ID,国語,数学,英語,理科,社会,合計,判定
19990001,58,81,66,46,35,286,不合格
19990002,67,93,65,64,75,364,合格
19990003,79,53,93,30,79,334,合格
19990004,61,38,74,4,30,207,不合格
19990005,50,36,36,99,70,291,不合格
19990006,93,87,63,38,71,352,合格
19990007,99,49,15,31,60,254,不合格
19990008,3,79,49,33,99,263,不合格
19990009,29,35,64,89,59,276,不合格
19990010,7,38,13,5,4,67,不合格
19990011,10,18,33,55,81,197,不合格
19990012,78,21,96,96,21,312,合格
19990013,96,22,47,51,88,304,合格
19990014,56,86,80,74,97,393,合格
19990015,64,3,34,84,4,189,不合格
19990016,55,23,18,11,68,175,不合格
19990017,87,61,21,62,1,232,不合格
19990018,21,78,74,74,24,271,不合格
19990019,88,70,25,34,11,228,不合格
19990020,59,60,75,15,58,267,不合格
19990021,86,96,78,12,9,281,不合格
19990022,98,95,84,71,46,394,合格
19990023,17,20,98,10,73,218,不合格
19990024,36,12,21,36,4,109,不合格
19990025,37,43,97,47,18,242,不合格
19990026,49,2,26,29,38,144,不合格
19990027,53,3,87,41,82,266,不合格
19990028,42,13,16,69,89,229,不合格
19990029,94,70,16,89,30,299,不合格
19990030,73,82,82,76,4,317,合格
19990031,57,35,58,59,16,225,不合格
19990032,72,34,15,24,84,229,不合格
19990033,68,53,39,0,86,246,不合格
19990034,85,34,14,30,88,251,不合格
19990035,4,45,2,41,49,141,不合格
19990036,48,24,50,33,66,221,不合格
19990037,24,75,9,42,43,193,不合格
19990038,25,34,83,57,48,247,不合格
19990039,44,18,42,61,89,254,不合格
19990040,83,8,81,14,41,227,不合格
19990041,47,1,68,15,49,180,不合格
19990042,51,63,40,42,95,291,不合格
19990043,76,95,83,55,2,311,合格
19990044,57,19,75,23,67,241,不合格
19990045,93,36,34,53,7,223,不合格
19990046,48,14,93,48,99,302,合格
19990047,76,6,64,3,55,204,不合格
19990048,64,87,3,14,19,187,不合格
19990049,74,29,90,52,29,274,不合格
19990050,18,12,4,64,89,187,不合格
19990051,70,68,25,88,56,307,合格
19990052,58,69,36,43,97,303,合格
19990053,49,32,4,12,62,159,不合格
19990054,65,88,79,99,87,418,合格
19990055,41,23,42,15,53,174,不合格
19990056,43,75,88,85,85,376,合格
19990057,23,53,20,22,4,122,不合格
19990058,89,80,4,65,43,281,不合格
19990059,69,86,71,62,67,355,合格
19990060,61,86,9,31,30,217,不合格
19990061,5,59,65,66,88,283,不合格
19990062,7,11,13,46,29,106,不合格
19990063,55,20,33,57,17,182,不合格
19990064,1,47,90,64,83,285,不合格
19990065,55,45,2,55,66,223,不合格
19990066,68,63,81,12,20,244,不合格
19990067,86,30,3,79,82,280,不合格
19990068,13,29,38,63,10,153,不合格
19990069,72,18,86,12,32,220,不合格
19990070,10,25,41,25,28,129,不合格
19990071,44,48,49,83,99,323,合格
19990072,69,58,99,8,52,286,不合格
19990073,64,77,49,45,43,278,不合格
19990074,89,66,65,6,28,254,不合格
19990075,27,2,43,72,30,174,不合格
19990076,7,92,22,76,27,224,不合格
19990077,99,20,2,62,84,267,不合格
19990078,47,47,32,43,67,236,不合格
19990079,24,95,76,50,78,323,合格
19990080,87,37,54,68,48,294,不合格
19990081,83,2,50,27,79,241,不合格
19990082,30,58,35,24,59,206,不合格
19990083,67,42,44,33,53,239,不合格
19990084,77,75,2,9,38,201,不合格
19990085,1,74,83,85,62,305,合格
19990086,2,75,54,11,26,168,不合格
19990087,64,59,37,37,3,200,不合格
19990088,2,3,69,28,75,177,不合格
19990089,56,69,75,57,0,257,不合格
19990090,56,81,16,84,45,282,不合格
19990091,7,77,8,51,50,193,不合格
19990092,92,80,73,15,99,359,合格
19990093,50,35,89,11,48,233,不合格
19990094,93,56,99,34,26,308,合格
19990095,11,25,85,7,53,181,不合格
19990096,85,88,59,14,37,283,不合格
19990097,69,86,21,95,76,347,合格
19990098,81,38,14,86,59,278,不合格
19990099,97,53,72,44,32,298,不合格
19990100,56,55,85,54,28,278,不合格
19990101,73,89,40,7,33,242,不合格
19990102,10,21,73,77,2,183,不合格
19990103,89,93,36,73,38,329,合格
19990104,24,43,73,11,50,201,不合格
19990105,79,14,4,58,35,190,不合格
19990106,21,11,45,75,16,168,不合格
19990107,51,64,97,8,51,271,不合格
19990108,43,59,45,32,45,224,不合格
19990109,81,93,29,90,37,330,合格
19990110,5,8,35,87,59,194,不合格
19990111,62,73,59,10,28,232,不合格
19990112,94,65,98,46,94,397,合格
19990113,29,32,84,20,88,253,不合格
19990114,87,72,15,29,14,217,不合格
19990115,80,34,91,2,41,248,不合格
19990116,2,48,83,78,28,239,不合格
19990117,92,62,23,20,49,246,不合格
19990118,83,50,28,93,21,275,不合格
19990119,2,5,43,8,52,110,不合格
19990120,71,9,96,61,21,258,不合格
19990121,17,80,81,3,48,229,不合格
19990122,97,23,0,16,34,170,不合格
19990123,11,22,39,74,40,186,不合格
19990124,96,15,66,9,83,269,不合格
19990125,36,34,69,87,17,243,不合格
19990126,68,0,49,23,51,191,不合格
19990127,23,8,61,61,28,181,不合格
19990128,98,3,35,36,53,225,不合格
19990129,72,51,35,89,46,293,不合格
19990130,82,60,72,90,29,333,合格
19990131,77,47,22,63,97,306,合格
19990132,77,75,48,86,5,291,不合格
19990133,86,10,97,44,86,323,合格
19990134,97,33,57,26,37,250,不合格
19990135,7,79,78,50,43,257,不合格
19990136,56,50,22,9,60,197,不合格
19990137,18,55,19,32,26,150,不合格
19990138,1,84,70,72,94,321,合格
19990139,61,71,78,74,10,294,不合格
19990140,4,34,23,39,23,123,不合格
19990141,5,23,82,27,54,191,不合格
19990142,21,52,18,28,41,160,不合格
19990143,26,64,35,33,61,219,不合格
19990144,60,98,17,84,51,310,合格
19990145,58,68,13,94,37,270,不合格
19990146,73,56,62,12,80,283,不合格
19990147,90,85,0,33,0,208,不合格
19990148,31,15,50,93,47,236,不合格
19990149,50,12,8,15,75,160,不合格
19990150,30,57,95,86,60,328,合格
19990151,44,80,29,83,47,283,不合格
19990152,26,80,84,19,97,306,合格
19990153,11,61,21,19,8,120,不合格
19990154,13,23,59,66,43,204,不合格
19990155,33,35,92,15,91,266,不合格
19990156,46,36,88,34,48,252,不合格
19990157,64,89,82,56,96,387,合格
19990158,37,90,22,92,11,252,不合格
19990159,0,15,38,29,4,86,不合格
19990160,17,16,0,95,92,220,不合格
19990161,38,44,28,41,76,227,不合格
19990162,39,88,55,55,98,335,合格
19990163,53,97,93,5,55,303,合格
19990164,13,73,66,80,65,297,不合格
19990165,52,67,23,8,52,202,不合格
19990166,66,60,0,21,88,235,不合格
19990167,0,42,36,77,17,172,不合格
19990168,10,46,32,16,74,178,不合格
19990169,95,47,9,68,49,268,不合格
19990170,65,92,15,19,25,216,不合格
19990171,55,42,59,72,10,238,不合格
19990172,13,39,33,16,8,109,不合格
19990173,78,59,98,53,29,317,合格
19990174,98,96,48,33,86,361,合格
19990175,8,17,70,82,55,232,不合格
19990176,69,44,24,31,14,182,不合格
19990177,7,13,87,69,93,269,不合格
19990178,75,93,37,48,10,263,不合格
19990179,86,45,62,64,32,289,不合格
19990180,33,60,51,89,92,325,合格
19990181,95,85,56,67,5,308,合格
19990182,40,60,61,75,22,258,不合格
19990183,77,94,2,40,81,294,不合格
19990184,37,28,77,24,25,191,不合格
19990185,84,63,90,68,43,348,合格
19990186,67,54,19,99,71,310,合格
19990187,18,21,96,60,2,197,不合格
19990188,61,10,14,34,13,132,不合格
19990189,63,30,33,49,44,219,不合格
19990190,33,71,68,46,89,307,合格
19990191,73,99,70,45,76,363,合格
19990192,19,50,7,23,62,161,不合格
19990193,58,48,8,98,9,221,不合格
19990194,73,74,32,27,92,298,不合格
19990195,64,21,45,24,26,180,不合格
19990196,52,45,22,54,5,178,不合格
19990197,21,17,74,64,88,264,不合格
19990198,80,55,5,15,54,209,不合格
19990199,89,58,60,0,73,280,不合格
19990200,67,54,54,15,36,226,不合格
19990201,14,17,97,12,43,183,不合格
19990202,37,51,68,93,99,348,合格
19990203,30,44,11,66,66,217,不合格
19990204,4,4,88,25,18,139,不合格
19990205,63,55,90,47,83,338,合格
19990206,44,50,54,89,18,255,不合格
19990207,89,19,3,97,98,306,合格
19990208,62,54,73,96,2,287,不合格
19990209,32,13,45,48,22,160,不合格
19990210,96,27,26,59,92,300,合格
19990211,26,13,13,89,50,191,不合格
19990212,90,28,41,60,84,303,合格
19990213,22,73,3,39,96,233,不合格
19990214,67,84,88,89,12,340,合格
19990215,11,45,84,82,47,269,不合格
19990216,47,87,8,91,8,241,不合格
19990217,57,1,80,69,59,266,不合格
19990218,19,87,39,68,68,281,不合格
19990219,82,65,6,30,50,233,不合格
19990220,58,49,88,56,48,299,不合格
19990221,72,55,42,50,28,247,不合格
19990222,2,7,35,31,36,111,不合格
19990223,38,64,32,32,61,227,不合格
19990224,45,67,52,96,82,342,合格
19990225,29,77,89,54,63,312,合格
19990226,99,5,42,92,37,275,不合格
19990227,66,61,86,83,16,312,合格
19990228,96,17,79,98,58,348,合格
19990229,85,56,25,2,17,185,不合格
19990230,89,17,12,21,94,233,不合格
19990231,73,31,62,30,33,229,不合格
19990232,45,76,67,83,90,361,合格
19990233,68,4,38,55,90,255,不合格
19990234,88,2,48,70,74,282,不合格
19990235,26,36,20,31,71,184,不合格
19990236,54,51,80,68,90,343,合格
19990237,9,88,40,4,19,160,不合格
19990238,68,57,27,7,52,211,不合格
19990239,47,39,61,80,2,229,不合格
19990240,77,2,16,43,65,203,不合格
19990241,5,60,48,59,10,182,不合格
19990242,29,77,85,48,17,256,不合格
19990243,61,72,42,99,52,326,合格
19990244,44,11,32,83,97,267,不合格
19990245,99,90,61,12,37,299,不合格
19990246,36,27,62,44,75,244,不合格
19990247,84,36,63,98,19,300,合格
19990248,35,86,82,33,83,319,合格
19990249,64,34,42,27,23,190,不合格
19990250,75,19,75,33,30,232,不合格
19990251,14,39,17,62,71,203,不合格
19990252,95,95,68,43,84,385,合格
19990253,13,3,41,42,57,156,不合格
19990254,73,16,52,98,30,269,不合格
19990255,20,71,32,19,4,146,不合格
19990256,37,42,25,74,18,196,不合格
19990257,71,1,18,18,86,194,不合格
19990258,12,83,97,47,48,287,不合格
19990259,6,6,44,5,14,75,不合格
19990260,70,14,62,45,73,264,不合格
19990261,73,29,34,89,39,264,不合格
19990262,20,81,43,74,41,259,不合格
19990263,16,39,22,20,4,101,不合格
19990264,32,10,13,69,47,171,不合格
19990265,69,78,53,9,90,299,不合格
19990266,40,15,30,23,93,201,不合格
19990267,92,61,91,73,83,400,合格
19990268,68,8,53,19,34,182,不合格
19990269,59,43,23,17,71,213,不合格
19990270,10,37,26,36,51,160,不合格
19990271,13,9,63,17,25,127,不合格
19990272,89,60,58,28,62,297,不合格
19990273,75,10,91,15,16,207,不合格
19990274,46,21,28,75,55,225,不合格
19990275,98,55,15,86,69,323,合格
19990276,76,95,65,0,11,247,不合格
19990277,40,96,63,21,86,306,合格
19990278,27,27,69,1,70,194,不合格
19990279,9,10,33,58,10,120,不合格
19990280,11,77,48,27,38,201,不合格
19990281,41,29,80,19,12,181,不合格
19990282,35,14,47,94,19,209,不合格
19990283,44,20,31,50,18,163,不合格
19990284,48,83,97,42,36,306,合格
19990285,9,25,34,45,81,194,不合格
19990286,61,46,69,53,6,235,不合格
19990287,26,38,14,36,31,145,不合格
19990288,40,76,38,90,87,331,合格
19990289,88,8,22,85,30,233,不合格
19990290,80,37,13,13,1,144,不合格
19990291,26,44,9,97,4,180,不合格
19990292,20,37,57,42,8,164,不合格
19990293,1,12,95,17,48,173,不合格
19990294,87,88,4,0,58,237,不合格
19990295,57,36,13,13,45,164,不合格
19990296,48,70,1,70,17,206,不合格
19990297,84,69,90,98,0,341,合格
19990298,31,35,28,20,15,129,不合格
19990299,92,99,90,21,35,337,合格
19990300,48,69,19,19,38,193,不合格
19990301,11,87,5,47,65,215,不合格
19990302,76,38,93,35,6,248,不合格
19990303,89,58,27,42,92,308,合格
19990304,54,49,27,58,84,272,不合格
19990305,91,83,3,93,31,301,合格
19990306,44,89,33,44,53,263,不合格
19990307,45,38,32,18,82,215,不合格
19990308,35,41,18,73,95,262,不合格
19990309,67,60,4,98,24,253,不合格
19990310,75,86,51,70,19,301,合格
19990311,50,93,17,94,78,332,合格
19990312,38,21,30,28,85,202,不合格
19990313,89,87,85,87,4,352,合格
19990314,33,47,4,64,84,232,不合格
19990315,66,6,90,36,37,235,不合格
19990316,96,77,90,7,85,355,合格
19990317,57,42,61,18,56,234,不合格
19990318,97,74,63,41,82,357,合格
19990319,38,2,74,25,76,215,不合格
19990320,97,73,97,0,82,349,合格
19990321,54,53,20,95,8,230,不合格
19990322,99,51,30,29,95,304,合格
19990323,16,37,67,78,0,198,不合格
19990324,25,25,96,92,89,327,合格
19990325,93,6,42,88,8,237,不合格
19990326,8,17,87,53,25,190,不合格
19990327,70,85,84,72,4,315,合格
19990328,48,29,0,82,1,160,不合格
19990329,94,71,63,82,74,384,合格
19990330,50,68,87,21,66,292,不合格
19990331,74,56,1,84,59,274,不合格
19990332,96,28,5,94,99,322,合格
19990333,81,6,69,6,22,184,不合格
19990334,62,37,98,13,34,244,不合格
19990335,9,81,41,65,4,200,不合格
19990336,3,4,50,23,59,139,不合格
19990337,74,56,67,79,85,361,合格
19990338,20,81,7,70,20,198,不合格
19990339,39,17,8,75,87,226,不合格
19990340,82,11,33,86,55,267,不合格
19990341,19,83,71,99,52,324,合格
19990342,93,93,37,87,11,321,合格
19990343,54,22,41,99,41,257,不合格
19990344,62,96,22,52,54,286,不合格
19990345,77,21,31,28,37,194,不合格
19990346,4,7,57,51,15,134,不合格
19990347,97,87,38,83,0,305,合格
19990348,52,35,39,91,42,259,不合格
19990349,47,76,12,46,62,243,不合格
19990350,17,67,60,85,83,312,合格
19990351,77,36,15,68,33,229,不合格
19990352,49,61,49,43,40,242,不合格
19990353,83,9,57,84,9,242,不合格
19990354,13,47,69,72,46,247,不合格
19990355,13,26,24,29,10,102,不合格
19990356,50,30,80,71,42,273,不合格
19990357,49,76,24,84,40,273,不合格
19990358,22,55,31,36,47,191,不合格
19990359,12,16,34,87,6,155,不合格
19990360,74,66,79,13,14,246,不合格
19990361,93,87,45,97,9,331,合格
19990362,13,39,69,61,53,235,不合格
19990363,8,22,23,87,1,141,不合格
19990364,8,79,87,85,0,259,不合格
19990365,54,38,47,21,38,198,不合格
19990366,23,50,55,17,6,151,不合格
19990367,94,23,0,39,46,202,不合格
19990368,17,5,70,72,23,187,不合格
19990369,15,16,19,26,20,96,不合格
19990370,66,17,11,75,55,224,不合格
19990371,58,16,35,36,20,165,不合格
19990372,23,37,63,29,99,251,不合格
19990373,74,20,64,34,93,285,不合格
19990374,71,19,72,95,11,268,不合格
19990375,34,72,83,98,64,351,合格
19990376,19,12,7,18,25,81,不合格
19990377,18,62,50,93,56,279,不合格
19990378,15,57,64,13,64,213,不合格
19990379,17,34,54,68,33,206,不合格
19990380,87,62,31,31,28,239,不合格
19990381,52,14,6,50,70,192,不合格
19990382,6,53,91,25,79,254,不合格
19990383,65,77,89,38,94,363,合格
19990384,86,75,4,62,29,256,不合格
19990385,66,60,53,75,42,296,不合格
19990386,76,33,70,82,15,276,不合格
19990387,30,50,95,69,86,330,合格
19990388,91,38,21,23,50,223,不合格
19990389,63,71,81,60,29,304,合格
19990390,40,26,64,26,47,203,不合格
19990391,49,13,42,14,55,173,不合格
19990392,4,25,85,5,13,132,不合格
19990393,93,41,74,21,55,284,不合格
19990394,22,81,31,6,92,232,不合格
19990395,79,31,53,86,66,315,合格
19990396,70,10,23,20,88,211,不合格
19990397,65,46,74,65,60,310,合格
19990398,58,0,49,73,64,244,不合格
19990399,61,95,73,29,10,268,不合格
19990400,34,79,89,45,50,297,不合格
19990401,92,94,97,86,15,384,合格
19990402,61,15,66,27,96,265,不合格
19990403,53,0,32,14,10,109,不合格
19990404,2,88,88,56,32,266,不合格
19990405,46,36,74,87,57,300,合格
19990406,39,54,99,18,46,256,不合格
19990407,19,94,91,54,10,268,不合格
19990408,22,25,51,77,46,221,不合格
19990409,41,48,94,47,42,272,不合格
19990410,31,12,43,81,68,235,不合格
19990411,45,6,5,17,56,129,不合格
19990412,76,87,35,90,54,342,合格
19990413,3,84,73,92,13,265,不合格
19990414,46,77,87,20,79,309,合格
19990415,12,25,41,14,74,166,不合格
19990416,78,95,96,24,65,358,合格
19990417,7,53,9,77,65,211,不合格
19990418,86,21,41,40,82,270,不合格
19990419,25,1,68,47,82,223,不合格
19990420,82,21,47,27,35,212,不合格
19990421,83,82,14,66,14,259,不合格
19990422,39,23,6,13,46,127,不合格
19990423,52,83,44,0,47,226,不合格
19990424,5,81,54,14,97,251,不合格
19990425,17,2,40,54,61,174,不合格
19990426,94,13,41,90,77,315,合格
19990427,43,72,7,7,55,184,不合格
19990428,64,16,0,55,81,216,不合格
19990429,2,35,3,51,89,180,不合格
19990430,49,18,3,33,61,164,不合格
19990431,13,49,32,80,95,269,不合格
19990432,7,56,97,68,6,234,不合格
19990433,51,81,91,23,57,303,合格
19990434,21,13,47,73,9,163,不合格
19990435,26,62,23,61,65,237,不合格
19990436,65,93,18,13,65,254,不合格
19990437,78,2,19,64,87,250,不合格
19990438,80,40,20,9,4,153,不合格
19990439,79,69,33,7,68,256,不合格
19990440,49,17,24,3,31,124,不合格
19990441,67,99,51,60,23,300,合格
19990442,23,49,9,94,5,180,不合格
19990443,3,19,24,36,54,136,不合格
19990444,40,81,20,98,27,266,不合格
19990445,75,5,91,88,91,350,合格
19990446,14,51,86,8,14,173,不合格
19990447,63,33,34,19,17,166,不合格
19990448,9,86,63,90,70,318,合格
19990449,56,36,78,26,46,242,不合格
19990450,26,43,51,71,49,240,不合格
19990451,56,58,99,45,47,305,合格
19990452,12,13,54,33,72,184,不合格
19990453,46,23,40,1,52,162,不合格
19990454,67,5,80,35,85,272,不合格
19990455,56,28,30,6,98,218,不合格
19990456,35,25,76,33,64,233,不合格
19990457,4,21,92,39,13,169,不合格
19990458,5,50,82,34,30,201,不合格
19990459,64,54,33,28,12,191,不合格
19990460,51,53,37,92,18,251,不合格
19990461,55,60,49,3,16,183,不合格
19990462,66,52,38,3,13,172,不合格
19990463,71,28,38,48,97,282,不合格
19990464,96,77,89,52,86,400,合格
19990465,75,14,11,75,92,267,不合格
19990466,65,34,34,15,98,246,不合格
19990467,19,98,89,74,99,379,合格
19990468,97,65,66,72,61,361,合格
19990469,9,15,85,78,60,247,不合格
19990470,14,18,54,27,78,191,不合格
19990471,16,71,30,2,20,139,不合格
19990472,96,11,71,66,94,338,合格
19990473,25,10,51,65,51,202,不合格
19990474,2,76,50,82,11,221,不合格
19990475,1,56,30,27,16,130,不合格
19990476,73,15,31,88,9,216,不合格
19990477,26,53,63,46,9,197,不合格
19990478,6,53,38,59,64,220,不合格
19990479,55,48,16,33,3,155,不合格
19990480,68,73,44,72,87,344,合格
19990481,73,74,88,53,24,312,合格
19990482,75,29,27,16,68,215,不合格
19990483,34,9,31,20,83,177,不合格
19990484,89,26,12,98,28,253,不合格
19990485,1,32,4,54,20,111,不合格
19990486,82,71,62,62,99,376,合格
19990487,4,5,52,54,53,168,不合格
19990488,17,2,54,71,91,235,不合格
19990489,18,33,16,18,95,180,不合格
19990490,29,40,77,37,1,184,不合格
19990491,69,70,45,38,5,227,不合格
19990492,29,65,99,72,65,330,合格
19990493,47,57,4,9,30,147,不合格
19990494,98,80,58,33,77,346,合格
19990495,38,9,10,55,48,160,不合格
19990496,64,5,67,48,75,259,不合格
19990497,86,27,5,28,77,223,不合格
19990498,9,62,38,15,97,221,不合格
19990499,68,11,71,22,16,188,不合格
19990500,56,26,68,44,31,225,不合格
19990501,90,21,41,77,85,314,合格
19990502,37,21,13,18,7,96,不合格
19990503,66,45,20,94,40,265,不合格
19990504,21,40,68,91,83,303,合格
19990505,98,90,32,4,50,274,不合格
19990506,69,12,41,23,1,146,不合格
19990507,19,28,32,15,2,96,不合格
19990508,29,81,83,30,70,293,不合格
19990509,20,12,95,89,82,298,不合格
19990510,92,96,42,28,85,343,合格
19990511,67,1,82,64,47,261,不合格
19990512,88,19,28,21,31,187,不合格
19990513,57,43,94,54,66,314,合格
19990514,88,43,50,95,43,319,合格
19990515,48,64,77,88,37,314,合格
19990516,28,48,79,10,94,259,不合格
19990517,52,71,1,34,11,169,不合格
19990518,38,42,23,17,16,136,不合格
19990519,22,99,35,86,22,264,不合格
19990520,20,34,8,43,54,159,不合格
19990521,74,19,45,35,13,186,不合格
19990522,18,95,17,58,84,272,不合格
19990523,74,23,15,13,60,185,不合格
19990524,46,3,25,66,57,197,不合格
19990525,19,0,44,93,73,229,不合格
19990526,19,68,72,50,89,298,不合格
19990527,10,36,9,12,3,70,不合格
19990528,21,34,76,77,72,280,不合格
19990529,20,55,6,4,20,105,不合格
19990530,1,96,22,16,31,166,不合格
19990531,35,35,81,10,4,165,不合格
19990532,80,30,27,41,90,268,不合格
19990533,41,96,36,82,93,348,合格
19990534,2,40,58,78,7,185,不合格
19990535,3,31,27,18,26,105,不合格
19990536,30,77,23,41,65,236,不合格
19990537,4,11,69,71,50,205,不合格
19990538,42,12,47,83,14,198,不合格
19990539,1,77,85,77,92,332,合格
19990540,85,70,89,74,53,371,合格
19990541,87,78,98,62,53,378,合格
19990542,71,21,94,83,13,282,不合格
19990543,24,43,86,40,62,255,不合格
19990544,83,5,45,1,71,205,不合格
19990545,26,85,26,20,6,163,不合格
19990546,43,41,54,81,49,268,不合格
19990547,55,78,16,33,48,230,不合格
19990548,57,61,42,52,98,310,合格
19990549,80,41,95,81,54,351,合格
19990550,49,56,94,64,15,278,不合格
19990551,65,61,73,4,40,243,不合格
19990552,28,21,60,21,57,187,不合格
19990553,32,34,68,98,74,306,合格
19990554,73,49,88,25,66,301,合格
19990555,26,45,61,88,89,309,合格
19990556,54,14,49,38,53,208,不合格
19990557,69,7,0,26,14,116,不合格
19990558,43,10,42,15,36,146,不合格
19990559,29,80,2,53,86,250,不合格
19990560,71,32,14,93,30,240,不合格
19990561,74,31,82,10,54,251,不合格
19990562,73,28,43,69,9,222,不合格
19990563,27,97,42,28,28,222,不合格
19990564,65,56,7,15,39,182,不合格
19990565,75,41,8,34,70,228,不合格
19990566,45,84,85,87,80,381,合格
19990567,83,88,7,93,90,361,合格
19990568,71,95,41,74,40,321,合格
19990569,82,98,64,22,90,356,合格
19990570,1,75,80,48,13,217,不合格
19990571,62,79,20,72,45,278,不合格
19990572,25,28,97,1,95,246,不合格
19990573,6,49,0,20,71,146,不合格
19990574,76,81,5,47,74,283,不合格
19990575,56,28,60,37,31,212,不合格
19990576,4,16,87,38,26,171,不合格
19990577,82,93,18,13,99,305,合格
19990578,51,30,45,83,51,260,不合格
19990579,7,64,72,94,84,321,合格
19990580,32,29,55,99,48,263,不合格
19990581,62,30,54,43,4,193,不合格
19990582,65,65,86,47,94,357,合格
19990583,87,31,22,4,91,235,不合格
19990584,21,86,59,47,86,299,不合格
19990585,38,17,52,63,15,185,不合格
19990586,71,45,95,75,83,369,合格
19990587,42,96,11,90,37,276,不合格
19990588,57,81,43,88,93,362,合格
19990589,39,85,59,44,76,303,合格
19990590,21,76,41,94,29,261,不合格
19990591,98,73,12,70,5,258,不合格
19990592,10,26,52,93,23,204,不合格
19990593,2,47,91,51,45,236,不合格
19990594,83,98,14,87,16,298,不合格
19990595,4,51,50,33,35,173,不合格
19990596,55,53,5,35,82,230,不合格
19990597,58,97,71,69,57,352,合格
19990598,8,49,34,63,29,183,不合格
19990599,43,74,81,53,39,290,不合格
19990600,96,50,26,66,84,322,合格
19990601,41,38,49,19,93,240,不合格
19990602,81,17,71,9,22,200,不合格
19990603,98,7,4,75,23,207,不合格
19990604,91,98,68,95,72,424,合格
19990605,74,56,64,42,65,301,合格
19990606,32,24,4,51,31,142,不合格
19990607,0,45,44,45,82,216,不合格
19990608,88,57,36,85,52,318,合格
19990609,87,72,3,67,73,302,合格
19990610,50,77,34,74,83,318,合格
19990611,3,5,26,20,81,135,不合格
19990612,91,46,62,50,88,337,合格
19990613,8,61,51,90,46,256,不合格
19990614,24,75,32,71,74,276,不合格
19990615,7,2,89,18,71,187,不合格
19990616,37,92,12,68,24,233,不合格
19990617,36,62,73,95,35,301,合格
19990618,59,0,30,28,19,136,不合格
19990619,4,71,27,42,5,149,不合格
19990620,19,85,82,13,11,210,不合格
19990621,81,23,60,81,40,285,不合格
19990622,56,97,41,76,18,288,不合格
19990623,5,11,72,76,81,245,不合格
19990624,92,16,33,10,84,235,不合格
19990625,73,56,41,52,10,232,不合格
19990626,25,74,33,49,49,230,不合格
19990627,2,16,90,86,36,230,不合格
19990628,10,3,21,43,6,83,不合格
19990629,11,68,80,17,29,205,不合格
19990630,93,11,81,29,16,230,不合格
19990631,53,87,77,48,21,286,不合格
19990632,3,91,32,61,74,261,不合格
19990633,63,46,39,97,4,249,不合格
19990634,88,28,30,54,87,287,不合格
19990635,92,55,73,15,69,304,合格
19990636,4,84,19,10,90,207,不合格
19990637,32,36,42,8,68,186,不合格
19990638,71,65,34,73,82,325,合格
19990639,87,20,64,86,56,313,合格
19990640,23,36,52,94,11,216,不合格
19990641,74,14,21,67,63,239,不合格
19990642,10,35,31,2,62,140,不合格
19990643,61,45,79,93,64,342,合格
19990644,56,70,77,52,38,293,不合格
19990645,14,64,35,58,14,185,不合格
19990646,6,43,91,56,19,215,不合格
19990647,2,40,76,59,33,210,不合格
19990648,60,75,15,30,69,249,不合格
19990649,10,62,16,74,90,252,不合格
19990650,50,93,18,13,70,244,不合格
19990651,22,41,1,47,20,131,不合格
19990652,7,2,46,54,7,116,不合格
19990653,22,95,35,90,74,316,合格
19990654,41,53,51,6,54,205,不合格
19990655,94,13,45,79,12,243,不合格
19990656,37,28,54,14,74,207,不合格
19990657,77,1,28,7,44,157,不合格
19990658,70,34,16,81,95,296,不合格
19990659,52,98,97,54,29,330,合格
19990660,70,78,26,12,91,277,不合格
19990661,93,74,64,58,22,311,合格
19990662,95,36,4,3,31,169,不合格
19990663,25,64,87,61,92,329,合格
19990664,19,44,75,74,12,224,不合格
19990665,68,80,9,63,2,222,不合格
19990666,15,92,76,37,83,303,合格
19990667,2,80,30,0,23,135,不合格
19990668,61,3,84,31,81,260,不合格
19990669,40,87,47,65,2,241,不合格
19990670,31,82,43,34,48,238,不合格
19990671,34,53,22,95,99,303,合格
19990672,67,43,74,43,24,251,不合格
19990673,99,93,75,50,48,365,合格
19990674,94,40,66,42,17,259,不合格
19990675,89,33,28,88,12,250,不合格
19990676,86,62,68,73,14,303,合格
19990677,60,92,38,2,16,208,不合格
19990678,25,11,67,1,13,117,不合格
19990679,21,75,51,82,61,290,不合格
19990680,18,95,22,3,1,139,不合格
19990681,5,87,16,32,43,183,不合格
19990682,66,97,59,95,77,394,合格
19990683,85,49,23,69,79,305,合格
19990684,72,8,18,45,56,199,不合格
19990685,16,46,8,17,86,173,不合格
19990686,51,80,92,36,47,306,合格
19990687,43,82,23,93,29,270,不合格
19990688,30,24,80,76,75,285,不合格
19990689,38,11,57,57,62,225,不合格
19990690,80,7,44,42,6,179,不合格
19990691,82,52,86,32,34,286,不合格
19990692,0,70,47,78,25,220,不合格
19990693,2,6,64,42,53,167,不合格
19990694,22,21,59,99,19,220,不合格
19990695,97,29,23,37,17,203,不合格
19990696,91,36,41,49,86,303,合格
19990697,30,3,15,20,33,101,不合格
19990698,57,38,49,48,17,209,不合格
19990699,12,20,40,94,61,227,不合格
19990700,97,14,56,74,53,294,不合格
19990701,37,73,46,30,60,246,不合格
19990702,63,37,53,35,31,219,不合格
19990703,32,68,64,64,64,292,不合格
19990704,14,9,35,23,45,126,不合格
19990705,27,5,40,94,53,219,不合格
19990706,16,88,22,39,47,212,不合格
19990707,8,61,95,60,37,261,不合格
19990708,51,17,86,20,55,229,不合格
19990709,12,84,72,78,42,288,不合格
19990710,54,59,17,51,43,224,不合格
19990711,91,31,98,64,21,305,合格
19990712,49,28,95,95,90,357,合格
19990713,12,47,18,46,32,155,不合格
19990714,90,66,5,55,72,288,不合格
19990715,25,74,42,88,99,328,合格
19990716,67,70,19,56,97,309,合格
19990717,84,82,71,77,45,359,合格
19990718,88,2,35,92,18,235,不合格
19990719,17,54,42,60,91,264,不合格
19990720,6,5,91,85,10,197,不合格
19990721,92,86,87,85,72,422,合格
19990722,46,44,17,10,94,211,不合格
19990723,8,91,97,79,96,371,合格
19990724,14,55,42,57,26,194,不合格
19990725,88,81,31,93,56,349,合格
19990726,80,60,28,62,97,327,合格
19990727,16,86,80,58,54,294,不合格
19990728,17,94,82,1,25,219,不合格
19990729,33,10,6,90,20,159,不合格
19990730,69,71,71,48,83,342,合格
19990731,3,61,98,88,3,253,不合格
19990732,19,91,2,34,57,203,不合格
19990733,19,30,89,5,57,200,不合格
19990734,88,22,27,83,45,265,不合格
19990735,24,80,65,81,80,330,合格
19990736,6,54,36,28,93,217,不合格
19990737,50,79,68,40,25,262,不合格
19990738,22,87,0,52,58,219,不合格
19990739,75,32,91,34,65,297,不合格
19990740,40,88,4,33,81,246,不合格
19990741,80,36,99,69,25,309,合格
19990742,40,95,50,11,61,257,不合格
19990743,68,76,98,20,52,314,合格
19990744,37,51,85,81,59,313,合格
19990745,28,67,81,16,55,247,不合格
19990746,35,19,74,42,81,251,不合格
19990747,51,55,40,20,8,174,不合格
19990748,6,83,34,72,59,254,不合格
19990749,30,79,43,83,84,319,合格
19990750,70,5,14,19,25,133,不合格
19990751,77,25,78,90,41,311,合格
19990752,6,30,1,9,19,65,不合格
19990753,0,47,59,43,79,228,不合格
19990754,19,54,93,15,61,242,不合格
19990755,67,10,1,17,89,184,不合格
19990756,91,80,66,51,69,357,合格
19990757,76,6,49,84,41,256,不合格
19990758,61,38,29,12,73,213,不合格
19990759,66,6,77,72,86,307,合格
19990760,37,11,9,97,0,154,不合格
19990761,54,90,79,82,23,328,合格
19990762,11,35,55,3,86,190,不合格
19990763,92,84,68,36,15,295,不合格
19990764,23,90,9,38,2,162,不合格
19990765,4,26,84,82,46,242,不合格
19990766,71,93,9,90,42,305,合格
19990767,53,13,60,23,56,205,不合格
19990768,55,73,11,16,14,169,不合格
19990769,6,30,50,80,92,258,不合格
19990770,15,24,12,53,85,189,不合格
19990771,97,51,23,89,33,293,不合格
19990772,77,70,24,30,83,284,不合格
19990773,47,26,43,0,83,199,不合格
19990774,7,56,44,37,60,204,不合格
19990775,8,73,98,62,54,295,不合格
19990776,49,85,19,42,95,290,不合格
19990777,25,28,85,19,56,213,不合格
19990778,93,70,78,49,2,292,不合格
19990779,49,28,50,82,98,307,合格
19990780,60,54,30,30,61,235,不合格
19990781,77,40,92,79,59,347,合格
19990782,57,68,93,59,76,353,合格
19990783,63,76,81,30,77,327,合格
19990784,90,75,27,16,58,266,不合格
19990785,19,25,36,3,80,163,不合格
19990786,92,4,84,70,89,339,合格
19990787,50,96,37,2,24,209,不合格
19990788,44,12,17,18,49,140,不合格
19990789,41,57,93,9,48,248,不合格
19990790,75,66,77,8,80,306,合格
19990791,33,65,78,82,65,323,合格
19990792,14,99,17,39,10,179,不合格
19990793,87,57,24,75,13,256,不合格
19990794,12,25,58,15,87,197,不合格
19990795,34,13,26,83,6,162,不合格
19990796,27,76,25,0,55,183,不合格
19990797,77,55,27,45,22,226,不合格
19990798,49,31,83,59,31,253,不合格
19990799,30,54,6,15,5,110,不合格
19990800,35,0,95,57,93,280,不合格
19990801,47,15,24,43,3,132,不合格
19990802,12,78,72,17,37,216,不合格
19990803,42,28,12,81,28,191,不合格
19990804,39,13,98,14,0,164,不合格
19990805,3,34,24,52,60,173,不合格
19990806,48,88,84,4,62,286,不合格
19990807,33,57,99,39,50,278,不合格
19990808,1,99,69,62,72,303,合格
19990809,48,23,66,24,80,241,不合格
19990810,19,71,16,51,8,165,不合格
19990811,67,53,54,6,99,279,不合格
19990812,29,29,43,28,56,185,不合格
19990813,83,67,52,18,93,313,合格
19990814,11,40,64,81,16,212,不合格
19990815,90,92,73,5,28,288,不合格
19990816,7,63,29,40,48,187,不合格
19990817,0,59,15,95,62,231,不合格
19990818,2,33,11,71,73,190,不合格
19990819,56,15,5,99,73,248,不合格
19990820,32,83,76,60,93,344,合格
19990821,54,38,83,82,37,294,不合格
19990822,82,10,75,5,84,256,不合格
19990823,75,37,9,49,60,230,不合格
19990824,65,42,32,36,27,202,不合格
19990825,37,4,37,52,81,211,不合格
19990826,32,37,44,72,31,216,不合格
19990827,17,63,71,39,71,261,不合格
19990828,35,40,11,61,30,177,不合格
19990829,23,46,89,41,85,284,不合格
19990830,0,60,19,98,72,249,不合格
19990831,99,21,13,13,63,209,不合格
19990832,23,96,76,8,69,272,不合格
19990833,94,53,14,78,49,288,不合格
19990834,90,54,74,28,64,310,合格
19990835,86,88,56,64,46,340,合格
19990836,81,48,18,82,84,313,合格
19990837,70,71,18,63,22,244,不合格
19990838,89,32,40,37,66,264,不合格
19990839,25,93,2,22,17,159,不合格
19990840,79,24,81,65,95,344,合格
19990841,22,40,80,87,95,324,合格
19990842,86,8,62,0,77,233,不合格
19990843,60,47,95,49,8,259,不合格
19990844,35,57,51,76,78,297,不合格
19990845,51,13,74,54,81,273,不合格
19990846,34,89,83,97,83,386,合格
19990847,72,60,81,84,76,373,合格
19990848,22,83,65,89,92,351,合格
19990849,57,99,83,32,38,309,合格
19990850,62,23,79,71,68,303,合格
19990851,93,11,91,8,81,284,不合格
19990852,74,71,47,3,71,266,不合格
19990853,33,45,54,96,1,229,不合格
19990854,44,81,58,0,59,242,不合格
19990855,72,57,75,1,16,221,不合格
19990856,88,88,81,57,99,413,合格
19990857,38,34,13,16,36,137,不合格
19990858,91,64,38,32,61,286,不合格
19990859,9,81,95,8,49,242,不合格
19990860,50,66,45,37,4,202,不合格
19990861,11,39,81,83,32,246,不合格
19990862,50,22,37,74,57,240,不合格
19990863,33,75,56,7,67,238,不合格
19990864,67,77,65,23,97,329,合格
19990865,12,46,24,23,62,167,不合格
19990866,74,12,31,5,33,155,不合格
19990867,92,4,93,1,39,229,不合格
19990868,64,45,36,80,50,275,不合格
19990869,27,24,48,54,94,247,不合格
19990870,87,77,22,84,33,303,合格
19990871,98,62,92,46,75,373,合格
19990872,10,34,88,36,83,251,不合格
19990873,90,16,81,27,77,291,不合格
19990874,65,93,11,85,97,351,合格
19990875,22,81,24,35,55,217,不合格
19990876,84,8,58,78,54,282,不合格
19990877,37,27,48,95,23,230,不合格
19990878,87,84,15,88,70,344,合格
19990879,73,94,60,56,78,361,合格
19990880,94,1,61,55,87,298,不合格
19990881,95,34,19,72,78,298,不合格
19990882,21,88,59,32,51,251,不合格
19990883,49,26,10,6,93,184,不合格
19990884,27,32,92,86,66,303,合格
19990885,50,7,69,75,47,248,不合格
19990886,25,8,23,31,50,137,不合格
19990887,26,49,62,70,72,279,不合格
19990888,38,67,30,28,13,176,不合格
19990889,71,60,63,73,74,341,合格
19990890,61,25,84,83,43,296,不合格
19990891,28,64,64,15,17,188,不合格
19990892,67,74,51,58,75,325,合格
19990893,89,73,29,15,66,272,不合格
19990894,94,7,76,19,36,232,不合格
19990895,94,77,22,95,56,344,合格
19990896,5,17,38,68,24,152,不合格
19990897,53,2,27,80,38,200,不合格
19990898,68,58,82,99,21,328,合格
19990899,38,87,16,67,12,220,不合格
19990900,19,60,5,17,82,183,不合格
19990901,83,30,45,64,12,234,不合格
19990902,76,52,11,7,14,160,不合格
19990903,67,33,18,61,96,275,不合格
19990904,47,69,33,38,55,242,不合格
19990905,76,10,65,42,12,205,不合格
19990906,37,1,55,75,13,181,不合格
19990907,2,98,42,68,6,216,不合格
19990908,45,92,18,85,0,240,不合格
19990909,69,26,19,40,16,170,不合格
19990910,8,18,72,39,44,181,不合格
19990911,40,50,33,79,92,294,不合格
19990912,79,89,24,19,89,300,合格
19990913,26,31,66,81,41,245,不合格
19990914,52,31,7,90,61,241,不合格
19990915,76,77,18,61,74,306,合格
19990916,56,9,80,29,36,210,不合格
19990917,19,96,6,17,65,203,不合格
19990918,22,11,57,17,10,117,不合格
19990919,16,52,36,26,22,152,不合格
19990920,13,94,26,11,58,202,不合格
19990921,81,64,36,50,56,287,不合格
19990922,18,92,32,84,62,288,不合格
19990923,5,25,34,39,0,103,不合格
19990924,45,74,55,62,19,255,不合格
19990925,70,91,94,31,49,335,合格
19990926,36,49,24,54,50,213,不合格
19990927,3,25,31,65,57,181,不合格
19990928,10,19,91,10,44,174,不合格
19990929,0,48,70,77,69,264,不合格
19990930,40,82,1,68,15,206,不合格
19990931,3,41,29,87,26,186,不合格
19990932,79,46,58,90,32,305,合格
19990933,15,7,92,28,45,187,不合格
19990934,83,84,23,12,46,248,不合格
19990935,6,42,3,11,96,158,不合格
19990936,4,48,93,26,2,173,不合格
19990937,6,93,32,96,13,240,不合格
19990938,44,33,28,74,50,229,不合格
19990939,19,64,1,49,54,187,不合格
19990940,37,79,36,13,97,262,不合格
19990941,33,8,99,8,30,178,不合格
19990942,76,13,15,77,48,229,不合格
19990943,78,52,54,19,85,288,不合格
19990944,63,29,79,42,92,305,合格
19990945,41,42,79,31,80,273,不合格
19990946,74,3,9,85,73,244,不合格
19990947,61,51,95,53,81,341,合格
19990948,68,3,76,51,93,291,不合格
19990949,7,86,87,55,17,252,不合格
19990950,2,37,29,22,20,110,不合格
19990951,85,47,27,85,65,309,合格
19990952,85,44,69,98,38,334,合格
19990953,99,26,29,37,35,226,不合格
19990954,86,27,47,62,52,274,不合格
19990955,13,72,64,4,20,173,不合格
19990956,27,28,63,94,25,237,不合格
19990957,13,72,99,51,68,303,合格
19990958,89,47,91,98,58,383,合格
19990959,2,11,97,68,63,241,不合格
19990960,54,56,43,6,12,171,不合格
19990961,69,43,70,58,68,308,合格
19990962,17,58,62,97,7,241,不合格
19990963,49,51,48,19,44,211,不合格
19990964,2,41,84,76,92,295,不合格
19990965,92,45,57,82,64,340,合格
19990966,21,60,17,10,72,180,不合格
19990967,61,36,74,51,84,306,合格
19990968,60,92,88,2,99,341,合格
19990969,21,79,14,67,89,270,不合格
19990970,49,26,22,56,11,164,不合格
19990971,18,47,57,38,79,239,不合格
19990972,99,68,99,75,61,402,合格
19990973,29,43,47,33,2,154,不合格
19990974,36,40,58,17,19,170,不合格
19990975,41,77,92,13,57,280,不合格
19990976,96,93,65,4,33,291,不合格
19990977,20,50,47,44,32,193,不合格
19990978,3,37,2,60,76,178,不合格
19990979,9,50,66,77,47,249,不合格
19990980,29,18,10,82,12,151,不合格
19990981,89,75,40,52,25,281,不合格
19990982,29,20,87,96,9,241,不合格
19990983,93,64,26,45,95,323,合格
19990984,84,79,31,29,23,246,不合格
19990985,47,48,74,66,59,294,不合格
19990986,95,47,77,27,70,316,合格
19990987,73,59,55,70,70,327,合格
19990988,28,87,34,4,76,229,不合格
19990989,56,27,31,49,7,170,不合格
19990990,63,71,4,21,36,195,不合格
19990991,48,26,24,17,24,139,不合格
19990992,61,6,10,23,30,130,不合格
19990993,87,33,71,81,2,274,不合格
19990994,22,2,9,1,17,51,不合格
19990995,36,62,50,52,15,215,不合格
19990996,54,91,60,67,50,322,合格
19990997,46,5,4,73,39,167,不合格
19990998,40,30,57,39,85,251,不合格
19990999,59,96,91,31,13,290,不合格
19991000,90,44,79,11,76,300,合格
19991001,65,97,17,49,59,287,不合格
19991002,43,80,16,68,89,296,不合格
19991003,18,93,61,89,98,359,合格
19991004,30,4,79,40,79,232,不合格
19991005,69,98,0,53,45,265,不合格
19991006,87,64,33,6,58,248,不合格
19991007,14,72,35,52,39,212,不合格
19991008,2,2,11,35,86,136,不合格
19991009,8,62,10,68,18,166,不合格
19991010,30,96,46,6,38,216,不合格
19991011,42,72,11,9,88,222,不合格
19991012,74,89,70,89,1,323,合格
19991013,15,64,4,92,14,189,不合格
19991014,86,67,91,50,43,337,合格
19991015,26,97,52,53,56,284,不合格
19991016,63,49,7,55,36,210,不合格
19991017,8,30,88,50,72,248,不合格
19991018,57,73,10,42,29,211,不合格
19991019,94,27,17,32,8,178,不合格
19991020,74,13,54,10,82,233,不合格
19991021,52,85,54,63,63,317,合格
19991022,20,58,55,81,83,297,不合格
19991023,9,71,67,53,31,231,不合格
19991024,19,10,80,54,2,165,不合格
19991025,60,25,15,31,18,149,不合格
19991026,84,18,91,38,3,234,不合格
19991027,78,40,14,33,89,254,不合格
19991028,46,95,86,34,17,278,不合格
19991029,1,52,48,8,59,168,不合格
19991030,78,24,53,6,31,192,不合格
19991031,10,20,62,17,15,124,不合格
19991032,25,85,18,64,91,283,不合格
19991033,13,71,35,73,95,287,不合格
19991034,77,75,74,20,89,335,合格
19991035,6,25,63,45,99,238,不合格
19991036,11,33,17,83,91,235,不合格
19991037,63,98,10,95,25,291,不合格
19991038,22,29,74,35,78,238,不合格
19991039,20,79,14,12,69,194,不合格
19991040,73,9,32,97,61,272,不合格
19991041,80,40,51,32,54,257,不合格
19991042,52,43,66,91,94,346,合格
19991043,44,49,80,48,11,232,不合格
19991044,60,20,87,98,56,321,合格
19991045,70,72,36,63,64,305,合格
19991046,98,50,4,16,52,220,不合格
19991047,41,86,49,58,54,288,不合格
19991048,84,93,89,25,38,329,合格
19991049,90,39,75,66,69,339,合格
19991050,63,77,77,80,75,372,合格
19991051,64,92,45,68,79,348,合格
19991052,9,38,80,92,74,293,不合格
19991053,81,61,21,68,25,256,不合格
19991054,9,66,88,5,18,186,不合格
19991055,99,14,98,7,54,272,不合格
19991056,68,46,2,20,82,218,不合格
19991057,55,30,73,23,12,193,不合格
19991058,24,13,26,15,17,95,不合格
19991059,73,20,47,29,90,259,不合格
19991060,12,54,76,11,21,174,不合格
19991061,72,96,6,25,35,234,不合格
19991062,51,56,4,79,48,238,不合格
19991063,36,15,75,25,24,175,不合格
19991064,43,68,56,2,90,259,不合格
19991065,47,98,82,53,63,343,合格
19991066,97,38,23,93,58,309,合格
19991067,31,33,84,73,33,254,不合格
19991068,22,21,30,88,64,225,不合格
19991069,11,87,10,16,7,131,不合格
19991070,56,35,63,49,92,295,不合格
19991071,13,33,57,1,24,128,不合格
19991072,19,22,58,12,18,129,不合格
19991073,67,7,23,73,67,237,不合格
19991074,12,39,29,32,61,173,不合格
19991075,21,85,48,94,19,267,不合格
19991076,18,75,52,23,56,224,不合格
19991077,27,40,51,67,46,231,不合格
19991078,6,10,23,81,3,123,不合格
19991079,77,67,4,67,92,307,合格
19991080,15,41,57,4,30,147,不合格
19991081,26,66,24,72,63,251,不合格
19991082,5,88,67,83,59,302,合格
19991083,19,32,83,78,25,237,不合格
19991084,47,47,29,3,86,212,不合格
19991085,78,0,42,95,81,296,不合格
19991086,78,30,54,85,41,288,不合格
19991087,10,47,69,64,14,204,不合格
19991088,60,75,58,24,79,296,不合格
19991089,30,74,22,30,30,186,不合格
19991090,28,82,53,82,79,324,合格
19991091,35,72,14,81,50,252,不合格
19991092,39,19,66,39,80,243,不合格
19991093,30,48,1,65,12,156,不合格
19991094,35,67,16,28,13,159,不合格
19991095,39,38,12,49,73,211,不合格
19991096,66,24,93,11,70,264,不合格
19991097,59,56,79,0,62,256,不合格
19991098,41,1,18,50,43,153,不合格
19991099,49,1,64,10,1,125,不合格
19991100,52,56,97,21,58,284,不合格
19991101,66,69,1,99,78,313,合格
19991102,61,54,35,61,9,220,不合格
19991103,36,49,15,50,30,180,不合格
19991104,9,28,96,17,31,181,不合格
19991105,62,64,45,54,51,276,不合格
19991106,24,46,61,64,38,233,不合格
19991107,14,71,21,37,49,192,不合格
19991108,95,83,34,75,54,341,合格
19991109,10,94,5,74,94,277,不合格
19991110,22,96,72,77,6,273,不合格
19991111,51,56,96,19,4,226,不合格
19991112,94,78,37,35,26,270,不合格
19991113,84,83,37,14,95,313,合格
19991114,28,34,4,50,46,162,不合格
19991115,55,23,21,0,29,128,不合格
19991116,90,99,24,38,98,349,合格
19991117,60,40,44,44,96,284,不合格
19991118,21,28,68,21,51,189,不合格
19991119,67,89,11,68,41,276,不合格
19991120,9,7,84,15,66,181,不合格
19991121,41,57,18,30,57,203,不合格
19991122,33,15,87,72,54,261,不合格
19991123,29,77,62,2,40,210,不合格
19991124,79,70,82,27,69,327,合格
19991125,5,63,19,32,13,132,不合格
19991126,17,38,21,36,60,172,不合格
19991127,93,75,90,92,78,428,合格
19991128,80,35,45,86,64,310,合格
19991129,76,96,29,16,27,244,不合格
19991130,23,90,15,18,35,181,不合格
19991131,78,20,61,2,96,257,不合格
19991132,59,47,43,92,28,269,不合格
19991133,46,60,68,78,41,293,不合格
19991134,83,62,97,1,32,275,不合格
19991135,27,28,75,96,29,255,不合格
19991136,49,54,8,77,53,241,不合格
19991137,30,55,21,6,83,195,不合格
19991138,8,72,72,67,42,261,不合格
19991139,45,52,63,72,5,237,不合格
19991140,45,52,71,20,83,271,不合格
19991141,83,53,72,58,82,348,合格
19991142,12,43,52,70,56,233,不合格
19991143,3,3,54,84,48,192,不合格
19991144,18,74,91,47,26,256,不合格
19991145,68,71,23,25,79,266,不合格
19991146,2,37,59,38,8,144,不合格
19991147,28,22,84,95,40,269,不合格
19991148,86,0,77,9,23,195,不合格
19991149,76,9,82,66,31,264,不合格
19991150,65,93,66,91,94,409,合格
19991151,64,34,56,28,55,237,不合格
19991152,27,33,13,75,98,246,不合格
19991153,30,13,86,65,77,271,不合格
19991154,26,58,80,63,28,255,不合格
19991155,70,73,47,67,77,334,合格
19991156,55,38,13,30,28,164,不合格
19991157,67,46,78,2,83,276,不合格
19991158,65,90,30,78,95,358,合格
19991159,30,1,26,58,98,213,不合格
19991160,86,17,53,13,18,187,不合格
19991161,19,43,68,49,67,246,不合格
19991162,86,91,81,51,38,347,合格
19991163,8,12,98,12,39,169,不合格
19991164,93,11,68,21,44,237,不合格
19991165,50,20,70,68,40,248,不合格
19991166,69,8,38,43,77,235,不合格
19991167,86,92,16,14,70,278,不合格
19991168,56,63,37,37,25,218,不合格
19991169,90,61,39,76,63,329,合格
19991170,25,7,77,79,13,201,不合格
19991171,92,82,71,66,37,348,合格
19991172,39,44,83,70,1,237,不合格
19991173,0,57,9,63,34,163,不合格
19991174,29,14,6,2,89,140,不合格
19991175,63,94,85,53,32,327,合格
19991176,66,9,54,92,56,277,不合格
19991177,83,87,90,62,47,369,合格
19991178,67,60,37,21,53,238,不合格
19991179,0,37,80,47,49,213,不合格
19991180,63,89,30,28,57,267,不合格
19991181,84,35,78,59,42,298,不合格
19991182,13,58,94,52,66,283,不合格
19991183,54,39,3,85,82,263,不合格
19991184,1,64,28,51,59,203,不合格
19991185,54,32,8,87,50,231,不合格
19991186,44,69,4,54,2,173,不合格
19991187,2,5,30,60,32,129,不合格
19991188,45,76,73,7,16,217,不合格
19991189,53,9,86,33,58,239,不合格
19991190,56,25,31,45,45,202,不合格
19991191,21,33,54,18,96,222,不合格
19991192,33,59,76,69,22,259,不合格
19991193,81,13,23,43,30,190,不合格
19991194,66,84,64,35,96,345,合格
19991195,62,3,42,35,4,146,不合格
19991196,47,97,8,10,22,184,不合格
19991197,12,4,66,98,94,274,不合格
19991198,92,55,48,18,22,235,不合格
19991199,78,18,16,96,94,302,合格
19991200,69,39,25,29,61,223,不合格
19991201,67,67,57,43,70,304,合格
19991202,17,5,11,50,74,157,不合格
19991203,73,70,96,75,23,337,合格
19991204,43,61,46,70,90,310,合格
19991205,80,98,45,20,3,246,不合格
19991206,65,88,57,64,51,325,合格
19991207,42,7,52,58,43,202,不合格
19991208,47,36,53,73,2,211,不合格
19991209,28,25,69,53,56,231,不合格
19991210,18,86,28,23,64,219,不合格
19991211,23,70,51,20,19,183,不合格
19991212,31,95,9,71,30,236,不合格
19991213,59,37,39,2,96,233,不合格
19991214,56,40,9,85,66,256,不合格
19991215,87,97,51,65,94,394,合格
19991216,37,55,18,94,3,207,不合格
19991217,51,37,0,33,74,195,不合格
19991218,12,83,51,53,87,286,不合格
19991219,42,40,97,68,39,286,不合格
19991220,71,60,99,47,47,324,合格
19991221,96,18,36,96,66,312,合格
19991222,12,66,94,49,6,227,不合格
19991223,99,28,24,86,29,266,不合格
19991224,52,84,23,99,89,347,合格
19991225,93,55,82,96,72,398,合格
19991226,74,75,2,86,89,326,合格
19991227,3,77,94,99,78,351,合格
19991228,93,19,62,92,33,299,不合格
19991229,22,68,85,97,70,342,合格
19991230,62,91,87,22,64,326,合格
19991231,4,43,41,12,28,128,不合格
19991232,68,96,61,10,60,295,不合格
19991233,11,10,49,50,55,175,不合格
19991234,21,49,90,17,32,209,不合格
19991235,20,43,54,14,14,145,不合格
19991236,15,12,99,35,53,214,不合格
19991237,85,79,45,21,96,326,合格
19991238,53,68,43,8,45,217,不合格
19991239,71,33,9,46,89,248,不合格
19991240,77,14,27,8,95,221,不合格
19991241,46,26,48,91,49,260,不合格
19991242,41,54,89,29,0,213,不合格
19991243,44,44,82,34,24,228,不合格
19991244,83,22,36,43,22,206,不合格
19991245,73,24,28,45,43,213,不合格
19991246,13,18,77,60,42,210,不合格
19991247,56,17,26,55,64,218,不合格
19991248,87,46,78,40,18,269,不合格
19991249,70,84,31,25,93,303,合格
19991250,95,70,15,43,99,322,合格
19991251,21,96,30,60,53,260,不合格
19991252,10,16,13,50,58,147,不合格
19991253,59,43,99,31,88,320,合格
19991254,34,93,38,48,1,214,不合格
19991255,90,34,80,31,8,243,不合格
19991256,66,61,11,26,36,200,不合格
19991257,64,33,62,70,74,303,合格
19991258,9,91,55,44,83,282,不合格
19991259,57,53,58,41,15,224,不合格
19991260,95,45,22,50,59,271,不合格
19991261,51,42,13,15,62,183,不合格
19991262,54,45,94,25,58,276,不合格
19991263,56,79,33,50,82,300,合格
19991264,54,21,71,25,53,224,不合格
19991265,24,51,94,21,77,267,不合格
19991266,9,49,25,79,57,219,不合格
19991267,43,36,27,6,53,165,不合格
19991268,46,80,7,12,8,153,不合格
19991269,45,1,45,13,78,182,不合格
19991270,11,57,40,11,55,174,不合格
19991271,54,15,33,42,31,175,不合格
19991272,69,55,1,93,69,287,不合格
19991273,12,95,14,11,34,166,不合格
19991274,96,38,71,10,94,309,合格
19991275,37,10,69,21,31,168,不合格
19991276,81,7,75,96,14,273,不合格
19991277,80,95,83,31,23,312,合格
19991278,91,58,60,61,99,369,合格
19991279,92,50,93,44,26,305,合格
19991280,13,31,14,92,23,173,不合格
19991281,98,69,68,19,83,337,合格
19991282,46,74,88,39,26,273,不合格
19991283,84,61,66,1,12,224,不合格
19991284,83,34,64,27,11,219,不合格
19991285,86,2,98,62,72,320,合格
19991286,76,80,31,82,7,276,不合格
19991287,67,32,98,19,98,314,合格
19991288,8,66,28,25,66,193,不合格
19991289,11,96,71,99,72,349,合格
19991290,95,9,56,0,20,180,不合格
19991291,80,40,77,67,58,322,合格
19991292,5,41,55,30,69,200,不合格
19991293,12,8,54,41,15,130,不合格
19991294,41,76,85,27,54,283,不合格
19991295,87,93,76,41,5,302,合格
19991296,71,78,2,7,95,253,不合格
19991297,75,84,74,92,35,360,合格
19991298,18,94,93,97,29,331,合格
19991299,84,60,4,4,37,189,不合格
19991300,62,12,71,65,52,262,不合格
19991301,53,21,27,47,91,239,不合格
19991302,22,33,73,49,94,271,不合格
19991303,77,41,94,18,85,315,合格
19991304,52,52,17,66,4,191,不合格
19991305,38,10,97,61,22,228,不合格
19991306,13,88,95,25,25,246,不合格
19991307,99,57,63,88,91,398,合格
19991308,2,64,90,84,13,253,不合格
19991309,83,96,2,68,47,296,不合格
19991310,4,68,72,30,37,211,不合格
19991311,38,72,4,86,9,209,不合格
19991312,90,62,39,18,84,293,不合格
19991313,45,63,38,90,12,248,不合格
19991314,68,27,87,72,0,254,不合格
19991315,57,86,57,60,86,346,合格
19991316,40,84,82,23,81,310,合格
19991317,75,13,54,85,52,279,不合格
19991318,97,84,53,30,73,337,合格
19991319,67,17,63,43,35,225,不合格
19991320,1,51,70,33,41,196,不合格
19991321,78,81,47,4,60,270,不合格
19991322,73,24,86,85,14,282,不合格
19991323,28,16,62,93,40,239,不合格
19991324,21,2,80,51,57,211,不合格
19991325,73,6,32,97,33,241,不合格
19991326,85,0,27,9,0,121,不合格
19991327,69,67,84,16,79,315,合格
19991328,79,26,63,17,45,230,不合格
19991329,80,50,7,13,6,156,不合格
19991330,37,19,0,49,25,130,不合格
19991331,40,72,77,49,55,293,不合格
19991332,38,57,34,87,41,257,不合格
19991333,75,50,42,25,88,280,不合格
19991334,29,37,74,0,1,141,不合格
19991335,24,11,37,8,80,160,不合格
19991336,18,23,27,35,81,184,不合格
19991337,90,71,83,86,39,369,合格
19991338,10,68,81,71,23,253,不合格
19991339,52,72,92,16,0,232,不合格
19991340,42,4,60,68,43,217,不合格
19991341,56,77,46,0,47,226,不合格
19991342,64,27,29,34,24,178,不合格
19991343,58,52,71,30,15,226,不合格
19991344,32,48,95,8,68,251,不合格
19991345,11,82,7,58,86,244,不合格
19991346,43,15,80,29,71,238,不合格
19991347,36,81,58,14,69,258,不合格
19991348,76,98,87,54,80,395,合格
19991349,89,83,39,48,7,266,不合格
19991350,95,54,40,4,1,194,不合格
19991351,37,39,98,83,8,265,不合格
19991352,50,47,50,41,25,213,不合格
19991353,55,16,25,13,54,163,不合格
19991354,73,64,6,14,18,175,不合格
19991355,67,12,96,43,70,288,不合格
19991356,11,92,76,8,39,226,不合格
19991357,39,77,91,33,78,318,合格
19991358,34,28,70,23,26,181,不合格
19991359,98,31,58,63,78,328,合格
19991360,84,71,78,62,85,380,合格
19991361,80,26,51,99,39,295,不合格
19991362,93,63,58,31,48,293,不合格
19991363,94,65,81,64,40,344,合格
19991364,98,9,3,40,39,189,不合格
19991365,19,25,99,55,55,253,不合格
19991366,76,80,72,40,63,331,合格
19991367,52,7,73,67,48,247,不合格
19991368,24,78,16,32,23,173,不合格
19991369,11,2,53,74,1,141,不合格
19991370,0,82,32,84,0,198,不合格
19991371,67,42,96,25,50,280,不合格
19991372,79,71,53,88,1,292,不合格
19991373,92,73,86,83,76,410,合格
19991374,28,67,88,52,51,286,不合格
19991375,90,83,98,96,70,437,合格
19991376,32,11,27,76,51,197,不合格
19991377,52,28,12,59,99,250,不合格
19991378,91,96,39,40,39,305,合格
19991379,80,11,34,63,1,189,不合格
19991380,88,39,20,52,89,288,不合格
19991381,33,6,2,67,12,120,不合格
19991382,19,5,58,74,1,157,不合格
19991383,81,75,57,58,63,334,合格
19991384,14,0,43,19,73,149,不合格
19991385,27,78,84,41,41,271,不合格
19991386,28,57,67,0,76,228,不合格
19991387,56,86,53,59,67,321,合格
19991388,51,28,8,98,80,265,不合格
19991389,5,84,60,41,43,233,不合格
19991390,65,71,89,20,67,312,合格
19991391,20,51,1,47,59,178,不合格
19991392,63,37,65,19,18,202,不合格
19991393,82,50,79,54,82,347,合格
19991394,18,89,86,29,44,266,不合格
19991395,13,89,7,64,61,234,不合格
19991396,87,80,8,76,53,304,合格
19991397,75,81,37,54,44,291,不合格
19991398,95,22,92,23,72,304,合格
19991399,95,77,49,69,20,310,合格
19991400,16,26,21,32,58,153,不合格
19991401,68,58,95,25,50,296,不合格
19991402,58,68,81,63,28,298,不合格
19991403,12,74,95,74,38,293,不合格
19991404,53,40,61,2,46,202,不合格
19991405,48,31,12,38,91,220,不合格
19991406,26,94,8,78,23,229,不合格
19991407,90,18,8,73,14,203,不合格
19991408,74,14,10,40,31,169,不合格
19991409,53,64,14,44,93,268,不合格
19991410,68,35,4,86,3,196,不合格
19991411,44,18,82,49,72,265,不合格
19991412,29,87,43,51,62,272,不合格
19991413,52,85,57,91,21,306,合格
19991414,66,97,40,18,2,223,不合格
19991415,52,20,33,6,87,198,不合格
19991416,44,17,87,96,9,253,不合格
19991417,92,25,97,93,27,334,合格
19991418,32,18,63,17,26,156,不合格
19991419,91,99,2,17,24,233,不合格
19991420,99,75,35,1,4,214,不合格
19991421,83,96,21,31,79,310,合格
19991422,99,51,0,98,75,323,合格
19991423,80,92,12,70,92,346,合格
19991424,79,98,23,54,88,342,合格
19991425,14,30,89,43,65,241,不合格
19991426,35,11,48,19,23,136,不合格
19991427,32,32,41,91,15,211,不合格
19991428,58,4,44,81,35,222,不合格
19991429,2,6,21,28,25,82,不合格
19991430,38,76,9,47,1,171,不合格
19991431,32,50,2,63,59,206,不合格
19991432,56,90,4,93,72,315,合格
19991433,99,33,39,45,74,290,不合格
19991434,43,12,46,64,37,202,不合格
19991435,7,28,76,8,37,156,不合格
19991436,19,55,28,14,48,164,不合格
19991437,90,46,90,83,16,325,合格
19991438,19,69,27,24,38,177,不合格
19991439,96,51,62,30,72,311,合格
19991440,69,66,60,17,18,230,不合格
19991441,4,35,38,70,56,203,不合格
19991442,16,0,6,37,84,143,不合格
19991443,60,74,34,87,82,337,合格
19991444,6,91,60,0,76,233,不合格
19991445,10,73,95,75,21,274,不合格
19991446,54,82,15,38,50,239,不合格
19991447,54,7,28,34,6,129,不合格
19991448,16,20,75,92,10,213,不合格
19991449,26,52,90,53,19,240,不合格
19991450,17,51,19,84,67,238,不合格
19991451,28,57,59,28,49,221,不合格
19991452,58,31,48,79,30,246,不合格
19991453,5,23,9,10,65,112,不合格
19991454,11,39,46,44,0,140,不合格
19991455,70,48,77,45,36,276,不合格
19991456,59,90,30,13,55,247,不合格
19991457,88,26,87,25,6,232,不合格
19991458,90,39,47,34,2,212,不合格
19991459,5,42,63,99,38,247,不合格
19991460,2,64,10,8,45,129,不合格
19991461,95,22,63,37,39,256,不合格
19991462,90,80,10,6,87,273,不合格
19991463,40,2,65,60,31,198,不合格
19991464,80,68,56,39,7,250,不合格
19991465,30,88,60,46,64,288,不合格
19991466,86,99,24,89,0,298,不合格
19991467,17,66,86,84,66,319,合格
19991468,12,8,93,15,2,130,不合格
19991469,19,24,2,38,25,108,不合格
19991470,73,90,74,42,63,342,合格
19991471,98,47,74,40,30,289,不合格
19991472,96,86,98,21,47,348,合格
19991473,99,54,41,96,58,348,合格
19991474,70,29,56,49,10,214,不合格
19991475,20,81,15,67,53,236,不合格
19991476,98,26,55,29,65,273,不合格
19991477,51,42,2,21,73,189,不合格
19991478,24,20,74,36,89,243,不合格
19991479,40,73,27,49,68,257,不合格
19991480,33,16,1,28,25,103,不合格
19991481,37,87,14,64,65,267,不合格
19991482,35,63,79,26,69,272,不合格
19991483,74,47,99,13,15,248,不合格
19991484,99,92,61,44,36,332,合格
19991485,19,99,66,38,9,231,不合格
19991486,73,68,60,27,90,318,合格
19991487,72,43,98,12,20,245,不合格
19991488,10,12,39,95,38,194,不合格
19991489,24,36,11,58,98,227,不合格
19991490,94,12,39,65,58,268,不合格
19991491,26,86,25,65,17,219,不合格
19991492,5,64,62,52,50,233,不合格
19991493,73,19,83,17,67,259,不合格
19991494,93,22,10,6,2,133,不合格
19991495,35,92,92,75,12,306,合格
19991496,53,83,83,44,4,267,不合格
19991497,27,99,85,55,53,319,合格
19991498,61,25,73,61,94,314,合格
19991499,65,70,19,18,44,216,不合格
19991500,46,60,55,58,65,284,不合格
19991501,76,14,55,58,30,233,不合格
19991502,74,88,0,16,75,253,不合格
19991503,18,91,22,7,64,202,不合格
19991504,71,12,28,95,43,249,不合格
19991505,50,83,91,49,5,278,不合格
19991506,89,79,84,4,95,351,合格
19991507,52,53,7,88,10,210,不合格
19991508,96,83,77,53,15,324,合格
19991509,23,62,34,26,61,206,不合格
19991510,67,17,11,47,71,213,不合格
19991511,96,41,22,48,49,256,不合格
19991512,12,57,24,4,59,156,不合格
19991513,17,9,41,77,92,236,不合格
19991514,67,5,65,31,22,190,不合格
19991515,55,70,59,5,72,261,不合格
19991516,49,56,38,40,8,191,不合格
19991517,48,34,26,6,99,213,不合格
19991518,92,26,77,93,32,320,合格
19991519,97,12,15,12,12,148,不合格
19991520,44,67,3,12,74,200,不合格
19991521,0,2,24,22,69,117,不合格
19991522,24,10,86,38,4,162,不合格
19991523,41,9,56,76,27,209,不合格
19991524,66,55,8,46,56,231,不合格
19991525,44,84,26,17,32,203,不合格
19991526,33,10,39,47,46,175,不合格
19991527,30,54,60,15,72,231,不合格
19991528,45,47,92,57,76,317,合格
19991529,51,98,87,96,91,423,合格
19991530,12,85,95,93,87,372,合格
19991531,29,12,94,78,56,269,不合格
19991532,77,53,29,70,69,298,不合格
19991533,0,47,87,87,59,280,不合格
19991534,76,31,30,74,38,249,不合格
19991535,64,34,52,43,76,269,不合格
19991536,98,65,79,17,38,297,不合格
19991537,65,13,86,42,68,274,不合格
19991538,23,81,63,5,22,194,不合格
19991539,23,60,80,21,60,244,不合格
19991540,25,29,32,58,95,239,不合格
19991541,85,32,43,24,51,235,不合格
19991542,38,43,70,55,34,240,不合格
19991543,95,86,16,87,39,323,合格
19991544,62,31,20,18,13,144,不合格
19991545,68,60,75,83,49,335,合格
19991546,20,49,79,70,46,264,不合格
19991547,39,34,97,20,7,197,不合格
19991548,98,47,15,67,85,312,合格
19991549,63,76,88,96,24,347,合格
19991550,4,61,18,31,14,128,不合格
19991551,18,6,6,33,59,122,不合格
19991552,76,50,43,21,2,192,不合格
19991553,26,32,67,99,45,269,不合格
19991554,77,32,28,42,3,182,不合格
19991555,96,38,56,2,80,272,不合格
19991556,20,79,52,69,46,266,不合格
19991557,90,24,82,21,84,301,合格
19991558,43,10,11,1,67,132,不合格
19991559,17,63,88,3,62,233,不合格
19991560,76,36,13,8,41,174,不合格
19991561,9,10,62,17,93,191,不合格
19991562,3,55,7,28,44,137,不合格
19991563,79,89,97,37,88,390,合格
19991564,69,94,81,33,25,302,合格
19991565,21,48,80,10,4,163,不合格
19991566,76,39,51,61,5,232,不合格
19991567,69,66,35,95,13,278,不合格
19991568,45,60,71,6,56,238,不合格
19991569,56,74,43,90,43,306,合格
19991570,77,23,27,60,28,215,不合格
19991571,63,98,5,86,71,323,合格
19991572,15,59,66,32,61,233,不合格
19991573,78,11,31,86,35,241,不合格
19991574,9,36,60,97,77,279,不合格
19991575,39,63,59,96,60,317,合格
19991576,61,52,15,93,49,270,不合格
19991577,6,31,44,55,92,228,不合格
19991578,70,16,20,57,57,220,不合格
19991579,39,47,38,70,10,204,不合格
19991580,61,18,7,38,21,145,不合格
19991581,16,16,48,49,89,218,不合格
19991582,58,40,67,78,71,314,合格
19991583,70,29,14,2,26,141,不合格
19991584,50,11,74,37,76,248,不合格
19991585,31,49,45,11,81,217,不合格
19991586,70,99,5,48,76,298,不合格
19991587,50,74,34,58,99,315,合格
19991588,56,50,52,28,61,247,不合格
19991589,0,92,13,55,43,203,不合格
19991590,50,62,40,68,86,306,合格
19991591,9,90,41,56,13,209,不合格
19991592,26,49,40,62,61,238,不合格
19991593,64,83,8,15,49,219,不合格
19991594,29,12,7,65,39,152,不合格
19991595,30,68,46,51,23,218,不合格
19991596,36,43,30,41,76,226,不合格
19991597,37,78,42,82,37,276,不合格
19991598,4,20,75,94,90,283,不合格
19991599,33,55,40,28,16,172,不合格
19991600,2,18,59,94,9,182,不合格
19991601,92,78,87,30,60,347,合格
19991602,67,98,76,37,46,324,合格
19991603,95,9,53,30,53,240,不合格
19991604,30,74,62,98,68,332,合格
19991605,32,97,42,13,86,270,不合格
19991606,10,80,17,50,89,246,不合格
19991607,42,85,46,45,92,310,合格
19991608,31,93,8,31,23,186,不合格
19991609,94,30,50,52,53,279,不合格
19991610,38,9,51,78,75,251,不合格
19991611,95,61,80,10,6,252,不合格
19991612,92,54,45,85,23,299,不合格
19991613,26,89,34,52,88,289,不合格
19991614,65,80,81,7,81,314,合格
19991615,69,41,51,5,68,234,不合格
19991616,12,50,3,79,43,187,不合格
19991617,29,6,18,15,88,156,不合格
19991618,97,81,93,17,33,321,合格
19991619,7,40,28,86,63,224,不合格
19991620,76,5,77,38,79,275,不合格
19991621,66,41,45,88,25,265,不合格
19991622,20,58,52,99,83,312,合格
19991623,2,9,74,94,36,215,不合格
19991624,97,7,38,32,28,202,不合格
19991625,24,90,3,36,24,177,不合格
19991626,82,64,50,12,11,219,不合格
19991627,73,28,27,57,11,196,不合格
19991628,21,27,9,89,88,234,不合格
19991629,48,5,0,4,86,143,不合格
19991630,5,96,99,41,29,270,不合格
19991631,77,12,44,18,39,190,不合格
19991632,61,29,26,44,5,165,不合格
19991633,4,71,1,78,12,166,不合格
19991634,25,1,56,79,94,255,不合格
19991635,82,70,47,18,77,294,不合格
19991636,27,46,77,79,5,234,不合格
19991637,28,77,24,15,60,204,不合格
19991638,36,46,53,33,79,247,不合格
19991639,95,11,14,76,64,260,不合格
19991640,26,65,15,36,82,224,不合格
19991641,67,42,54,35,25,223,不合格
19991642,32,8,8,4,86,138,不合格
19991643,75,9,66,85,43,278,不合格
19991644,13,44,7,61,74,199,不合格
19991645,28,48,75,20,75,246,不合格
19991646,93,69,29,61,45,297,不合格
19991647,57,48,11,74,50,240,不合格
19991648,40,78,59,7,3,187,不合格
19991649,44,30,24,99,36,233,不合格
19991650,9,93,96,82,26,306,合格
19991651,37,21,52,20,38,168,不合格
19991652,74,66,57,5,81,283,不合格
19991653,81,81,96,73,21,352,合格
19991654,37,87,48,4,25,201,不合格
19991655,68,88,85,89,75,405,合格
19991656,10,13,37,64,77,201,不合格
19991657,3,64,45,92,54,258,不合格
19991658,75,1,32,57,49,214,不合格
19991659,41,51,16,83,70,261,不合格
19991660,94,95,99,49,48,385,合格
19991661,45,35,14,66,44,204,不合格
19991662,4,32,44,41,82,203,不合格
19991663,23,15,98,83,75,294,不合格
19991664,18,0,21,80,41,160,不合格
19991665,46,64,90,81,87,368,合格
19991666,90,73,79,63,67,372,合格
19991667,36,88,19,94,62,299,不合格
19991668,14,24,14,24,24,100,不合格
19991669,55,0,22,67,4,148,不合格
19991670,43,52,23,99,91,308,合格
19991671,45,79,7,35,28,194,不合格
19991672,58,90,52,15,50,265,不合格
19991673,26,66,69,29,20,210,不合格
19991674,14,48,8,35,19,124,不合格
19991675,20,45,96,19,71,251,不合格
19991676,65,23,6,65,83,242,不合格
19991677,22,99,68,15,6,210,不合格
19991678,96,50,76,17,33,272,不合格
19991679,1,39,50,18,4,112,不合格
19991680,45,62,82,30,9,228,不合格
19991681,61,32,14,89,99,295,不合格
19991682,29,23,84,94,79,309,合格
19991683,34,62,24,7,80,207,不合格
19991684,94,83,7,45,87,316,合格
19991685,12,78,43,64,54,251,不合格
19991686,58,6,1,25,70,160,不合格
19991687,62,77,27,61,9,236,不合格
19991688,59,36,51,23,15,184,不合格
19991689,82,89,54,29,79,333,合格
19991690,17,74,26,31,76,224,不合格
19991691,26,90,44,33,40,233,不合格
19991692,16,69,41,69,67,262,不合格
19991693,15,3,71,95,96,280,不合格
19991694,9,35,77,0,60,181,不合格
19991695,85,51,83,44,99,362,合格
19991696,82,77,90,30,78,357,合格
19991697,31,37,12,70,23,173,不合格
19991698,85,86,13,23,2,209,不合格
19991699,11,89,82,82,49,313,合格
19991700,13,56,81,70,35,255,不合格
19991701,67,53,32,41,47,240,不合格
19991702,34,81,98,59,28,300,合格
19991703,87,90,92,63,15,347,合格
19991704,22,16,5,78,62,183,不合格
19991705,46,31,47,68,89,281,不合格
19991706,18,40,62,85,51,256,不合格
19991707,45,26,97,12,10,190,不合格
19991708,68,25,60,28,10,191,不合格
19991709,64,24,33,2,49,172,不合格
19991710,40,53,17,78,78,266,不合格
19991711,85,73,76,16,22,272,不合格
19991712,34,42,55,77,92,300,合格
19991713,48,55,15,41,94,253,不合格
19991714,62,71,93,89,66,381,合格
19991715,92,3,53,63,36,247,不合格
19991716,52,81,53,97,26,309,合格
19991717,41,62,70,88,75,336,合格
19991718,14,50,7,91,95,257,不合格
19991719,13,34,26,21,4,98,不合格
19991720,76,19,38,11,79,223,不合格
19991721,55,12,18,25,29,139,不合格
19991722,91,54,30,58,68,301,合格
19991723,6,41,23,53,90,213,不合格
19991724,95,56,79,56,7,293,不合格
19991725,45,21,73,13,16,168,不合格
19991726,72,55,87,69,83,366,合格
19991727,67,17,17,0,60,161,不合格
19991728,21,68,32,57,45,223,不合格
19991729,41,80,27,71,43,262,不合格
19991730,43,93,45,87,77,345,合格
19991731,41,42,39,47,99,268,不合格
19991732,22,48,1,28,49,148,不合格
19991733,9,96,21,49,4,179,不合格
19991734,52,38,9,5,28,132,不合格
19991735,19,67,63,79,0,228,不合格
19991736,52,30,80,26,61,249,不合格
19991737,99,26,58,48,42,273,不合格
19991738,62,23,94,46,65,290,不合格
19991739,28,60,36,47,28,199,不合格
19991740,57,17,65,9,36,184,不合格
19991741,38,47,69,40,97,291,不合格
19991742,8,70,23,23,91,215,不合格
19991743,31,82,14,25,83,235,不合格
19991744,46,54,42,55,57,254,不合格
19991745,66,3,7,1,18,95,不合格
19991746,75,3,74,52,40,244,不合格
19991747,54,63,79,23,38,257,不合格
19991748,60,44,44,91,75,314,合格
19991749,61,18,47,54,69,249,不合格
19991750,66,72,99,72,66,375,合格
19991751,50,64,15,67,15,211,不合格
19991752,33,16,18,62,16,145,不合格
19991753,43,1,52,95,16,207,不合格
19991754,89,47,76,49,36,297,不合格
19991755,54,44,98,54,75,325,合格
19991756,80,3,21,39,5,148,不合格
19991757,61,28,44,71,61,265,不合格
19991758,27,88,52,3,46,216,不合格
19991759,24,94,55,77,58,308,合格
19991760,68,58,88,72,15,301,合格
19991761,34,91,52,8,53,238,不合格
19991762,48,31,92,42,47,260,不合格
19991763,79,26,38,8,79,230,不合格
19991764,98,38,89,44,99,368,合格
19991765,36,15,76,89,61,277,不合格
19991766,36,67,86,29,40,258,不合格
19991767,65,33,52,67,92,309,合格
19991768,81,50,24,36,44,235,不合格
19991769,83,5,82,57,67,294,不合格
19991770,17,89,55,72,21,254,不合格
19991771,10,85,60,57,13,225,不合格
19991772,72,94,43,13,5,227,不合格
19991773,10,83,81,30,81,285,不合格
19991774,68,49,90,1,13,221,不合格
19991775,74,26,10,91,8,209,不合格
19991776,12,88,8,37,50,195,不合格
19991777,76,29,36,58,43,242,不合格
19991778,20,49,24,14,56,163,不合格
19991779,43,18,13,43,47,164,不合格
19991780,90,35,7,99,90,321,合格
19991781,1,93,78,43,78,293,不合格
19991782,30,14,36,4,63,147,不合格
19991783,72,52,81,19,52,276,不合格
19991784,23,91,72,65,23,274,不合格
19991785,87,7,77,49,56,276,不合格
19991786,3,78,16,41,69,207,不合格
19991787,94,24,58,10,12,198,不合格
19991788,65,70,31,40,85,291,不合格
19991789,81,10,13,77,19,200,不合格
19991790,80,42,8,39,3,172,不合格
19991791,4,29,15,69,79,196,不合格
19991792,3,49,16,44,3,115,不合格
19991793,81,81,70,95,41,368,合格
19991794,87,99,39,65,66,356,合格
19991795,64,94,53,67,44,322,合格
19991796,98,57,50,3,99,307,合格
19991797,38,4,41,38,69,190,不合格
19991798,52,8,3,46,63,172,不合格
19991799,51,96,18,76,90,331,合格
19991800,68,52,29,14,15,178,不合格
19991801,60,39,58,39,42,238,不合格
19991802,53,35,91,71,24,274,不合格
19991803,58,37,61,40,45,241,不合格
19991804,3,82,2,7,50,144,不合格
19991805,99,60,38,90,31,318,合格
19991806,37,17,25,12,20,111,不合格
19991807,53,64,85,99,41,342,合格
19991808,12,12,64,23,10,121,不合格
19991809,81,70,36,31,45,263,不合格
19991810,5,45,8,37,56,151,不合格
19991811,6,90,87,58,12,253,不合格
19991812,5,88,79,11,7,190,不合格
19991813,30,48,75,25,43,221,不合格
19991814,28,39,27,12,67,173,不合格
19991815,65,6,56,15,75,217,不合格
19991816,49,3,61,17,79,209,不合格
19991817,50,79,11,95,64,299,不合格
19991818,68,17,83,50,1,219,不合格
19991819,52,73,62,5,87,279,不合格
19991820,91,68,17,83,1,260,不合格
19991821,47,97,98,58,85,385,合格
19991822,79,32,58,46,13,228,不合格
19991823,58,25,23,48,29,183,不合格
19991824,80,67,13,4,59,223,不合格
19991825,48,94,22,84,60,308,合格
19991826,15,64,77,92,67,315,合格
19991827,48,71,3,5,26,153,不合格
19991828,39,13,33,85,1,171,不合格
19991829,67,91,97,32,58,345,合格
19991830,66,97,39,85,71,358,合格
19991831,69,8,18,25,12,132,不合格
19991832,10,42,22,88,13,175,不合格
19991833,27,11,60,89,16,203,不合格
19991834,19,48,4,75,46,192,不合格
19991835,43,35,62,74,30,244,不合格
19991836,49,0,0,75,17,141,不合格
19991837,69,14,95,75,16,269,不合格
19991838,31,93,33,9,1,167,不合格
19991839,77,74,66,63,24,304,合格
19991840,16,16,1,23,74,130,不合格
19991841,22,15,65,1,63,166,不合格
19991842,25,5,36,53,12,131,不合格
19991843,21,71,55,66,66,279,不合格
19991844,68,54,29,37,47,235,不合格
19991845,41,53,15,74,56,239,不合格
19991846,8,3,25,21,78,135,不合格
19991847,55,2,97,29,15,198,不合格
19991848,16,91,93,2,67,269,不合格
19991849,97,14,53,8,37,209,不合格
19991850,20,39,77,11,62,209,不合格
19991851,58,76,51,40,41,266,不合格
19991852,48,74,28,5,82,237,不合格
19991853,1,58,45,79,17,200,不合格
19991854,27,34,95,98,89,343,合格
19991855,35,25,96,3,51,210,不合格
19991856,80,37,63,3,6,189,不合格
19991857,47,4,59,67,43,220,不合格
19991858,95,60,94,60,2,311,合格
19991859,0,58,25,1,98,182,不合格
19991860,45,16,82,78,84,305,合格
19991861,0,58,43,82,84,267,不合格
19991862,47,51,7,6,89,200,不合格
19991863,27,55,65,47,10,204,不合格
19991864,45,63,85,21,91,305,合格
19991865,80,4,16,21,46,167,不合格
19991866,63,20,0,35,5,123,不合格
19991867,0,5,55,81,57,198,不合格
19991868,37,87,24,30,80,258,不合格
19991869,55,14,53,7,47,176,不合格
19991870,75,9,92,51,52,279,不合格
19991871,69,85,99,60,14,327,合格
19991872,5,15,23,16,78,137,不合格
19991873,63,3,62,17,67,212,不合格
19991874,90,9,73,8,17,197,不合格
19991875,36,17,66,77,16,212,不合格
19991876,53,45,82,69,18,267,不合格
19991877,79,16,99,84,54,332,合格
19991878,66,65,41,37,3,212,不合格
19991879,10,4,99,35,97,245,不合格
19991880,89,51,33,59,20,252,不合格
19991881,66,25,57,17,27,192,不合格
19991882,81,37,87,16,37,258,不合格
19991883,3,13,60,36,62,174,不合格
19991884,29,32,95,82,32,270,不合格
19991885,74,73,50,89,24,310,合格
19991886,52,37,28,2,37,156,不合格
19991887,31,25,77,24,20,177,不合格
19991888,51,38,60,42,11,202,不合格
19991889,22,67,49,75,8,221,不合格
19991890,91,78,3,5,40,217,不合格
19991891,68,42,75,83,85,353,合格
19991892,66,21,69,79,88,323,合格
19991893,50,18,88,28,45,229,不合格
19991894,47,6,33,97,7,190,不合格
19991895,10,97,31,7,20,165,不合格
19991896,64,81,84,71,30,330,合格
19991897,78,62,35,40,17,232,不合格
19991898,9,88,49,5,3,154,不合格
19991899,76,79,41,13,41,250,不合格
19991900,3,24,81,0,74,182,不合格
19991901,50,77,24,87,60,298,不合格
19991902,53,17,83,64,66,283,不合格
19991903,15,81,94,18,99,307,合格
19991904,69,43,97,99,67,375,合格
19991905,88,86,73,0,54,301,合格
19991906,29,51,80,35,44,239,不合格
19991907,81,55,44,87,86,353,合格
19991908,88,45,32,32,93,290,不合格
19991909,70,81,67,38,48,304,合格
19991910,16,28,46,70,30,190,不合格
19991911,37,84,33,68,53,275,不合格
19991912,50,75,47,16,0,188,不合格
19991913,58,20,76,10,62,226,不合格
19991914,92,4,15,35,81,227,不合格
19991915,95,1,37,64,14,211,不合格
19991916,58,29,91,41,2,221,不合格
19991917,31,29,65,54,14,193,不合格
19991918,70,35,36,8,88,237,不合格
19991919,5,28,97,62,67,259,不合格
19991920,62,17,31,45,38,193,不合格
19991921,61,85,83,5,93,327,合格
19991922,33,14,54,44,81,226,不合格
19991923,0,84,4,74,64,226,不合格
19991924,1,52,55,73,82,263,不合格
19991925,42,5,70,13,48,178,不合格
19991926,85,99,34,39,56,313,合格
19991927,17,17,19,51,86,190,不合格
19991928,64,69,3,63,62,261,不合格
19991929,67,48,85,14,44,258,不合格
19991930,40,15,31,12,23,121,不合格
19991931,17,3,71,76,63,230,不合格
19991932,80,86,81,22,35,304,合格
19991933,48,80,53,0,42,223,不合格
19991934,54,84,61,56,60,315,合格
19991935,85,14,64,90,95,348,合格
19991936,55,5,79,12,97,248,不合格
19991937,88,96,19,76,47,326,合格
19991938,95,87,45,19,18,264,不合格
19991939,12,39,94,93,47,285,不合格
19991940,90,36,55,5,66,252,不合格
19991941,59,62,78,40,59,298,不合格
19991942,98,76,64,0,16,254,不合格
19991943,2,31,73,84,35,225,不合格
19991944,25,48,73,85,83,314,合格
19991945,49,57,95,3,35,239,不合格
19991946,92,96,93,5,29,315,合格
19991947,37,10,41,90,98,276,不合格
19991948,62,48,89,94,48,341,合格
19991949,39,67,33,13,95,247,不合格
19991950,24,70,83,45,67,289,不合格
19991951,96,99,21,63,16,295,不合格
19991952,54,60,28,27,86,255,不合格
19991953,79,72,80,59,15,305,合格
19991954,55,4,58,27,37,181,不合格
19991955,46,6,69,5,59,185,不合格
19991956,98,49,93,60,53,353,合格
19991957,15,15,49,81,72,232,不合格
19991958,0,32,69,83,82,266,不合格
19991959,92,94,39,49,17,291,不合格
19991960,59,85,60,3,12,219,不合格
19991961,63,0,68,45,45,221,不合格
19991962,19,75,35,69,86,284,不合格
19991963,73,14,73,56,1,217,不合格
19991964,80,48,26,89,70,313,合格
19991965,87,10,14,25,81,217,不合格
19991966,33,25,8,52,37,155,不合格
19991967,48,5,81,85,64,283,不合格
19991968,17,95,14,96,20,242,不合格
19991969,39,71,72,30,34,246,不合格
19991970,46,91,15,46,99,297,不合格
19991971,60,13,96,21,55,245,不合格
19991972,53,72,5,81,1,212,不合格
19991973,14,86,75,32,60,267,不合格
19991974,2,67,49,49,54,221,不合格
19991975,57,41,51,88,7,244,不合格
19991976,33,85,28,5,77,228,不合格
19991977,67,31,84,63,34,279,不合格
19991978,76,82,87,72,24,341,合格
19991979,94,47,90,14,66,311,合格
19991980,82,32,39,80,58,291,不合格
19991981,72,4,25,52,26,179,不合格
19991982,61,1,34,66,49,211,不合格
19991983,50,43,95,16,45,249,不合格
19991984,20,88,18,16,51,193,不合格
19991985,62,83,39,55,73,312,合格
19991986,77,22,54,92,54,299,不合格
19991987,88,14,34,86,70,292,不合格
19991988,18,42,86,97,62,305,合格
19991989,2,67,99,34,52,254,不合格
19991990,61,3,49,2,86,201,不合格
19991991,11,65,74,49,80,279,不合格
19991992,40,9,36,22,17,124,不合格
19991993,58,4,56,46,23,187,不合格
19991994,20,7,63,18,33,141,不合格
19991995,96,17,49,12,66,240,不合格
19991996,29,80,57,86,21,273,不合格
19991997,43,59,36,21,3,162,不合格
19991998,41,69,97,96,14,317,合格
19991999,51,45,17,25,47,185,不合格
19992000,30,91,55,65,93,334,合格
19992001,65,73,23,50,95,306,合格
19992002,61,1,16,1,69,148,不合格
19992003,98,63,5,22,96,284,不合格
19992004,51,68,47,75,57,298,不合格
19992005,48,70,48,94,57,317,合格
19992006,73,11,33,49,76,242,不合格
19992007,76,51,47,90,84,348,合格
19992008,54,24,21,17,57,173,不合格
19992009,72,41,36,91,49,289,不合格
19992010,13,57,53,72,42,237,不合格
19992011,30,18,9,9,76,142,不合格
19992012,65,69,23,15,37,209,不合格
19992013,94,83,93,81,85,436,合格
19992014,79,26,65,21,5,196,不合格
19992015,84,65,63,85,87,384,合格
19992016,10,9,96,20,16,151,不合格
19992017,98,96,16,65,46,321,合格
19992018,14,16,65,23,78,196,不合格
19992019,98,50,5,55,68,276,不合格
19992020,20,77,2,89,32,220,不合格
19992021,41,85,59,96,1,282,不合格
19992022,36,79,48,45,4,212,不合格
19992023,24,5,89,37,42,197,不合格
19992024,45,45,31,75,10,206,不合格
19992025,70,76,92,6,55,299,不合格
19992026,6,98,16,83,61,264,不合格
19992027,78,63,60,12,13,226,不合格
19992028,78,62,85,41,18,284,不合格
19992029,4,23,6,50,16,99,不合格
19992030,65,85,24,14,12,200,不合格
19992031,15,95,74,76,11,271,不合格
19992032,36,13,38,15,17,119,不合格
19992033,52,10,38,54,15,169,不合格
19992034,1,43,18,85,13,160,不合格
19992035,5,74,90,62,26,257,不合格
19992036,6,21,44,48,63,182,不合格
19992037,68,8,21,55,60,212,不合格
19992038,97,72,75,66,59,369,合格
19992039,88,54,53,23,11,229,不合格
19992040,71,81,24,37,84,297,不合格
19992041,38,33,16,31,53,171,不合格
19992042,70,75,37,58,41,281,不合格
19992043,89,59,97,47,56,348,合格
19992044,56,36,8,96,20,216,不合格
19992045,27,38,46,92,64,267,不合格
19992046,38,61,62,75,63,299,不合格
19992047,55,38,88,93,52,326,合格
19992048,0,17,33,27,83,160,不合格
19992049,31,86,59,42,96,314,合格
19992050,63,55,54,34,94,300,合格
19992051,94,92,42,5,97,330,合格
19992052,17,93,93,25,82,310,合格
19992053,72,67,18,89,29,275,不合格
19992054,72,71,1,10,81,235,不合格
19992055,22,90,96,75,89,372,合格
19992056,22,92,30,68,16,228,不合格
19992057,69,44,51,80,36,280,不合格
19992058,44,41,58,14,41,198,不合格
19992059,49,50,49,3,83,234,不合格
19992060,74,63,3,14,44,198,不合格
19992061,56,34,79,52,49,270,不合格
19992062,20,51,64,0,99,234,不合格
19992063,50,69,35,35,74,263,不合格
19992064,16,86,18,64,29,213,不合格
19992065,4,96,46,78,66,290,不合格
19992066,39,93,60,3,10,205,不合格
19992067,57,7,89,30,6,189,不合格
19992068,8,90,2,14,14,128,不合格
19992069,68,80,39,9,79,275,不合格
19992070,35,18,98,95,76,322,合格
19992071,91,25,91,53,66,326,合格
19992072,74,44,62,56,75,311,合格
19992073,77,70,44,87,26,304,合格
19992074,12,60,94,71,35,272,不合格
19992075,84,22,92,84,30,312,合格
19992076,35,86,83,79,37,320,合格
19992077,57,46,6,22,57,188,不合格
19992078,82,95,13,93,66,349,合格
19992079,74,14,44,49,81,262,不合格
19992080,51,22,35,25,11,144,不合格
19992081,46,55,85,12,50,248,不合格
19992082,83,97,25,35,83,323,合格
19992083,72,68,38,4,56,238,不合格
19992084,40,48,87,2,96,273,不合格
19992085,15,33,73,53,60,234,不合格
19992086,48,76,28,91,39,282,不合格
19992087,96,49,34,81,40,300,合格
19992088,89,32,64,49,34,268,不合格
19992089,64,0,6,47,45,162,不合格
19992090,45,54,30,36,67,232,不合格
19992091,55,17,27,55,63,217,不合格
19992092,12,52,63,36,74,237,不合格
19992093,3,9,40,85,23,160,不合格
19992094,94,10,57,85,17,263,不合格
19992095,23,69,11,92,54,249,不合格
19992096,79,40,8,80,99,306,合格
19992097,10,46,19,96,71,242,不合格
19992098,94,0,62,35,47,238,不合格
19992099,95,8,93,33,92,321,合格
19992100,42,16,83,27,64,232,不合格
19992101,42,42,58,61,65,268,不合格
19992102,6,97,85,3,56,247,不合格
19992103,5,39,73,24,86,227,不合格
19992104,76,31,46,60,98,311,合格
19992105,61,86,39,51,72,309,合格
19992106,35,24,93,9,76,237,不合格
19992107,29,67,33,1,8,138,不合格
19992108,11,34,8,42,6,101,不合格
19992109,81,40,56,45,89,311,合格
19992110,13,96,39,26,73,247,不合格
19992111,97,43,56,54,25,275,不合格
19992112,50,86,93,46,78,353,合格
19992113,88,94,55,68,99,404,合格
19992114,47,61,46,88,32,274,不合格
19992115,10,35,16,20,71,152,不合格
19992116,38,2,59,40,61,200,不合格
19992117,22,60,77,36,32,227,不合格
19992118,93,55,80,53,46,327,合格
19992119,57,95,46,51,74,323,合格
19992120,79,5,22,47,52,205,不合格
19992121,7,21,1,72,9,110,不合格
19992122,34,52,12,99,69,266,不合格
19992123,56,49,76,31,30,242,不合格
19992124,94,39,70,62,55,320,合格
19992125,29,34,44,26,94,227,不合格
19992126,19,67,16,51,26,179,不合格
19992127,67,91,17,97,28,300,合格
19992128,35,34,89,19,59,236,不合格
19992129,32,79,86,9,27,233,不合格
19992130,7,49,5,60,57,178,不合格
19992131,86,88,95,73,24,366,合格
19992132,63,4,35,76,23,201,不合格
19992133,61,20,98,35,38,252,不合格
19992134,11,14,31,65,45,166,不合格
19992135,85,72,91,9,95,352,合格
19992136,49,36,27,9,52,173,不合格
19992137,10,12,75,76,38,211,不合格
19992138,57,47,55,29,87,275,不合格
19992139,48,48,13,94,7,210,不合格
19992140,11,96,39,87,62,295,不合格
19992141,39,34,14,39,66,192,不合格
19992142,21,52,56,47,45,221,不合格
19992143,30,8,82,77,12,209,不合格
19992144,59,91,64,10,63,287,不合格
19992145,70,26,95,50,17,258,不合格
19992146,43,73,20,94,26,256,不合格
19992147,12,93,44,25,19,193,不合格
19992148,38,23,99,25,42,227,不合格
19992149,87,37,95,36,78,333,合格
19992150,4,22,99,73,47,245,不合格
19992151,6,91,85,83,48,313,合格
19992152,1,50,83,76,1,211,不合格
19992153,62,38,53,53,24,230,不合格
19992154,0,38,63,71,16,188,不合格
19992155,18,14,48,69,30,179,不合格
19992156,30,36,66,32,92,256,不合格
19992157,62,90,80,67,74,373,合格
19992158,51,27,88,39,96,301,合格
19992159,57,58,71,54,26,266,不合格
19992160,32,39,82,87,99,339,合格
19992161,34,50,81,8,16,189,不合格
19992162,15,23,31,11,73,153,不合格
19992163,73,69,69,93,15,319,合格
19992164,38,72,74,59,4,247,不合格
19992165,52,84,80,32,60,308,合格
19992166,43,9,9,1,12,74,不合格
19992167,58,1,64,75,11,209,不合格
19992168,18,25,92,52,34,221,不合格
19992169,3,13,61,4,70,151,不合格
19992170,80,85,37,36,76,314,合格
19992171,96,1,25,67,64,253,不合格
19992172,68,3,77,80,67,295,不合格
19992173,26,0,30,49,54,159,不合格
19992174,78,56,7,77,71,289,不合格
19992175,74,39,84,22,65,284,不合格
19992176,4,75,63,43,35,220,不合格
19992177,52,26,77,88,49,292,不合格
19992178,97,23,1,62,73,256,不合格
19992179,71,83,68,61,45,328,合格
19992180,19,86,93,68,37,303,合格
19992181,64,20,26,52,82,244,不合格
19992182,70,89,42,81,41,323,合格
19992183,13,62,24,86,61,246,不合格
19992184,26,30,6,62,16,140,不合格
19992185,83,29,83,73,60,328,合格
19992186,85,72,25,22,9,213,不合格
19992187,58,2,89,51,49,249,不合格
19992188,16,21,90,36,67,230,不合格
19992189,57,37,81,40,54,269,不合格
19992190,57,74,14,29,3,177,不合格
19992191,43,81,32,54,29,239,不合格
19992192,2,74,11,74,68,229,不合格
19992193,17,82,36,3,62,200,不合格
19992194,10,2,2,61,54,129,不合格
19992195,64,98,57,92,74,385,合格
19992196,6,53,27,92,89,267,不合格
19992197,33,92,17,83,89,314,合格
19992198,62,6,18,40,22,148,不合格
19992199,95,55,12,76,8,246,不合格
19992200,61,84,88,77,75,385,合格
19992201,73,43,69,5,10,200,不合格
19992202,55,3,14,82,26,180,不合格
19992203,21,64,56,66,87,294,不合格
19992204,13,43,43,63,61,223,不合格
19992205,50,43,97,39,84,313,合格
19992206,37,49,18,99,64,267,不合格
19992207,53,49,96,42,71,311,合格
19992208,45,51,2,87,94,279,不合格
19992209,19,69,48,88,35,259,不合格
19992210,7,50,31,60,60,208,不合格
19992211,25,7,7,96,70,205,不合格
19992212,33,68,12,51,90,254,不合格
19992213,68,48,95,71,13,295,不合格
19992214,33,68,70,74,39,284,不合格
19992215,96,21,65,63,63,308,合格
19992216,7,97,72,65,18,259,不合格
19992217,86,96,82,52,50,366,合格
19992218,66,6,90,93,27,282,不合格
19992219,19,29,97,85,30,260,不合格
19992220,69,62,18,63,35,247,不合格
19992221,93,85,73,17,63,331,合格
19992222,19,45,26,97,76,263,不合格
19992223,66,60,24,73,95,318,合格
19992224,73,94,3,34,86,290,不合格
19992225,34,40,44,69,62,249,不合格
19992226,47,22,87,56,27,239,不合格
19992227,87,35,31,82,88,323,合格
19992228,73,74,73,89,57,366,合格
19992229,41,10,5,45,85,186,不合格
19992230,59,52,94,79,86,370,合格
19992231,51,29,3,63,67,213,不合格
19992232,43,71,59,56,91,320,合格
19992233,93,35,39,10,64,241,不合格
19992234,10,5,29,89,91,224,不合格
19992235,92,55,92,78,81,398,合格
19992236,78,96,56,90,4,324,合格
19992237,65,32,42,3,29,171,不合格
19992238,42,21,39,58,95,255,不合格
19992239,5,4,41,27,66,143,不合格
19992240,64,79,29,27,90,289,不合格
19992241,85,41,64,39,95,324,合格
19992242,4,41,50,33,93,221,不合格
19992243,2,49,70,60,6,187,不合格
19992244,47,82,4,42,27,202,不合格
19992245,98,66,85,33,46,328,合格
19992246,36,44,72,17,22,191,不合格
19992247,38,47,84,82,42,293,不合格
19992248,59,64,22,16,45,206,不合格
19992249,98,35,18,77,11,239,不合格
19992250,73,89,34,4,35,235,不合格
19992251,70,83,42,31,86,312,合格
19992252,9,1,61,17,84,172,不合格
19992253,7,85,77,29,58,256,不合格
19992254,9,18,84,50,65,226,不合格
19992255,89,94,97,55,26,361,合格
19992256,93,71,10,9,33,216,不合格
19992257,65,62,99,25,52,303,合格
19992258,97,14,23,24,80,238,不合格
19992259,12,64,94,99,14,283,不合格
19992260,82,71,81,67,53,354,合格
19992261,16,33,31,27,97,204,不合格
19992262,48,85,11,35,34,213,不合格
19992263,81,73,84,30,80,348,合格
19992264,83,58,3,83,50,277,不合格
19992265,95,69,24,50,51,289,不合格
19992266,37,80,4,38,71,230,不合格
19992267,75,96,51,85,74,381,合格
19992268,27,97,92,41,90,347,合格
19992269,7,26,0,66,47,146,不合格
19992270,69,91,20,30,29,239,不合格
19992271,11,83,95,50,57,296,不合格
19992272,16,37,45,20,75,193,不合格
19992273,28,63,83,4,27,205,不合格
19992274,75,23,3,87,62,250,不合格
19992275,2,43,26,40,27,138,不合格
19992276,76,3,29,35,32,175,不合格
19992277,53,17,8,97,67,242,不合格
19992278,28,91,1,4,38,162,不合格
19992279,84,67,92,99,84,426,合格
19992280,58,84,99,48,7,296,不合格
19992281,61,33,5,23,97,219,不合格
19992282,10,59,38,67,72,246,不合格
19992283,23,80,30,86,99,318,合格
19992284,79,75,85,62,15,316,合格
19992285,16,24,19,48,7,114,不合格
19992286,6,58,2,84,60,210,不合格
19992287,86,25,54,51,77,293,不合格
19992288,70,64,42,57,70,303,合格
19992289,87,27,62,33,55,264,不合格
19992290,93,86,19,22,58,278,不合格
19992291,64,2,42,37,87,232,不合格
19992292,65,67,15,29,68,244,不合格
19992293,35,82,78,16,39,250,不合格
19992294,75,14,45,75,56,265,不合格
19992295,58,5,20,63,44,190,不合格
19992296,42,68,35,21,23,189,不合格
19992297,39,72,59,79,60,309,合格
19992298,5,40,1,57,40,143,不合格
19992299,86,85,78,30,29,308,合格
19992300,99,55,7,65,10,236,不合格
19992301,14,11,44,38,52,159,不合格
19992302,14,55,36,9,64,178,不合格
19992303,14,97,33,6,59,209,不合格
19992304,13,6,92,41,20,172,不合格
19992305,18,13,70,48,12,161,不合格
19992306,12,64,4,62,45,187,不合格
19992307,38,18,36,34,40,166,不合格
19992308,4,30,91,69,44,238,不合格
19992309,47,18,28,97,65,255,不合格
19992310,51,2,76,70,89,288,不合格
19992311,33,27,31,59,40,190,不合格
19992312,77,49,84,26,16,252,不合格
19992313,21,54,20,7,52,154,不合格
19992314,66,84,84,48,53,335,合格
19992315,28,91,55,8,59,241,不合格
19992316,70,61,51,81,23,286,不合格
19992317,59,13,14,24,86,196,不合格
19992318,89,94,80,70,34,367,合格
19992319,4,22,87,77,35,225,不合格
19992320,7,95,29,25,37,193,不合格
19992321,5,23,17,72,70,187,不合格
19992322,27,71,36,71,10,215,不合格
19992323,34,57,52,38,59,240,不合格
19992324,20,85,31,27,81,244,不合格
19992325,35,96,98,50,33,312,合格
19992326,78,36,29,72,11,226,不合格
19992327,42,26,12,93,16,189,不合格
19992328,0,78,42,21,63,204,不合格
19992329,60,27,33,94,20,234,不合格
19992330,52,15,14,42,69,192,不合格
19992331,88,15,60,38,15,216,不合格
19992332,12,47,46,50,24,179,不合格
19992333,5,66,84,25,26,206,不合格
19992334,7,24,74,96,53,254,不合格
19992335,15,27,8,15,38,103,不合格
19992336,81,0,78,9,27,195,不合格
19992337,8,36,68,92,10,214,不合格
19992338,32,31,84,97,93,337,合格
19992339,90,99,30,81,1,301,合格
19992340,8,24,22,68,75,197,不合格
19992341,25,18,68,94,57,262,不合格
19992342,53,70,72,19,59,273,不合格
19992343,57,74,0,73,17,221,不合格
19992344,11,62,15,93,54,235,不合格
19992345,17,55,41,67,82,262,不合格
19992346,12,19,10,16,7,64,不合格
19992347,8,76,4,37,99,224,不合格
19992348,34,54,45,6,21,160,不合格
19992349,4,81,66,83,40,274,不合格
19992350,35,46,39,15,63,198,不合格
19992351,25,45,34,89,12,205,不合格
19992352,49,9,52,83,69,262,不合格
19992353,90,92,47,29,23,281,不合格
19992354,29,55,84,65,17,250,不合格
19992355,21,72,30,40,74,237,不合格
19992356,28,0,30,35,7,100,不合格
19992357,2,66,42,48,99,257,不合格
19992358,63,83,98,8,2,254,不合格
19992359,79,64,67,12,38,260,不合格
19992360,80,59,71,12,81,303,合格
19992361,2,40,38,25,15,120,不合格
19992362,61,87,47,0,11,206,不合格
19992363,54,22,89,79,96,340,合格
19992364,44,63,16,79,37,239,不合格
19992365,56,97,97,14,50,314,合格
19992366,39,93,32,0,58,222,不合格
19992367,52,88,10,97,36,283,不合格
19992368,20,7,5,10,69,111,不合格
19992369,65,92,45,88,28,318,合格
19992370,23,59,14,50,56,202,不合格
19992371,74,4,22,98,35,233,不合格
19992372,36,4,73,70,99,282,不合格
19992373,8,73,71,6,52,210,不合格
19992374,55,92,4,58,57,266,不合格
19992375,47,15,89,91,5,247,不合格
19992376,16,42,89,70,82,299,不合格
19992377,21,74,87,23,55,260,不合格
19992378,61,77,39,6,40,223,不合格
19992379,64,30,75,85,32,286,不合格
19992380,17,35,9,71,6,138,不合格
19992381,8,45,96,92,5,246,不合格
19992382,40,65,60,4,67,236,不合格
19992383,57,27,21,6,56,167,不合格
19992384,6,98,57,79,23,263,不合格
19992385,80,97,28,11,82,298,不合格
19992386,92,92,4,66,28,282,不合格
19992387,40,31,47,88,71,277,不合格
19992388,72,15,54,36,89,266,不合格
19992389,61,43,36,11,38,189,不合格
19992390,21,61,97,36,50,265,不合格
19992391,36,49,7,10,65,167,不合格
19992392,78,63,17,87,82,327,合格
19992393,50,6,86,61,41,244,不合格
19992394,95,16,34,96,91,332,合格
19992395,97,73,87,67,11,335,合格
19992396,12,34,73,90,97,306,合格
19992397,60,45,62,31,80,278,不合格
19992398,86,28,7,1,83,205,不合格
19992399,77,89,52,9,57,284,不合格
19992400,41,26,14,72,78,231,不合格
19992401,15,6,3,75,57,156,不合格
19992402,70,34,39,28,55,226,不合格
19992403,62,16,25,81,26,210,不合格
19992404,82,32,23,51,3,191,不合格
19992405,4,81,16,39,88,228,不合格
19992406,66,31,29,81,34,241,不合格
19992407,91,45,17,55,50,258,不合格
19992408,90,26,30,34,33,213,不合格
19992409,28,52,32,29,93,234,不合格
19992410,84,50,69,69,56,328,合格
19992411,25,8,53,46,29,161,不合格
19992412,46,55,88,79,45,313,合格
19992413,43,70,68,29,91,301,合格
19992414,32,13,73,16,57,191,不合格
19992415,59,1,47,50,96,253,不合格
19992416,91,84,15,51,16,257,不合格
19992417,34,68,57,1,71,231,不合格
19992418,27,48,17,61,67,220,不合格
19992419,83,79,84,45,66,357,合格
19992420,31,25,31,76,39,202,不合格
19992421,11,59,8,27,35,140,不合格
19992422,57,67,92,70,0,286,不合格
19992423,50,31,99,42,7,229,不合格
19992424,97,55,24,28,59,263,不合格
19992425,89,63,59,58,86,355,合格
19992426,17,30,58,25,14,144,不合格
19992427,89,94,6,68,81,338,合格
19992428,50,55,26,6,73,210,不合格
19992429,39,14,79,67,89,288,不合格
19992430,45,27,67,23,50,212,不合格
19992431,27,78,37,25,0,167,不合格
19992432,90,11,81,79,14,275,不合格
19992433,83,35,51,92,93,354,合格
19992434,87,95,4,37,0,223,不合格
19992435,7,88,1,58,74,228,不合格
19992436,31,55,73,16,94,269,不合格
19992437,25,19,20,89,64,217,不合格
19992438,34,78,50,43,21,226,不合格
19992439,54,35,22,64,12,187,不合格
19992440,60,68,48,6,26,208,不合格
19992441,27,31,24,22,66,170,不合格
19992442,34,23,86,85,86,314,合格
19992443,16,21,20,76,78,211,不合格
19992444,97,74,8,91,43,313,合格
19992445,88,18,35,69,31,241,不合格
19992446,28,94,36,38,36,232,不合格
19992447,84,63,85,83,87,402,合格
19992448,72,57,5,26,50,210,不合格
19992449,36,65,85,45,85,316,合格
19992450,20,83,27,36,30,196,不合格
19992451,28,10,27,14,12,91,不合格
19992452,5,34,8,43,69,159,不合格
19992453,6,70,60,16,46,198,不合格
19992454,92,56,2,89,78,317,合格
19992455,13,25,46,22,71,177,不合格
19992456,93,54,26,91,45,309,合格
19992457,47,32,69,73,85,306,合格
19992458,94,29,2,42,81,248,不合格
19992459,60,88,75,25,68,316,合格
19992460,53,42,59,29,32,215,不合格
19992461,25,94,85,21,78,303,合格
19992462,74,21,53,72,73,293,不合格
19992463,61,19,18,65,41,204,不合格
19992464,26,23,13,65,21,148,不合格
19992465,7,65,72,98,75,317,合格
19992466,98,12,90,85,11,296,不合格
19992467,96,85,68,61,58,368,合格
19992468,88,40,60,6,19,213,不合格
19992469,66,77,41,6,41,231,不合格
19992470,64,17,38,91,66,276,不合格
19992471,12,94,29,13,80,228,不合格
19992472,59,83,57,36,67,302,合格
19992473,24,65,46,35,47,217,不合格
19992474,60,51,66,76,98,351,合格
19992475,78,44,27,68,24,241,不合格
19992476,75,22,96,8,98,299,不合格
19992477,62,44,40,62,95,303,合格
19992478,31,62,51,1,10,155,不合格
19992479,45,20,93,52,14,224,不合格
19992480,68,50,48,22,37,225,不合格
19992481,29,30,63,19,92,233,不合格
19992482,59,99,87,28,54,327,合格
19992483,79,48,96,18,77,318,合格
19992484,67,94,25,5,90,281,不合格
19992485,54,97,67,56,29,303,合格
19992486,33,6,23,59,77,198,不合格
19992487,83,78,48,65,83,357,合格
19992488,86,98,59,0,59,302,合格
19992489,16,15,80,3,26,140,不合格
19992490,88,32,23,8,13,164,不合格
19992491,87,48,49,65,76,325,合格
19992492,73,57,42,47,74,293,不合格
19992493,38,62,52,36,65,253,不合格
19992494,55,90,62,8,8,223,不合格
19992495,1,7,10,25,50,93,不合格
19992496,84,38,23,46,32,223,不合格
19992497,68,0,1,1,21,91,不合格
19992498,46,41,56,15,22,180,不合格
19992499,1,96,45,89,91,322,合格
19992500,79,95,58,36,63,331,合格
19992501,24,83,8,56,47,218,不合格
19992502,35,17,72,29,16,169,不合格
19992503,13,2,1,64,12,92,不合格
19992504,24,12,60,80,27,203,不合格
19992505,6,33,61,3,62,165,不合格
19992506,35,58,11,80,25,209,不合格
19992507,75,61,57,49,92,334,合格
19992508,27,2,74,98,8,209,不合格
19992509,76,5,53,10,26,170,不合格
19992510,51,0,28,90,86,255,不合格
19992511,92,31,52,27,89,291,不合格
19992512,80,11,91,65,53,300,合格
19992513,79,9,9,24,46,167,不合格
19992514,44,48,50,55,63,260,不合格
19992515,75,28,6,88,35,232,不合格
19992516,80,44,54,37,69,284,不合格
19992517,47,31,76,53,16,223,不合格
19992518,48,91,1,60,21,221,不合格
19992519,77,7,72,47,70,273,不合格
19992520,96,41,27,30,9,203,不合格
19992521,46,72,89,14,16,237,不合格
19992522,47,50,16,40,7,160,不合格
19992523,61,86,82,24,32,285,不合格
19992524,65,26,29,24,40,184,不合格
19992525,10,69,3,84,8,174,不合格
19992526,60,49,0,10,67,186,不合格
19992527,69,5,47,36,77,234,不合格
19992528,96,51,95,72,1,315,合格
19992529,84,92,61,69,6,312,合格
19992530,19,50,98,0,44,211,不合格
19992531,22,48,98,1,53,222,不合格
19992532,92,12,43,41,43,231,不合格
19992533,47,48,82,74,61,312,合格
19992534,18,81,33,34,59,225,不合格
19992535,70,17,97,65,2,251,不合格
19992536,72,22,75,3,74,246,不合格
19992537,91,83,21,64,59,318,合格
19992538,86,79,62,56,63,346,合格
19992539,81,62,99,30,62,334,合格
19992540,11,9,73,67,15,175,不合格
19992541,68,86,89,55,49,347,合格
19992542,78,80,88,55,44,345,合格
19992543,82,58,77,28,20,265,不合格
19992544,87,3,21,51,60,222,不合格
19992545,79,35,68,54,7,243,不合格
19992546,78,88,20,45,34,265,不合格
19992547,98,33,49,25,27,232,不合格
19992548,83,93,20,86,13,295,不合格
19992549,47,93,28,0,2,170,不合格
19992550,50,23,55,16,90,234,不合格
19992551,84,64,66,25,0,239,不合格
19992552,89,74,37,33,79,312,合格
19992553,74,71,64,20,10,239,不合格
19992554,87,33,97,3,20,240,不合格
19992555,81,73,73,97,14,338,合格
19992556,49,33,10,2,80,174,不合格
19992557,45,71,26,70,51,263,不合格
19992558,63,80,97,5,51,296,不合格
19992559,28,51,58,65,71,273,不合格
19992560,15,86,1,57,2,161,不合格
19992561,81,82,92,15,58,328,合格
19992562,95,21,10,66,21,213,不合格
19992563,25,47,77,80,89,318,合格
19992564,52,74,24,59,20,229,不合格
19992565,1,58,72,36,9,176,不合格
19992566,73,45,25,28,34,205,不合格
19992567,72,7,91,76,32,278,不合格
19992568,92,54,94,63,45,348,合格
19992569,99,82,24,84,7,296,不合格
19992570,31,39,10,64,92,236,不合格
19992571,23,0,64,13,20,120,不合格
19992572,89,51,55,56,43,294,不合格
19992573,91,1,99,67,75,333,合格
19992574,44,23,46,45,85,243,不合格
19992575,4,55,25,68,92,244,不合格
19992576,40,56,32,15,23,166,不合格
19992577,98,20,15,27,99,259,不合格
19992578,13,68,10,67,99,257,不合格
19992579,47,24,98,95,28,292,不合格
19992580,14,19,73,91,56,253,不合格
19992581,51,37,27,53,39,207,不合格
19992582,25,28,46,40,53,192,不合格
19992583,0,47,96,47,19,209,不合格
19992584,3,35,38,86,84,246,不合格
19992585,36,34,33,15,64,182,不合格
19992586,93,24,72,54,97,340,合格
19992587,24,8,1,38,32,103,不合格
19992588,53,64,65,77,4,263,不合格
19992589,92,6,56,21,77,252,不合格
19992590,3,5,45,4,81,138,不合格
19992591,73,56,70,31,63,293,不合格
19992592,78,56,66,81,89,370,合格
19992593,43,57,97,11,66,274,不合格
19992594,6,21,5,8,32,72,不合格
19992595,25,3,27,66,29,150,不合格
19992596,59,40,65,19,31,214,不合格
19992597,22,88,32,82,69,293,不合格
19992598,83,95,98,2,70,348,合格
19992599,38,70,74,80,35,297,不合格
19992600,94,85,27,46,99,351,合格
19992601,60,14,94,86,62,316,合格
19992602,86,52,95,23,16,272,不合格
19992603,63,66,35,3,63,230,不合格
19992604,31,43,74,13,54,215,不合格
19992605,56,70,89,91,4,310,合格
19992606,22,7,61,35,2,127,不合格
19992607,10,87,4,68,54,223,不合格
19992608,47,35,68,53,84,287,不合格
19992609,9,96,67,99,93,364,合格
19992610,75,0,43,22,63,203,不合格
19992611,6,1,27,90,93,217,不合格
19992612,95,17,32,59,45,248,不合格
19992613,1,35,18,88,55,197,不合格
19992614,5,14,35,42,14,110,不合格
19992615,14,74,6,43,24,161,不合格
19992616,86,77,52,35,4,254,不合格
19992617,96,83,87,27,72,365,合格
19992618,53,60,17,38,21,189,不合格
19992619,63,2,36,38,77,216,不合格
19992620,37,70,93,12,18,230,不合格
19992621,78,86,14,90,3,271,不合格
19992622,69,55,91,45,76,336,合格
19992623,11,58,74,40,65,248,不合格
19992624,77,35,30,41,99,282,不合格
19992625,10,28,18,36,5,97,不合格
19992626,92,81,55,97,45,370,合格
19992627,73,85,67,74,97,396,合格
19992628,4,85,5,99,76,269,不合格
19992629,70,63,31,94,12,270,不合格
19992630,31,40,69,84,56,280,不合格
19992631,70,52,87,8,21,238,不合格
19992632,3,32,60,83,59,237,不合格
19992633,29,77,52,88,21,267,不合格
19992634,88,95,22,10,26,241,不合格
19992635,79,44,21,27,96,267,不合格
19992636,6,40,47,70,61,224,不合格
19992637,29,7,46,13,13,108,不合格
19992638,5,68,78,17,63,231,不合格
19992639,69,15,70,83,63,300,合格
19992640,10,32,36,37,54,169,不合格
19992641,76,78,94,83,19,350,合格
19992642,54,70,50,53,76,303,合格
19992643,79,69,58,51,9,266,不合格
19992644,38,75,88,98,58,357,合格
19992645,14,47,56,65,82,264,不合格
19992646,42,0,77,52,66,237,不合格
19992647,37,66,35,4,56,198,不合格
19992648,7,43,81,11,2,144,不合格
19992649,25,4,6,29,7,71,不合格
19992650,29,76,46,55,94,300,合格
19992651,9,42,24,47,42,164,不合格
19992652,64,80,98,0,73,315,合格
19992653,25,83,16,56,53,233,不合格
19992654,66,15,25,12,75,193,不合格
19992655,35,49,34,23,99,240,不合格
19992656,45,77,42,17,27,208,不合格
19992657,1,9,20,13,76,119,不合格
19992658,49,88,79,82,88,386,合格
19992659,41,16,91,2,24,174,不合格
19992660,56,7,92,78,50,283,不合格
19992661,50,55,94,35,51,285,不合格
19992662,29,67,61,8,67,232,不合格
19992663,20,26,23,9,89,167,不合格
19992664,9,92,1,8,39,149,不合格
19992665,43,21,10,50,73,197,不合格
19992666,7,56,84,55,25,227,不合格
19992667,1,42,20,36,59,158,不合格
19992668,63,38,16,92,44,253,不合格
19992669,8,88,0,95,49,240,不合格
19992670,37,11,6,70,90,214,不合格
19992671,79,56,28,64,94,321,合格
19992672,16,25,8,30,80,159,不合格
19992673,17,4,24,3,4,52,不合格
19992674,91,76,39,12,88,306,合格
19992675,79,61,55,74,69,338,合格
19992676,35,0,49,91,72,247,不合格
19992677,74,96,36,59,71,336,合格
19992678,72,53,50,81,12,268,不合格
19992679,33,28,75,60,41,237,不合格
19992680,90,37,21,53,83,284,不合格
19992681,47,72,2,45,90,256,不合格
19992682,29,57,12,86,35,219,不合格
19992683,37,6,61,67,62,233,不合格
19992684,52,15,20,64,28,179,不合格
19992685,68,72,62,20,58,280,不合格
19992686,56,60,46,52,88,302,合格
19992687,34,51,87,47,55,274,不合格
19992688,48,95,26,71,67,307,合格
19992689,38,22,74,30,34,198,不合格
19992690,98,82,29,78,54,341,合格
19992691,87,48,84,82,55,356,合格
19992692,76,64,40,98,71,349,合格
19992693,23,80,62,76,55,296,不合格
19992694,2,24,47,25,67,165,不合格
19992695,80,21,19,51,87,258,不合格
19992696,26,50,80,84,12,252,不合格
19992697,21,42,70,47,0,180,不合格
19992698,77,90,89,40,23,319,合格
19992699,94,45,96,27,99,361,合格
19992700,19,59,13,4,40,135,不合格
19992701,44,68,6,13,64,195,不合格
19992702,74,40,15,15,95,239,不合格
19992703,16,64,37,53,34,204,不合格
19992704,75,4,23,1,71,174,不合格
19992705,68,71,41,46,96,322,合格
19992706,14,14,69,76,63,236,不合格
19992707,93,19,65,93,15,285,不合格
19992708,63,46,46,11,92,258,不合格
19992709,5,8,74,62,96,245,不合格
19992710,39,38,21,14,98,210,不合格
19992711,17,16,8,48,39,128,不合格
19992712,32,66,15,90,81,284,不合格
19992713,22,70,45,64,32,233,不合格
19992714,31,60,49,10,18,168,不合格
19992715,9,3,63,19,52,146,不合格
19992716,70,16,55,25,74,240,不合格
19992717,34,81,11,47,69,242,不合格
19992718,53,52,31,84,28,248,不合格
19992719,7,65,10,83,25,190,不合格
19992720,11,16,11,99,35,172,不合格
19992721,93,84,40,93,23,333,合格
19992722,33,91,52,52,51,279,不合格
19992723,47,45,26,26,8,152,不合格
19992724,13,25,87,47,61,233,不合格
19992725,20,90,49,34,6,199,不合格
19992726,23,8,42,2,73,148,不合格
19992727,37,73,29,4,61,204,不合格
19992728,59,31,23,13,26,152,不合格
19992729,95,57,37,43,93,325,合格
19992730,63,16,24,45,89,237,不合格
19992731,30,9,53,99,15,206,不合格
19992732,28,15,78,33,72,226,不合格
19992733,76,1,26,1,25,129,不合格
19992734,1,85,7,23,33,149,不合格
19992735,60,4,76,82,75,297,不合格
19992736,42,61,1,41,80,225,不合格
19992737,58,3,33,53,97,244,不合格
19992738,47,23,12,7,20,109,不合格
19992739,11,16,9,93,32,161,不合格
19992740,24,18,27,55,9,133,不合格
19992741,31,62,77,48,39,257,不合格
19992742,94,91,32,27,53,297,不合格
19992743,4,57,84,77,5,227,不合格
19992744,16,69,71,81,84,321,合格
19992745,48,77,12,89,75,301,合格
19992746,10,97,31,95,88,321,合格
19992747,30,56,70,49,56,261,不合格
19992748,19,26,37,59,85,226,不合格
19992749,92,81,38,20,24,255,不合格
19992750,14,94,65,44,18,235,不合格
19992751,73,29,88,30,7,227,不合格
19992752,96,8,41,6,90,241,不合格
19992753,38,75,99,67,0,279,不合格
19992754,40,92,11,91,58,292,不合格
19992755,35,2,19,89,8,153,不合格
19992756,43,60,13,91,30,237,不合格
19992757,52,3,27,47,43,172,不合格
19992758,58,94,85,87,15,339,合格
19992759,38,14,69,20,37,178,不合格
19992760,76,30,95,82,50,333,合格
19992761,37,4,5,76,25,147,不合格
19992762,64,38,51,98,89,340,合格
19992763,84,59,7,38,58,246,不合格
19992764,16,19,79,30,3,147,不合格
19992765,21,36,0,21,80,158,不合格
19992766,57,61,32,76,50,276,不合格
19992767,66,52,8,57,74,257,不合格
19992768,64,80,57,98,80,379,合格
19992769,58,95,14,57,45,269,不合格
19992770,83,35,56,31,68,273,不合格
19992771,69,55,53,71,90,338,合格
19992772,33,11,28,54,91,217,不合格
19992773,86,43,35,89,54,307,合格
19992774,58,61,25,77,38,259,不合格
19992775,55,36,80,91,2,264,不合格
19992776,84,5,4,3,0,96,不合格
19992777,48,66,89,81,86,370,合格
19992778,93,2,16,45,21,177,不合格
19992779,22,39,39,91,90,281,不合格
19992780,14,66,81,16,52,229,不合格
19992781,68,29,82,97,76,352,合格
19992782,76,81,7,87,50,301,合格
19992783,20,30,5,72,83,210,不合格
19992784,13,91,21,3,81,209,不合格
19992785,89,62,48,74,59,332,合格
19992786,81,22,83,18,85,289,不合格
19992787,75,25,39,87,58,284,不合格
19992788,53,43,90,42,42,270,不合格
19992789,16,58,23,12,82,191,不合格
19992790,5,44,99,27,1,176,不合格
19992791,10,8,1,53,76,148,不合格
19992792,80,1,16,98,74,269,不合格
19992793,74,75,7,2,23,181,不合格
19992794,2,63,36,88,16,205,不合格
19992795,30,87,42,2,34,195,不合格
19992796,49,10,94,35,48,236,不合格
19992797,13,22,89,92,68,284,不合格
19992798,71,46,24,88,23,252,不合格
19992799,63,11,36,84,97,291,不合格
19992800,50,0,7,3,61,121,不合格
19992801,46,25,59,4,84,218,不合格
19992802,73,92,55,11,54,285,不合格
19992803,20,47,18,54,29,168,不合格
19992804,90,61,94,14,46,305,合格
19992805,3,4,47,76,18,148,不合格
19992806,97,59,87,70,22,335,合格
19992807,91,87,30,57,60,325,合格
19992808,28,6,81,52,44,211,不合格
19992809,4,54,97,9,33,197,不合格
19992810,99,89,63,75,70,396,合格
19992811,67,67,42,21,39,236,不合格
19992812,43,76,6,43,72,240,不合格
19992813,32,41,85,54,75,287,不合格
19992814,89,77,80,32,85,363,合格
19992815,44,68,90,39,47,288,不合格
19992816,68,96,56,42,16,278,不合格
19992817,86,79,32,74,27,298,不合格
19992818,66,99,50,21,31,267,不合格
19992819,63,17,47,4,37,168,不合格
19992820,22,18,95,99,86,320,合格
19992821,92,49,51,85,27,304,合格
19992822,47,35,86,99,4,271,不合格
19992823,11,83,51,42,61,248,不合格
19992824,38,39,49,72,23,221,不合格
19992825,12,45,73,99,7,236,不合格
19992826,30,25,30,53,94,232,不合格
19992827,28,5,44,40,95,212,不合格
19992828,98,68,51,63,31,311,合格
19992829,7,0,29,31,36,103,不合格
19992830,48,29,34,7,49,167,不合格
19992831,76,98,56,19,62,311,合格
19992832,85,5,35,14,96,235,不合格
19992833,32,26,94,84,98,334,合格
19992834,5,61,5,87,30,188,不合格
19992835,90,20,9,6,71,196,不合格
19992836,76,71,65,99,43,354,合格
19992837,70,77,68,60,32,307,合格
19992838,79,58,65,74,41,317,合格
19992839,75,37,84,94,55,345,合格
19992840,91,50,15,36,30,222,不合格
19992841,12,67,59,23,86,247,不合格
19992842,66,70,61,50,47,294,不合格
19992843,21,45,29,97,90,282,不合格
19992844,10,4,73,58,27,172,不合格
19992845,3,59,58,44,78,242,不合格
19992846,44,15,0,5,75,139,不合格
19992847,31,1,91,43,39,205,不合格
19992848,76,90,38,17,96,317,合格
19992849,2,65,51,98,33,249,不合格
19992850,24,10,17,48,2,101,不合格
19992851,5,6,10,53,15,89,不合格
19992852,34,20,36,32,20,142,不合格
19992853,9,80,78,97,47,311,合格
19992854,47,31,49,0,22,149,不合格
19992855,67,8,11,34,29,149,不合格
19992856,71,88,16,47,80,302,合格
19992857,67,0,2,28,55,152,不合格
19992858,91,68,47,77,0,283,不合格
19992859,7,9,10,53,0,79,不合格
19992860,24,95,30,80,88,317,合格
19992861,10,89,46,94,33,272,不合格
19992862,96,26,58,57,51,288,不合格
19992863,10,51,12,92,19,184,不合格
19992864,89,13,73,45,37,257,不合格
19992865,77,76,7,29,75,264,不合格
19992866,60,99,4,0,99,262,不合格
19992867,65,60,18,55,34,232,不合格
19992868,77,72,50,8,5,212,不合格
19992869,60,12,13,27,96,208,不合格
19992870,46,41,6,62,89,244,不合格
19992871,9,52,33,16,8,118,不合格
19992872,87,43,44,96,78,348,合格
19992873,53,36,58,78,92,317,合格
19992874,80,5,54,23,39,201,不合格
19992875,47,25,35,92,63,262,不合格
19992876,7,64,93,93,35,292,不合格
19992877,37,73,30,23,25,188,不合格
19992878,20,18,67,90,36,231,不合格
19992879,69,54,38,66,95,322,合格
19992880,97,27,40,45,18,227,不合格
19992881,70,33,83,38,40,264,不合格
19992882,44,18,32,18,18,130,不合格
19992883,61,3,44,43,26,177,不合格
19992884,22,87,40,82,24,255,不合格
19992885,97,93,87,91,40,408,合格
19992886,92,50,9,97,69,317,合格
19992887,49,96,99,64,93,401,合格
19992888,42,18,8,20,47,135,不合格
19992889,41,29,34,91,85,280,不合格
19992890,82,17,95,44,18,256,不合格
19992891,88,95,73,79,68,403,合格
19992892,94,39,39,38,40,250,不合格
19992893,76,21,29,94,8,228,不合格
19992894,90,24,1,56,9,180,不合格
19992895,80,85,46,2,41,254,不合格
19992896,42,12,31,21,91,197,不合格
19992897,82,30,87,46,17,262,不合格
19992898,43,94,76,2,31,246,不合格
19992899,55,5,64,96,21,241,不合格
19992900,71,65,87,94,62,379,合格
19992901,45,49,73,62,73,302,合格
19992902,53,84,82,32,30,281,不合格
19992903,89,33,42,22,27,213,不合格
19992904,39,46,60,33,39,217,不合格
19992905,48,65,45,97,53,308,合格
19992906,34,73,62,66,23,258,不合格
19992907,53,50,81,47,97,328,合格
19992908,31,72,89,10,96,298,不合格
19992909,44,94,25,60,88,311,合格
19992910,4,55,72,18,12,161,不合格
19992911,51,90,13,88,85,327,合格
19992912,2,39,76,92,70,279,不合格
19992913,10,98,75,9,0,192,不合格
19992914,41,39,11,9,6,106,不合格
19992915,63,8,69,33,47,220,不合格
19992916,24,85,51,58,17,235,不合格
19992917,50,8,73,41,36,208,不合格
19992918,16,23,81,18,61,199,不合格
19992919,42,73,98,17,65,295,不合格
19992920,40,97,53,83,88,361,合格
19992921,54,67,52,72,52,297,不合格
19992922,25,82,92,94,41,334,合格
19992923,99,77,70,39,26,311,合格
19992924,6,27,66,62,57,218,不合格
19992925,40,67,57,96,61,321,合格
19992926,62,79,11,70,84,306,合格
19992927,22,53,95,7,60,237,不合格
19992928,77,89,31,24,55,276,不合格
19992929,89,77,1,92,10,269,不合格
19992930,65,79,67,90,51,352,合格
19992931,87,80,15,59,27,268,不合格
19992932,41,37,45,1,36,160,不合格
19992933,21,87,23,91,57,279,不合格
19992934,56,26,68,78,83,311,合格
19992935,61,78,10,63,14,226,不合格
19992936,97,89,92,68,24,370,合格
19992937,22,81,14,27,4,148,不合格
19992938,25,45,51,27,72,220,不合格
19992939,25,98,61,74,62,320,合格
19992940,77,81,65,96,15,334,合格
19992941,43,80,97,94,43,357,合格
19992942,69,14,56,38,79,256,不合格
19992943,88,23,56,57,90,314,合格
19992944,50,19,0,18,92,179,不合格
19992945,43,95,68,54,94,354,合格
19992946,63,3,38,73,71,248,不合格
19992947,61,18,45,18,31,173,不合格
19992948,10,51,93,20,39,213,不合格
19992949,1,92,26,22,82,223,不合格
19992950,59,69,12,50,53,243,不合格
19992951,76,54,99,75,48,352,合格
19992952,34,6,3,93,75,211,不合格
19992953,70,81,48,48,86,333,合格
19992954,89,49,89,2,52,281,不合格
19992955,69,99,10,13,8,199,不合格
19992956,46,77,10,96,70,299,不合格
19992957,11,29,57,96,80,273,不合格
19992958,75,0,21,24,90,210,不合格
19992959,74,0,71,4,58,207,不合格
19992960,76,0,60,19,12,167,不合格
19992961,84,84,16,16,29,229,不合格
19992962,57,83,14,47,45,246,不合格
19992963,65,27,17,16,29,154,不合格
19992964,80,67,45,31,2,225,不合格
19992965,92,30,43,30,55,250,不合格
19992966,40,54,73,26,49,242,不合格
19992967,97,30,90,7,1,225,不合格
19992968,52,37,50,48,39,226,不合格
19992969,14,84,5,74,99,276,不合格
19992970,61,44,3,16,6,130,不合格
19992971,94,66,91,15,29,295,不合格
19992972,21,27,9,67,20,144,不合格
19992973,91,95,80,51,15,332,合格
19992974,29,19,65,8,91,212,不合格
19992975,42,79,93,38,55,307,合格
19992976,24,7,4,70,41,146,不合格
19992977,10,62,82,28,85,267,不合格
19992978,47,54,38,86,28,253,不合格
19992979,47,60,3,19,6,135,不合格
19992980,74,10,5,60,80,229,不合格
19992981,45,48,83,43,3,222,不合格
19992982,59,0,91,66,50,266,不合格
19992983,73,2,12,13,68,168,不合格
19992984,86,7,81,47,35,256,不合格
19992985,12,3,13,38,13,79,不合格
19992986,61,18,59,20,36,194,不合格
19992987,1,37,38,28,43,147,不合格
19992988,84,48,43,0,29,204,不合格
19992989,78,40,97,30,36,281,不合格
19992990,76,44,43,50,84,297,不合格
19992991,51,58,33,29,96,267,不合格
19992992,24,97,69,64,73,327,合格
19992993,64,47,85,58,69,323,合格
19992994,53,92,87,71,43,346,合格
19992995,18,5,75,92,55,245,不合格
19992996,12,21,87,18,36,174,不合格
19992997,14,14,95,21,42,186,不合格
19992998,66,96,48,74,32,316,合格
19992999,43,45,91,66,29,274,不合格
19993000,92,88,86,83,83,432,合格
19993001,32,7,28,91,60,218,不合格
19993002,42,90,52,59,69,312,合格
19993003,52,59,64,94,13,282,不合格
19993004,68,39,59,7,65,238,不合格
19993005,43,55,43,82,56,279,不合格
19993006,59,57,25,20,7,168,不合格
19993007,59,64,53,25,8,209,不合格
19993008,28,17,79,89,14,227,不合格
19993009,5,27,54,30,90,206,不合格
19993010,19,98,93,1,19,230,不合格
19993011,8,49,4,50,19,130,不合格
19993012,49,45,97,30,99,320,合格
19993013,55,3,69,56,93,276,不合格
19993014,49,64,96,31,56,296,不合格
19993015,78,97,74,44,44,337,合格
19993016,94,56,67,96,65,378,合格
19993017,80,82,93,63,73,391,合格
19993018,80,62,88,35,36,301,合格
19993019,24,99,99,21,50,293,不合格
19993020,35,52,7,83,5,182,不合格
19993021,90,59,52,73,88,362,合格
19993022,17,16,81,72,14,200,不合格
19993023,59,36,52,70,9,226,不合格
19993024,57,36,80,78,71,322,合格
19993025,34,59,44,92,70,299,不合格
19993026,36,57,44,84,66,287,不合格
19993027,8,49,61,33,20,171,不合格
19993028,90,51,35,3,55,234,不合格
19993029,43,11,63,28,96,241,不合格
19993030,96,84,4,56,83,323,合格
19993031,54,43,66,65,73,301,合格
19993032,61,61,96,15,26,259,不合格
19993033,59,42,7,67,99,274,不合格
19993034,70,71,17,38,70,266,不合格
19993035,71,73,1,56,45,246,不合格
19993036,57,80,78,37,61,313,合格
19993037,42,4,32,26,67,171,不合格
19993038,3,66,43,5,60,177,不合格
19993039,21,40,84,95,71,311,合格
19993040,37,54,3,1,35,130,不合格
19993041,25,7,64,38,29,163,不合格
19993042,87,48,28,94,39,296,不合格
19993043,45,51,99,15,74,284,不合格
19993044,90,46,27,22,58,243,不合格
19993045,22,42,42,10,61,177,不合格
19993046,17,66,86,84,5,258,不合格
19993047,61,35,36,87,69,288,不合格
19993048,29,45,27,65,41,207,不合格
19993049,17,70,20,78,3,188,不合格
19993050,58,7,59,76,38,238,不合格
19993051,47,67,6,64,3,187,不合格
19993052,45,20,42,21,28,156,不合格
19993053,3,38,40,5,91,177,不合格
19993054,77,54,4,46,76,257,不合格
19993055,26,99,71,94,23,313,合格
19993056,61,82,88,91,30,352,合格
19993057,75,20,49,24,26,194,不合格
19993058,25,13,95,39,81,253,不合格
19993059,37,71,8,48,4,168,不合格
19993060,28,99,1,82,73,283,不合格
19993061,82,91,54,58,26,311,合格
19993062,22,27,84,64,82,279,不合格
19993063,89,47,76,72,86,370,合格
19993064,17,45,58,34,66,220,不合格
19993065,92,85,77,55,63,372,合格
19993066,74,23,62,79,73,311,合格
19993067,22,14,17,23,65,141,不合格
19993068,92,50,53,50,33,278,不合格
19993069,58,33,72,75,0,238,不合格
19993070,61,12,78,10,40,201,不合格
19993071,65,69,53,26,14,227,不合格
19993072,20,75,33,85,7,220,不合格
19993073,17,59,60,6,76,218,不合格
19993074,70,8,53,93,53,277,不合格
19993075,95,24,55,88,21,283,不合格
19993076,37,91,54,66,11,259,不合格
19993077,16,61,52,3,50,182,不合格
19993078,26,3,42,90,7,168,不合格
19993079,46,19,49,40,28,182,不合格
19993080,82,6,29,16,11,144,不合格
19993081,51,57,12,40,89,249,不合格
19993082,59,69,83,55,8,274,不合格
19993083,0,13,39,88,34,174,不合格
19993084,75,71,30,54,87,317,合格
19993085,59,57,49,32,21,218,不合格
19993086,7,63,10,17,6,103,不合格
19993087,46,88,29,27,33,223,不合格
19993088,17,55,36,23,23,154,不合格
19993089,41,14,78,97,46,276,不合格
19993090,22,97,76,78,97,370,合格
19993091,71,87,74,57,95,384,合格
19993092,97,81,60,47,66,351,合格
19993093,16,35,5,61,93,210,不合格
19993094,33,91,75,83,46,328,合格
19993095,3,67,88,70,50,278,不合格
19993096,67,89,40,92,19,307,合格
19993097,67,86,80,13,74,320,合格
19993098,24,64,12,42,94,236,不合格
19993099,28,95,59,92,46,320,合格
19993100,65,2,81,26,95,269,不合格
19993101,2,53,1,29,81,166,不合格
19993102,69,56,23,96,85,329,合格
19993103,75,50,80,66,37,308,合格
19993104,30,94,59,23,93,299,不合格
19993105,88,83,0,61,77,309,合格
19993106,2,24,49,36,91,202,不合格
19993107,8,36,96,10,33,183,不合格
19993108,76,7,48,5,87,223,不合格
19993109,44,13,84,77,88,306,合格
19993110,36,95,40,80,85,336,合格
19993111,62,21,38,28,62,211,不合格
19993112,59,26,64,84,86,319,合格
19993113,49,16,70,8,2,145,不合格
19993114,13,56,25,50,47,191,不合格
19993115,3,92,4,21,73,193,不合格
19993116,87,74,30,27,5,223,不合格
19993117,95,82,26,86,61,350,合格
19993118,18,52,82,75,33,260,不合格
19993119,56,98,45,39,97,335,合格
19993120,66,71,94,28,90,349,合格
19993121,39,26,51,14,68,198,不合格
19993122,6,11,29,5,51,102,不合格
19993123,67,24,11,95,84,281,不合格
19993124,9,91,23,48,84,255,不合格
19993125,16,2,19,82,20,139,不合格
19993126,85,20,6,71,68,250,不合格
19993127,24,95,67,0,29,215,不合格
19993128,29,14,93,91,27,254,不合格
19993129,37,93,83,52,28,293,不合格
19993130,88,91,37,58,69,343,合格
19993131,84,54,43,62,78,321,合格
19993132,9,65,41,44,12,171,不合格
19993133,24,57,65,27,84,257,不合格
19993134,33,25,55,79,19,211,不合格
19993135,15,57,10,61,59,202,不合格
19993136,26,89,90,86,80,371,合格
19993137,28,0,32,39,14,113,不合格
19993138,93,68,34,76,51,322,合格
19993139,55,2,5,51,81,194,不合格
19993140,57,93,47,75,64,336,合格
19993141,68,68,48,94,96,374,合格
19993142,96,12,26,85,61,280,不合格
19993143,45,40,70,99,69,323,合格
19993144,90,24,67,48,78,307,合格
19993145,25,91,96,85,59,356,合格
19993146,44,42,55,74,89,304,合格
19993147,24,36,77,12,34,183,不合格
19993148,61,1,42,81,30,215,不合格
19993149,20,33,74,29,96,252,不合格
19993150,94,79,82,64,69,388,合格
19993151,42,67,36,51,23,219,不合格
19993152,8,95,52,2,71,228,不合格
19993153,86,12,0,88,34,220,不合格
19993154,24,57,15,33,41,170,不合格
19993155,33,78,55,23,72,261,不合格
19993156,94,8,26,25,8,161,不合格
19993157,49,73,64,42,52,280,不合格
19993158,72,73,89,95,38,367,合格
19993159,24,69,22,24,92,231,不合格
19993160,35,7,56,0,5,103,不合格
19993161,11,43,44,13,10,121,不合格
19993162,10,53,77,99,41,280,不合格
19993163,91,6,81,58,96,332,合格
19993164,6,10,23,71,53,163,不合格
19993165,74,57,34,31,4,200,不合格
19993166,40,13,98,87,14,252,不合格
19993167,91,91,6,29,33,250,不合格
19993168,66,47,8,63,3,187,不合格
19993169,88,39,4,31,48,210,不合格
19993170,90,65,17,14,6,192,不合格
19993171,26,80,76,48,78,308,合格
19993172,69,9,26,93,85,282,不合格
19993173,27,62,60,37,18,204,不合格
19993174,53,42,5,15,63,178,不合格
19993175,71,20,22,81,15,209,不合格
19993176,5,41,11,94,16,167,不合格
19993177,82,43,38,61,25,249,不合格
19993178,67,80,46,65,24,282,不合格
19993179,18,33,82,47,62,242,不合格
19993180,11,88,51,29,54,233,不合格
19993181,61,20,37,95,65,278,不合格
19993182,94,94,54,11,18,271,不合格
19993183,77,7,69,68,36,257,不合格
19993184,67,2,75,91,21,256,不合格
19993185,41,27,12,94,33,207,不合格
19993186,80,3,60,48,81,272,不合格
19993187,66,95,88,65,92,406,合格
19993188,39,76,40,93,24,272,不合格
19993189,3,39,83,56,71,252,不合格
19993190,53,88,12,75,83,311,合格
19993191,36,76,17,97,8,234,不合格
19993192,79,96,96,42,30,343,合格
19993193,54,76,37,0,35,202,不合格
19993194,15,15,3,57,85,175,不合格
19993195,53,9,48,60,43,213,不合格
19993196,66,64,82,36,40,288,不合格
19993197,63,66,20,61,3,213,不合格
19993198,14,47,6,52,67,186,不合格
19993199,52,24,16,92,35,219,不合格
19993200,3,8,17,75,48,151,不合格
19993201,59,8,74,73,18,232,不合格
19993202,77,5,31,43,67,223,不合格
19993203,85,68,3,90,33,279,不合格
19993204,54,80,54,90,39,317,合格
19993205,39,63,28,35,80,245,不合格
19993206,26,97,41,95,40,299,不合格
19993207,24,79,41,8,20,172,不合格
19993208,6,43,80,76,82,287,不合格
19993209,48,4,95,26,5,178,不合格
19993210,92,97,63,19,32,303,合格
19993211,52,39,69,35,87,282,不合格
19993212,75,39,18,3,9,144,不合格
19993213,2,98,26,50,97,273,不合格
19993214,21,45,8,15,3,92,不合格
19993215,93,25,38,44,62,262,不合格
19993216,23,33,47,10,33,146,不合格
19993217,33,79,9,50,39,210,不合格
19993218,7,86,6,22,23,144,不合格
19993219,95,75,36,72,84,362,合格
19993220,5,48,67,79,94,293,不合格
19993221,30,36,98,99,79,342,合格
19993222,23,91,67,10,76,267,不合格
19993223,63,55,91,99,75,383,合格
19993224,0,65,31,5,29,130,不合格
19993225,55,73,32,74,54,288,不合格
19993226,37,41,37,78,54,247,不合格
19993227,63,13,28,30,14,148,不合格
19993228,75,61,22,63,15,236,不合格
19993229,91,85,48,20,89,333,合格
19993230,1,48,33,57,32,171,不合格
19993231,12,6,56,67,10,151,不合格
19993232,33,71,68,69,50,291,不合格
19993233,38,4,79,39,63,223,不合格
19993234,53,17,65,43,94,272,不合格
19993235,47,80,8,62,74,271,不合格
19993236,20,57,39,40,76,232,不合格
19993237,69,64,17,30,57,237,不合格
19993238,33,58,49,80,98,318,合格
19993239,59,65,48,65,16,253,不合格
19993240,15,74,97,0,85,271,不合格
19993241,25,27,58,91,59,260,不合格
19993242,18,49,22,11,42,142,不合格
19993243,26,5,11,65,58,165,不合格
19993244,9,31,89,6,51,186,不合格
19993245,95,32,9,81,25,242,不合格
19993246,8,16,65,7,61,157,不合格
19993247,83,67,53,18,60,281,不合格
19993248,47,4,54,48,50,203,不合格
19993249,43,12,63,16,70,204,不合格
19993250,73,28,39,1,22,163,不合格
19993251,52,87,29,62,85,315,合格
19993252,43,79,59,0,51,232,不合格
19993253,8,75,41,25,88,237,不合格
19993254,88,23,81,71,66,329,合格
19993255,87,63,47,18,77,292,不合格
19993256,33,9,12,22,53,129,不合格
19993257,94,49,18,39,78,278,不合格
19993258,23,25,2,99,77,226,不合格
19993259,17,17,96,91,28,249,不合格
19993260,21,86,63,50,69,289,不合格
19993261,2,73,77,87,73,312,合格
19993262,12,94,7,58,91,262,不合格
19993263,90,40,74,81,65,350,合格
19993264,84,17,92,45,36,274,不合格
19993265,40,4,83,69,93,289,不合格
19993266,45,41,15,47,50,198,不合格
19993267,80,87,39,55,46,307,合格
19993268,34,88,45,53,12,232,不合格
19993269,66,67,77,89,95,394,合格
19993270,44,46,29,2,13,134,不合格
19993271,49,39,22,16,79,205,不合格
19993272,48,94,17,60,22,241,不合格
19993273,15,35,45,70,58,223,不合格
19993274,55,82,61,41,45,284,不合格
19993275,3,52,14,9,1,79,不合格
19993276,61,91,25,63,46,286,不合格
19993277,58,30,53,44,70,255,不合格
19993278,4,89,52,84,46,275,不合格
19993279,37,48,80,93,16,274,不合格
19993280,8,85,94,70,67,324,合格
19993281,2,98,55,69,16,240,不合格
19993282,61,57,58,65,78,319,合格
19993283,1,31,54,25,44,155,不合格
19993284,2,0,46,39,27,114,不合格
19993285,67,40,78,89,69,343,合格
19993286,56,18,78,67,22,241,不合格
19993287,36,9,84,61,12,202,不合格
19993288,51,99,63,90,59,362,合格
19993289,7,71,46,54,57,235,不合格
19993290,3,99,21,61,50,234,不合格
19993291,59,12,41,32,29,173,不合格
19993292,64,34,82,35,20,235,不合格
19993293,57,80,48,70,35,290,不合格
19993294,61,53,60,96,26,296,不合格
19993295,49,83,99,5,61,297,不合格
19993296,72,92,84,36,66,350,合格
19993297,50,54,69,69,56,298,不合格
19993298,79,65,49,98,34,325,合格
19993299,56,36,93,9,81,275,不合格
19993300,5,52,2,83,64,206,不合格
19993301,4,74,51,46,88,263,不合格
19993302,6,7,99,18,62,192,不合格
19993303,75,89,18,66,46,294,不合格
19993304,92,23,54,71,31,271,不合格
19993305,72,91,73,16,16,268,不合格
19993306,37,81,20,99,95,332,合格
19993307,54,52,19,57,33,215,不合格
19993308,16,1,89,96,79,281,不合格
19993309,12,69,48,28,76,233,不合格
19993310,51,85,95,38,54,323,合格
19993311,79,50,89,25,13,256,不合格
19993312,37,97,46,3,20,203,不合格
19993313,85,82,21,34,48,270,不合格
19993314,53,50,46,13,0,162,不合格
19993315,58,30,18,90,85,281,不合格
19993316,13,4,27,79,20,143,不合格
19993317,15,8,45,96,8,172,不合格
19993318,14,56,6,67,45,188,不合格
19993319,43,66,31,19,97,256,不合格
19993320,41,66,44,85,9,245,不合格
19993321,52,73,77,30,53,285,不合格
19993322,61,54,58,20,87,280,不合格
19993323,39,21,45,5,89,199,不合格
19993324,20,8,82,35,75,220,不合格
19993325,98,50,27,11,77,263,不合格
19993326,24,53,53,30,56,216,不合格
19993327,42,8,66,90,54,260,不合格
19993328,58,49,44,6,25,182,不合格
19993329,26,68,14,53,66,227,不合格
19993330,11,62,63,54,1,191,不合格
19993331,41,23,39,52,88,243,不合格
19993332,56,20,35,4,14,129,不合格
19993333,90,55,67,12,57,281,不合格
19993334,85,51,18,56,15,225,不合格
19993335,21,31,23,15,86,176,不合格
19993336,36,67,85,38,70,296,不合格
19993337,41,83,97,99,58,378,合格
19993338,11,25,46,90,4,176,不合格
19993339,48,29,2,18,2,99,不合格
19993340,9,6,99,65,44,223,不合格
19993341,72,56,20,72,58,278,不合格
19993342,44,33,97,55,99,328,合格
19993343,90,0,33,68,77,268,不合格
19993344,1,74,60,31,84,250,不合格
19993345,51,37,91,32,52,263,不合格
19993346,45,33,70,21,2,171,不合格
19993347,58,79,32,4,20,193,不合格
19993348,1,44,8,37,71,161,不合格
19993349,4,28,95,41,66,234,不合格
19993350,14,17,65,63,57,216,不合格
19993351,28,19,81,7,26,161,不合格
19993352,98,15,79,83,22,297,不合格
19993353,81,95,69,81,89,415,合格
19993354,68,78,95,16,88,345,合格
19993355,61,18,16,98,79,272,不合格
19993356,69,77,61,66,64,337,合格
19993357,48,91,11,94,52,296,不合格
19993358,77,12,33,99,14,235,不合格
19993359,6,78,28,41,15,168,不合格
19993360,99,40,49,51,47,286,不合格
19993361,66,90,32,40,45,273,不合格
19993362,36,54,80,43,55,268,不合格
19993363,68,11,57,74,37,247,不合格
19993364,53,71,69,8,9,210,不合格
19993365,69,30,84,14,82,279,不合格
19993366,56,97,9,76,49,287,不合格
19993367,25,78,24,72,38,237,不合格
19993368,89,9,52,56,78,284,不合格
19993369,73,8,7,82,23,193,不合格
19993370,17,11,69,98,16,211,不合格
19993371,86,26,17,19,50,198,不合格
19993372,88,62,20,76,82,328,合格
19993373,71,21,74,27,25,218,不合格
19993374,80,79,77,42,35,313,合格
19993375,73,39,42,49,30,233,不合格
19993376,86,31,12,31,37,197,不合格
19993377,96,72,85,0,11,264,不合格
19993378,38,70,82,27,8,225,不合格
19993379,71,21,4,99,23,218,不合格
19993380,0,51,26,8,79,164,不合格
19993381,42,15,89,67,96,309,合格
19993382,13,7,45,21,57,143,不合格
19993383,66,76,66,80,9,297,不合格
19993384,13,84,24,27,85,233,不合格
19993385,7,88,60,21,25,201,不合格
19993386,53,48,57,96,10,264,不合格
19993387,75,66,40,46,75,302,合格
19993388,31,53,53,81,89,307,合格
19993389,40,89,97,22,89,337,合格
19993390,69,70,10,99,26,274,不合格
19993391,90,56,38,58,87,329,合格
19993392,93,80,23,96,63,355,合格
19993393,7,47,76,28,1,159,不合格
19993394,59,93,85,13,64,314,合格
19993395,1,66,20,28,30,145,不合格
19993396,62,76,77,4,70,289,不合格
19993397,31,28,51,9,0,119,不合格
19993398,84,33,57,14,80,268,不合格
19993399,46,4,63,6,85,204,不合格
19993400,8,66,67,16,63,220,不合格
19993401,44,88,90,23,74,319,合格
19993402,75,34,13,67,31,220,不合格
19993403,42,98,50,74,83,347,合格
19993404,9,60,2,82,56,209,不合格
19993405,55,61,62,22,97,297,不合格
19993406,79,91,24,1,26,221,不合格
19993407,1,36,72,0,40,149,不合格
19993408,36,38,50,51,30,205,不合格
19993409,0,95,2,82,2,181,不合格
19993410,78,60,32,79,9,258,不合格
19993411,90,16,66,49,27,248,不合格
19993412,36,0,62,71,83,252,不合格
19993413,92,41,54,53,95,335,合格
19993414,49,28,66,85,26,254,不合格
19993415,23,90,50,42,11,216,不合格
19993416,5,54,99,55,4,217,不合格
19993417,99,8,2,19,42,170,不合格
19993418,25,86,82,52,77,322,合格
19993419,45,83,55,2,51,236,不合格
19993420,11,75,65,56,97,304,合格
19993421,82,47,25,57,48,259,不合格
19993422,75,44,34,34,92,279,不合格
19993423,89,65,9,72,58,293,不合格
19993424,99,94,30,93,47,363,合格
19993425,41,52,84,88,9,274,不合格
19993426,42,88,49,70,52,301,合格
19993427,24,94,98,26,28,270,不合格
19993428,27,46,3,21,43,140,不合格
19993429,41,63,78,97,78,357,合格
19993430,71,34,1,39,95,240,不合格
19993431,75,77,20,91,92,355,合格
19993432,75,16,63,11,80,245,不合格
19993433,76,82,49,64,24,295,不合格
19993434,74,51,26,63,39,253,不合格
19993435,28,22,67,97,9,223,不合格
19993436,80,45,85,45,54,309,合格
19993437,94,32,25,58,71,280,不合格
19993438,4,35,0,57,60,156,不合格
19993439,98,29,21,54,52,254,不合格
19993440,61,95,91,78,98,423,合格
19993441,80,63,84,72,23,322,合格
19993442,21,44,37,51,48,201,不合格
19993443,29,19,63,44,5,160,不合格
19993444,89,45,34,60,29,257,不合格
19993445,54,33,91,72,49,299,不合格
19993446,39,17,94,59,37,246,不合格
19993447,6,66,42,10,73,197,不合格
19993448,18,87,81,96,45,327,合格
19993449,52,69,75,37,76,309,合格
19993450,53,22,22,83,73,253,不合格
19993451,66,0,64,98,80,308,合格
19993452,54,5,33,41,79,212,不合格
19993453,93,89,44,83,79,388,合格
19993454,6,24,78,95,21,224,不合格
19993455,50,23,48,79,74,274,不合格
19993456,52,90,41,70,24,277,不合格
19993457,31,1,42,97,28,199,不合格
19993458,50,68,22,65,22,227,不合格
19993459,45,11,21,9,41,127,不合格
19993460,72,54,88,26,29,269,不合格
19993461,76,54,53,85,39,307,合格
19993462,95,59,18,33,95,300,合格
19993463,63,40,60,92,50,305,合格
19993464,34,29,4,44,29,140,不合格
19993465,16,64,27,30,15,152,不合格
19993466,43,63,73,3,23,205,不合格
19993467,20,76,41,47,50,234,不合格
19993468,0,65,0,79,46,190,不合格
19993469,57,86,39,50,77,309,合格
19993470,33,89,64,61,32,279,不合格
19993471,30,83,9,66,51,239,不合格
19993472,15,69,88,83,28,283,不合格
19993473,50,1,18,62,50,181,不合格
19993474,80,36,83,86,86,371,合格
19993475,94,0,5,72,59,230,不合格
19993476,13,37,87,42,28,207,不合格
19993477,0,24,88,18,72,202,不合格
19993478,30,92,15,3,81,221,不合格
19993479,56,90,80,30,53,309,合格
19993480,5,32,91,89,26,243,不合格
19993481,66,71,40,61,50,288,不合格
19993482,59,61,45,2,5,172,不合格
19993483,53,45,93,77,63,331,合格
19993484,15,25,19,65,6,130,不合格
19993485,74,50,11,86,72,293,不合格
19993486,99,16,94,27,18,254,不合格
19993487,3,70,85,78,65,301,合格
19993488,54,0,47,51,43,195,不合格
19993489,73,71,21,1,10,176,不合格
19993490,76,74,46,26,91,313,合格
19993491,51,29,70,59,72,281,不合格
19993492,74,28,85,96,12,295,不合格
19993493,26,11,1,0,38,76,不合格
19993494,15,35,45,80,44,219,不合格
19993495,7,32,68,4,4,115,不合格
19993496,66,22,1,63,99,251,不合格
19993497,38,37,55,21,48,199,不合格
19993498,15,75,23,88,49,250,不合格
19993499,16,20,45,33,99,213,不合格
19993500,55,53,83,76,68,335,合格
19993501,68,28,32,73,28,229,不合格
19993502,18,69,29,64,23,203,不合格
19993503,43,73,26,36,27,205,不合格
19993504,44,33,93,21,53,244,不合格
19993505,12,14,66,40,60,192,不合格
19993506,56,88,63,62,7,276,不合格
19993507,7,27,64,65,23,186,不合格
19993508,40,92,8,65,67,272,不合格
19993509,80,3,24,69,90,266,不合格
19993510,94,26,43,83,73,319,合格
19993511,86,48,75,95,44,348,合格
19993512,94,48,41,39,0,222,不合格
19993513,6,63,21,87,90,267,不合格
19993514,49,11,98,40,26,224,不合格
19993515,68,92,28,65,85,338,合格
19993516,74,55,88,13,56,286,不合格
19993517,34,1,93,16,59,203,不合格
19993518,21,99,58,66,33,277,不合格
19993519,36,50,98,0,36,220,不合格
19993520,75,53,51,4,45,228,不合格
19993521,94,90,96,31,77,388,合格
19993522,67,75,47,45,61,295,不合格
19993523,69,73,0,3,14,159,不合格
19993524,61,72,58,40,67,298,不合格
19993525,86,78,40,11,34,249,不合格
19993526,65,70,36,16,6,193,不合格
19993527,61,13,87,5,83,249,不合格
19993528,99,52,34,80,56,321,合格
19993529,54,74,42,55,60,285,不合格
19993530,19,90,72,4,1,186,不合格
19993531,48,36,17,10,77,188,不合格
19993532,32,58,83,4,92,269,不合格
19993533,42,93,41,42,15,233,不合格
19993534,44,58,42,48,31,223,不合格
19993535,60,94,26,15,56,251,不合格
19993536,86,69,84,48,51,338,合格
19993537,42,68,65,96,33,304,合格
19993538,99,51,34,83,82,349,合格
19993539,37,27,96,91,85,336,合格
19993540,38,29,80,57,21,225,不合格
19993541,21,61,21,80,54,237,不合格
19993542,61,93,62,10,74,300,合格
19993543,90,7,85,87,9,278,不合格
19993544,74,14,49,68,27,232,不合格
19993545,7,64,81,99,8,259,不合格
19993546,9,29,24,4,82,148,不合格
19993547,60,90,1,96,2,249,不合格
19993548,60,69,9,2,58,198,不合格
19993549,69,60,66,97,11,303,合格
19993550,5,4,85,22,74,190,不合格
19993551,43,20,77,91,12,243,不合格
19993552,83,47,24,34,12,200,不合格
19993553,7,71,69,54,78,279,不合格
19993554,23,65,33,69,30,220,不合格
19993555,74,84,41,13,26,238,不合格
19993556,2,5,53,56,21,137,不合格
19993557,19,35,48,87,30,219,不合格
19993558,40,92,60,99,89,380,合格
19993559,24,48,2,78,38,190,不合格
19993560,3,7,53,43,87,193,不合格
19993561,69,96,87,87,10,349,合格
19993562,55,1,63,44,32,195,不合格
19993563,10,1,3,92,85,191,不合格
19993564,50,48,73,50,64,285,不合格
19993565,80,19,72,14,92,277,不合格
19993566,47,60,80,46,72,305,合格
19993567,0,93,39,84,19,235,不合格
19993568,95,12,24,49,81,261,不合格
19993569,61,0,52,12,87,212,不合格
19993570,80,77,79,22,46,304,合格
19993571,10,65,22,27,42,166,不合格
19993572,61,71,75,35,55,297,不合格
19993573,34,87,73,17,95,306,合格
19993574,50,10,37,32,72,201,不合格
19993575,47,79,48,43,53,270,不合格
19993576,91,36,32,30,16,205,不合格
19993577,66,85,9,25,44,229,不合格
19993578,8,55,8,76,11,158,不合格
19993579,86,69,99,90,1,345,合格
19993580,6,99,84,12,75,276,不合格
19993581,28,82,10,50,15,185,不合格
19993582,7,4,95,54,70,230,不合格
19993583,84,26,2,80,78,270,不合格
19993584,88,0,85,7,44,224,不合格
19993585,38,86,91,99,68,382,合格
19993586,43,36,40,36,35,190,不合格
19993587,2,84,68,31,42,227,不合格
19993588,19,57,24,64,34,198,不合格
19993589,28,7,66,41,92,234,不合格
19993590,97,97,42,54,35,325,合格
19993591,4,52,58,33,85,232,不合格
19993592,30,13,70,75,56,244,不合格
19993593,52,89,58,87,93,379,合格
19993594,56,51,56,36,77,276,不合格
19993595,7,39,65,26,72,209,不合格
19993596,90,38,39,87,48,302,合格
19993597,85,35,70,51,77,318,合格
19993598,0,75,78,95,18,266,不合格
19993599,98,40,84,3,6,231,不合格
19993600,5,95,35,80,66,281,不合格
19993601,6,57,76,28,10,177,不合格
19993602,40,99,44,3,54,240,不合格
19993603,80,11,40,69,9,209,不合格
19993604,69,83,5,89,9,255,不合格
19993605,9,69,6,21,80,185,不合格
19993606,22,38,46,47,8,161,不合格
19993607,59,22,37,37,16,171,不合格
19993608,45,47,83,75,83,333,合格
19993609,86,28,61,54,45,274,不合格
19993610,14,91,61,31,12,209,不合格
19993611,5,73,33,52,43,206,不合格
19993612,30,18,44,9,73,174,不合格
19993613,13,4,57,9,96,179,不合格
19993614,56,76,9,9,68,218,不合格
19993615,36,98,61,39,91,325,合格
19993616,9,41,71,40,2,163,不合格
19993617,87,96,22,82,46,333,合格
19993618,59,60,32,88,53,292,不合格
19993619,21,46,64,22,2,155,不合格
19993620,85,40,9,56,84,274,不合格
19993621,45,88,34,60,32,259,不合格
19993622,87,30,53,7,53,230,不合格
19993623,88,10,86,39,23,246,不合格
19993624,47,26,61,59,5,198,不合格
19993625,12,9,10,55,13,99,不合格
19993626,42,97,38,44,12,233,不合格
19993627,30,33,3,23,38,127,不合格
19993628,97,94,38,27,54,310,合格
19993629,7,90,91,0,83,271,不合格
19993630,85,96,45,63,12,301,合格
19993631,21,87,54,23,43,228,不合格
19993632,23,81,78,93,71,346,合格
19993633,29,89,88,42,37,285,不合格
19993634,74,51,68,96,57,346,合格
19993635,26,15,98,51,26,216,不合格
19993636,54,5,92,78,53,282,不合格
19993637,25,82,9,5,65,186,不合格
19993638,22,54,71,56,37,240,不合格
19993639,69,65,54,60,27,275,不合格
19993640,94,90,18,98,56,356,合格
19993641,40,61,18,95,82,296,不合格
19993642,92,43,94,22,0,251,不合格
19993643,81,97,29,74,88,369,合格
19993644,25,81,64,30,7,207,不合格
19993645,76,78,74,98,69,395,合格
19993646,65,78,53,19,32,247,不合格
19993647,93,12,38,71,56,270,不合格
19993648,25,69,38,41,55,228,不合格
19993649,42,72,97,20,55,286,不合格
19993650,26,93,2,83,58,262,不合格
19993651,52,66,19,96,97,330,合格
19993652,82,93,64,72,68,379,合格
19993653,51,47,85,45,29,257,不合格
19993654,94,45,94,27,93,353,合格
19993655,30,90,96,39,13,268,不合格
19993656,61,12,47,24,39,183,不合格
19993657,94,15,71,56,4,240,不合格
19993658,62,30,70,59,42,263,不合格
19993659,48,93,58,91,57,347,合格
19993660,66,64,62,3,94,289,不合格
19993661,44,51,77,43,13,228,不合格
19993662,71,24,1,12,19,127,不合格
19993663,23,46,49,72,24,214,不合格
19993664,60,13,78,85,79,315,合格
19993665,61,90,96,85,50,382,合格
19993666,66,75,69,87,6,303,合格
19993667,68,99,93,70,67,397,合格
19993668,32,17,32,89,25,195,不合格
19993669,83,27,50,42,43,245,不合格
19993670,20,77,23,81,44,245,不合格
19993671,53,17,91,29,77,267,不合格
19993672,46,50,4,83,36,219,不合格
19993673,40,38,18,35,36,167,不合格
19993674,5,95,84,69,95,348,合格
19993675,44,24,88,53,13,222,不合格
19993676,82,19,49,23,32,205,不合格
19993677,84,75,32,59,42,292,不合格
19993678,35,55,12,73,75,250,不合格
19993679,50,7,83,17,5,162,不合格
19993680,61,60,12,85,8,226,不合格
19993681,74,20,16,93,22,225,不合格
19993682,30,6,19,55,84,194,不合格
19993683,71,73,33,92,63,332,合格
19993684,53,90,49,56,90,338,合格
19993685,24,81,46,71,17,239,不合格
19993686,11,74,43,92,79,299,不合格
19993687,60,92,39,50,87,328,合格
19993688,64,83,56,90,53,346,合格
19993689,36,52,2,9,45,144,不合格
19993690,36,39,82,74,14,245,不合格
19993691,3,87,42,17,4,153,不合格
19993692,90,24,3,25,45,187,不合格
19993693,32,87,85,18,83,305,合格
19993694,17,33,51,92,87,280,不合格
19993695,38,25,54,33,31,181,不合格
19993696,64,25,84,18,34,225,不合格
19993697,26,80,21,59,88,274,不合格
19993698,54,17,47,74,7,199,不合格
19993699,12,16,65,35,46,174,不合格
19993700,27,26,51,19,31,154,不合格
19993701,83,34,38,43,13,211,不合格
19993702,92,75,16,64,9,256,不合格
19993703,55,44,55,83,86,323,合格
19993704,64,97,69,64,55,349,合格
19993705,79,63,6,51,37,236,不合格
19993706,82,93,62,50,25,312,合格
19993707,28,4,37,56,1,126,不合格
19993708,63,91,89,29,31,303,合格
19993709,35,10,52,94,3,194,不合格
19993710,32,42,23,43,63,203,不合格
19993711,26,45,86,23,29,209,不合格
19993712,31,79,37,10,90,247,不合格
19993713,86,50,65,91,33,325,合格
19993714,66,38,74,56,69,303,合格
19993715,20,70,84,30,64,268,不合格
19993716,6,52,90,58,58,264,不合格
19993717,18,75,32,16,84,225,不合格
19993718,31,81,35,74,62,283,不合格
19993719,73,28,1,23,74,199,不合格
19993720,83,30,22,95,62,292,不合格
19993721,12,12,38,0,60,122,不合格
19993722,80,81,23,89,74,347,合格
19993723,29,71,90,62,79,331,合格
19993724,44,88,21,95,42,290,不合格
19993725,64,23,40,53,86,266,不合格
19993726,33,39,15,42,78,207,不合格
19993727,41,96,75,9,33,254,不合格
19993728,16,61,6,21,0,104,不合格
19993729,53,54,50,77,90,324,合格
19993730,72,68,55,68,76,339,合格
19993731,3,4,91,34,48,180,不合格
19993732,78,64,88,80,16,326,合格
19993733,19,17,36,37,11,120,不合格
19993734,10,73,78,64,53,278,不合格
19993735,8,62,43,70,38,221,不合格
19993736,46,43,2,74,37,202,不合格
19993737,82,88,58,68,57,353,合格
19993738,1,40,97,33,59,230,不合格
19993739,78,27,48,5,13,171,不合格
19993740,31,8,94,84,47,264,不合格
19993741,59,81,27,18,97,282,不合格
19993742,66,15,76,69,60,286,不合格
19993743,25,34,12,83,46,200,不合格
19993744,10,91,29,68,23,221,不合格
19993745,83,98,52,20,22,275,不合格
19993746,16,69,6,87,44,222,不合格
19993747,59,55,48,0,99,261,不合格
19993748,84,42,56,50,84,316,合格
19993749,12,72,92,71,32,279,不合格
19993750,67,74,17,82,81,321,合格
19993751,6,5,50,74,45,180,不合格
19993752,55,34,90,67,72,318,合格
19993753,96,37,23,48,3,207,不合格
19993754,42,42,99,96,36,315,合格
19993755,84,74,18,8,73,257,不合格
19993756,84,59,26,99,50,318,合格
19993757,62,50,67,56,32,267,不合格
19993758,21,7,44,60,63,195,不合格
19993759,22,83,78,50,48,281,不合格
19993760,60,94,80,57,12,303,合格
19993761,25,62,82,91,46,306,合格
19993762,2,66,5,55,83,211,不合格
19993763,75,39,53,29,12,208,不合格
19993764,62,64,77,99,35,337,合格
19993765,52,39,60,99,46,296,不合格
19993766,75,48,85,33,87,328,合格
19993767,86,97,76,43,77,379,合格
19993768,88,37,94,89,74,382,合格
19993769,81,79,4,60,62,286,不合格
19993770,67,97,95,96,45,400,合格
19993771,66,66,61,11,18,222,不合格
19993772,51,18,59,22,57,207,不合格
19993773,7,79,85,99,18,288,不合格
19993774,39,91,29,47,68,274,不合格
19993775,49,53,65,33,12,212,不合格
19993776,65,52,7,89,41,254,不合格
19993777,51,69,10,87,43,260,不合格
19993778,89,47,48,16,92,292,不合格
19993779,41,15,82,83,88,309,合格
19993780,93,69,19,4,68,253,不合格
19993781,21,15,92,45,42,215,不合格
19993782,69,2,67,43,68,249,不合格
19993783,7,5,71,61,43,187,不合格
19993784,60,76,91,77,32,336,合格
19993785,61,64,4,50,65,244,不合格
19993786,1,38,6,58,19,122,不合格
19993787,35,50,22,27,13,147,不合格
19993788,54,87,94,16,11,262,不合格
19993789,66,80,8,55,57,266,不合格
19993790,47,41,69,74,62,293,不合格
19993791,0,98,18,13,19,148,不合格
19993792,3,90,78,56,49,276,不合格
19993793,1,33,62,38,69,203,不合格
19993794,81,24,32,74,73,284,不合格
19993795,13,83,37,11,76,220,不合格
19993796,12,71,78,18,85,264,不合格
19993797,34,7,59,50,24,174,不合格
19993798,91,8,23,31,40,193,不合格
19993799,39,79,68,85,6,277,不合格
19993800,16,86,56,21,66,245,不合格
19993801,56,69,57,45,13,240,不合格
19993802,86,21,61,95,82,345,合格
19993803,55,12,0,29,83,179,不合格
19993804,39,0,62,73,27,201,不合格
19993805,30,55,95,74,86,340,合格
19993806,23,48,66,81,55,273,不合格
19993807,8,52,19,51,6,136,不合格
19993808,54,53,96,36,52,291,不合格
19993809,60,38,8,51,46,203,不合格
19993810,67,75,69,55,63,329,合格
19993811,97,38,81,85,13,314,合格
19993812,62,59,50,81,26,278,不合格
19993813,22,63,69,35,73,262,不合格
19993814,74,17,47,18,56,212,不合格
19993815,17,42,22,1,70,152,不合格
19993816,83,47,68,11,74,283,不合格
19993817,83,63,92,15,1,254,不合格
19993818,14,14,97,50,53,228,不合格
19993819,50,71,33,63,25,242,不合格
19993820,69,65,31,14,99,278,不合格
19993821,86,17,12,31,46,192,不合格
19993822,25,77,25,47,6,180,不合格
19993823,95,62,3,0,9,169,不合格
19993824,83,66,44,28,52,273,不合格
19993825,65,68,60,92,67,352,合格
19993826,42,60,94,20,12,228,不合格
19993827,67,1,24,95,38,225,不合格
19993828,53,78,6,77,90,304,合格
19993829,40,1,34,22,96,193,不合格
19993830,5,63,38,80,54,240,不合格
19993831,65,35,45,55,24,224,不合格
19993832,87,72,52,91,24,326,合格
19993833,96,49,56,71,19,291,不合格
19993834,87,79,13,37,5,221,不合格
19993835,81,53,31,26,18,209,不合格
19993836,22,60,53,90,41,266,不合格
19993837,15,81,72,23,92,283,不合格
19993838,3,8,83,7,21,122,不合格
19993839,1,26,83,82,5,197,不合格
19993840,79,54,58,53,74,318,合格
19993841,79,35,78,2,10,204,不合格
19993842,91,53,63,29,63,299,不合格
19993843,79,77,39,55,86,336,合格
19993844,79,28,77,23,77,284,不合格
19993845,83,60,57,69,3,272,不合格
19993846,26,54,81,84,80,325,合格
19993847,30,88,3,64,62,247,不合格
19993848,66,47,84,69,63,329,合格
19993849,41,61,63,67,31,263,不合格
19993850,34,58,28,2,83,205,不合格
19993851,7,63,69,64,87,290,不合格
19993852,35,99,89,32,58,313,合格
19993853,39,83,44,5,72,243,不合格
19993854,90,29,90,33,28,270,不合格
19993855,27,87,86,53,25,278,不合格
19993856,5,65,97,95,61,323,合格
19993857,1,20,62,63,20,166,不合格
19993858,84,48,47,41,59,279,不合格
19993859,83,23,19,18,20,163,不合格
19993860,60,27,63,26,55,231,不合格
19993861,63,54,75,23,0,215,不合格
19993862,77,22,67,4,3,173,不合格
19993863,15,40,68,9,0,132,不合格
19993864,81,71,7,31,43,233,不合格
19993865,38,88,6,13,12,157,不合格
19993866,85,15,9,91,20,220,不合格
19993867,53,54,84,97,44,332,合格
19993868,42,5,71,31,63,212,不合格
19993869,63,95,31,82,66,337,合格
19993870,57,2,7,37,55,158,不合格
19993871,26,96,28,45,95,290,不合格
19993872,60,38,29,76,57,260,不合格
19993873,23,71,44,37,7,182,不合格
19993874,67,55,34,73,62,291,不合格
19993875,74,57,77,54,5,267,不合格
19993876,7,93,14,17,47,178,不合格
19993877,48,54,69,32,26,229,不合格
19993878,26,57,78,17,87,265,不合格
19993879,48,30,31,1,13,123,不合格
19993880,28,79,98,11,21,237,不合格
19993881,82,57,80,20,1,240,不合格
19993882,74,40,88,11,12,225,不合格
19993883,35,35,63,13,0,146,不合格
19993884,11,69,22,76,29,207,不合格
19993885,61,65,84,57,4,271,不合格
19993886,43,60,93,90,86,372,合格
19993887,41,60,31,99,64,295,不合格
19993888,75,12,91,52,37,267,不合格
19993889,39,1,38,5,59,142,不合格
19993890,64,46,36,64,31,241,不合格
19993891,28,46,11,98,9,192,不合格
19993892,32,14,48,64,57,215,不合格
19993893,62,70,94,34,11,271,不合格
19993894,84,54,49,77,85,349,合格
19993895,83,75,78,48,72,356,合格
19993896,72,56,16,89,64,297,不合格
19993897,20,92,28,45,70,255,不合格
19993898,69,17,34,42,73,235,不合格
19993899,20,5,60,5,46,136,不合格
19993900,49,10,63,82,84,288,不合格
19993901,8,96,39,19,54,216,不合格
19993902,48,97,50,95,0,290,不合格
19993903,41,22,67,75,46,251,不合格
19993904,82,9,49,0,33,173,不合格
19993905,99,39,32,86,67,323,合格
19993906,47,28,99,81,42,297,不合格
19993907,55,14,55,96,99,319,合格
19993908,44,91,27,21,83,266,不合格
19993909,3,40,3,17,51,114,不合格
19993910,63,61,85,5,46,260,不合格
19993911,95,50,70,43,52,310,合格
19993912,34,35,18,46,23,156,不合格
19993913,84,32,4,78,94,292,不合格
19993914,31,4,28,72,66,201,不合格
19993915,3,36,79,36,0,154,不合格
19993916,39,96,13,79,18,245,不合格
19993917,56,79,65,47,3,250,不合格
19993918,38,49,59,39,6,191,不合格
19993919,43,86,9,50,87,275,不合格
19993920,91,66,70,65,85,377,合格
19993921,71,84,78,48,34,315,合格
19993922,33,75,85,98,55,346,合格
19993923,43,78,80,47,92,340,合格
19993924,9,28,55,81,97,270,不合格
19993925,75,20,8,74,99,276,不合格
19993926,1,14,65,56,83,219,不合格
19993927,92,77,75,83,96,423,合格
19993928,71,52,84,57,65,329,合格
19993929,18,64,78,93,98,351,合格
19993930,75,67,73,49,15,279,不合格
19993931,91,2,41,81,6,221,不合格
19993932,59,34,28,2,54,177,不合格
19993933,71,76,85,56,34,322,合格
19993934,43,87,75,59,12,276,不合格
19993935,40,52,41,43,98,274,不合格
19993936,81,20,8,92,4,205,不合格
19993937,85,8,85,75,86,339,合格
19993938,4,6,57,33,93,193,不合格
19993939,66,37,72,97,97,369,合格
19993940,61,89,56,66,64,336,合格
19993941,8,3,2,64,19,96,不合格
19993942,43,30,12,3,67,155,不合格
19993943,33,11,82,73,3,202,不合格
19993944,11,68,52,81,94,306,合格
19993945,25,13,39,20,85,182,不合格
19993946,35,81,95,77,57,345,合格
19993947,8,51,9,2,92,162,不合格
19993948,37,9,4,4,23,77,不合格
19993949,90,8,28,46,30,202,不合格
19993950,57,68,35,80,72,312,合格
19993951,11,25,57,60,76,229,不合格
19993952,62,5,21,20,45,153,不合格
19993953,83,34,74,91,78,360,合格
19993954,71,66,30,77,47,291,不合格
19993955,97,41,54,91,37,320,合格
19993956,85,13,87,22,61,268,不合格
19993957,90,65,77,74,25,331,合格
19993958,1,57,51,33,10,152,不合格
19993959,39,34,37,86,96,292,不合格
19993960,40,23,66,85,22,236,不合格
19993961,38,13,75,46,2,174,不合格
19993962,94,95,55,95,60,399,合格
19993963,44,20,85,54,22,225,不合格
19993964,34,58,5,6,31,134,不合格
19993965,57,89,1,71,12,230,不合格
19993966,14,17,77,66,4,178,不合格
19993967,70,34,94,54,83,335,合格
19993968,30,4,11,19,31,95,不合格
19993969,58,79,65,25,86,313,合格
19993970,38,90,67,84,84,363,合格
19993971,41,12,43,29,68,193,不合格
19993972,20,17,61,65,6,169,不合格
19993973,76,66,69,52,80,343,合格
19993974,3,47,14,94,37,195,不合格
19993975,65,86,51,29,17,248,不合格
19993976,90,44,35,20,63,252,不合格
19993977,95,28,55,87,99,364,合格
19993978,31,79,87,68,91,356,合格
19993979,85,3,82,82,52,304,合格
19993980,65,22,42,87,23,239,不合格
19993981,32,20,18,96,48,214,不合格
19993982,64,46,88,77,68,343,合格
19993983,93,14,97,13,63,280,不合格
19993984,33,49,30,70,36,218,不合格
19993985,56,35,60,82,73,306,合格
19993986,19,83,72,76,3,253,不合格
19993987,72,70,81,15,8,246,不合格
19993988,3,76,73,97,1,250,不合格
19993989,29,1,3,83,66,182,不合格
19993990,57,37,59,25,40,218,不合格
19993991,46,47,79,31,41,244,不合格
19993992,74,25,60,21,59,239,不合格
19993993,98,28,12,37,77,252,不合格
19993994,87,53,89,39,17,285,不合格
19993995,66,3,47,81,24,221,不合格
19993996,5,87,7,15,5,119,不合格
19993997,26,15,51,27,51,170,不合格
19993998,23,43,89,59,11,225,不合格
19993999,23,49,70,9,92,243,不合格
19994000,7,6,51,96,17,177,不合格
19994001,54,10,16,76,60,216,不合格
19994002,81,73,40,40,32,266,不合格
19994003,84,21,7,60,47,219,不合格
19994004,2,70,10,31,84,197,不合格
19994005,10,30,72,80,99,291,不合格
19994006,70,28,90,91,19,298,不合格
19994007,74,21,46,40,93,274,不合格
19994008,22,3,5,65,15,110,不合格
19994009,0,60,51,10,29,150,不合格
19994010,27,24,83,30,65,229,不合格
19994011,63,41,56,78,25,263,不合格
19994012,31,57,69,47,11,215,不合格
19994013,81,71,98,18,30,298,不合格
19994014,46,25,74,55,81,281,不合格
19994015,91,41,11,51,72,266,不合格
19994016,21,37,79,59,47,243,不合格
19994017,29,99,67,98,47,340,合格
19994018,67,81,69,97,72,386,合格
19994019,48,27,72,32,40,219,不合格
19994020,64,96,62,51,4,277,不合格
19994021,97,74,11,26,85,293,不合格
19994022,89,91,85,93,23,381,合格
19994023,64,40,28,46,62,240,不合格
19994024,79,75,28,5,47,234,不合格
19994025,76,85,39,92,35,327,合格
19994026,79,34,54,48,99,314,合格
19994027,31,99,91,90,92,403,合格
19994028,76,16,42,98,30,262,不合格
19994029,55,78,34,78,91,336,合格
19994030,10,25,30,23,75,163,不合格
19994031,25,54,97,67,50,293,不合格
19994032,76,6,97,20,89,288,不合格
19994033,68,45,64,91,9,277,不合格
19994034,9,69,97,52,28,255,不合格
19994035,79,63,70,53,88,353,合格
19994036,24,71,73,54,38,260,不合格
19994037,21,68,52,24,90,255,不合格
19994038,8,21,69,27,77,202,不合格
19994039,35,49,82,40,21,227,不合格
19994040,49,91,36,86,14,276,不合格
19994041,76,19,99,62,39,295,不合格
19994042,15,92,11,9,50,177,不合格
19994043,8,2,13,61,62,146,不合格
19994044,42,69,77,60,38,286,不合格
19994045,98,88,92,34,84,396,合格
19994046,66,43,65,35,0,209,不合格
19994047,79,42,51,26,69,267,不合格
19994048,34,33,0,72,92,231,不合格
19994049,29,39,82,14,32,196,不合格
19994050,4,5,24,59,88,180,不合格
19994051,10,38,47,26,19,140,不合格
19994052,38,56,4,76,15,189,不合格
19994053,15,20,0,81,71,187,不合格
19994054,46,13,76,36,3,174,不合格
19994055,60,50,97,76,73,356,合格
19994056,89,72,73,16,6,256,不合格
19994057,37,56,78,55,48,274,不合格
19994058,53,43,21,44,91,252,不合格
19994059,76,25,36,33,5,175,不合格
19994060,5,25,90,44,36,200,不合格
19994061,34,73,71,46,51,275,不合格
19994062,25,52,55,14,19,165,不合格
19994063,48,60,94,24,23,249,不合格
19994064,71,72,27,33,21,224,不合格
19994065,19,5,4,87,55,170,不合格
19994066,8,91,74,90,49,312,合格
19994067,29,82,81,86,75,353,合格
19994068,69,8,62,81,85,305,合格
19994069,87,39,31,32,74,263,不合格
19994070,30,56,17,40,63,206,不合格
19994071,29,88,47,47,72,283,不合格
19994072,88,9,75,90,90,352,合格
19994073,55,45,9,61,95,265,不合格
19994074,1,38,99,10,44,192,不合格
19994075,39,48,45,90,49,271,不合格
19994076,9,86,85,66,6,252,不合格
19994077,73,74,65,12,14,238,不合格
19994078,61,37,53,49,25,225,不合格
19994079,25,47,70,46,2,190,不合格
19994080,81,99,65,98,51,394,合格
19994081,73,38,27,32,89,259,不合格
19994082,23,45,76,4,20,168,不合格
19994083,49,90,66,53,44,302,合格
19994084,81,82,67,31,79,340,合格
19994085,91,90,71,2,53,307,合格
19994086,14,65,47,33,56,215,不合格
19994087,50,54,9,4,21,138,不合格
19994088,56,22,77,25,19,199,不合格
19994089,86,44,45,82,31,288,不合格
19994090,76,67,42,19,46,250,不合格
19994091,37,88,39,91,89,344,合格
19994092,92,87,42,82,38,341,合格
19994093,8,98,81,64,96,347,合格
19994094,80,53,21,10,96,260,不合格
19994095,31,24,76,14,69,214,不合格
19994096,78,94,64,54,4,294,不合格
19994097,54,85,35,64,50,288,不合格
19994098,30,38,24,83,38,213,不合格
19994099,37,92,77,51,9,266,不合格
19994100,66,29,37,83,32,247,不合格
19994101,93,9,28,65,49,244,不合格
19994102,47,63,42,43,23,218,不合格
19994103,58,77,68,97,65,365,合格
19994104,97,14,22,36,41,210,不合格
19994105,32,54,84,39,22,231,不合格
19994106,55,28,42,37,6,168,不合格
19994107,97,80,36,96,15,324,合格
19994108,3,34,1,17,61,116,不合格
19994109,76,21,76,51,39,263,不合格
19994110,84,57,53,36,27,257,不合格
19994111,11,60,45,10,23,149,不合格
19994112,3,0,41,62,30,136,不合格
19994113,52,19,79,48,8,206,不合格
19994114,87,60,0,36,49,232,不合格
19994115,54,47,22,53,87,263,不合格
19994116,0,83,21,14,76,194,不合格
19994117,84,53,80,91,6,314,合格
19994118,64,97,90,20,30,301,合格
19994119,47,96,91,4,14,252,不合格
19994120,87,27,64,87,67,332,合格
19994121,86,83,7,59,80,315,合格
19994122,44,59,46,49,94,292,不合格
19994123,32,43,31,41,57,204,不合格
19994124,55,16,26,65,72,234,不合格
19994125,81,39,9,88,51,268,不合格
19994126,75,56,99,26,5,261,不合格
19994127,67,90,56,23,97,333,合格
19994128,44,39,50,56,30,219,不合格
19994129,85,90,88,37,2,302,合格
19994130,99,79,6,2,24,210,不合格
19994131,97,37,80,97,49,360,合格
19994132,20,35,36,12,99,202,不合格
19994133,65,40,25,19,74,223,不合格
19994134,52,29,24,25,74,204,不合格
19994135,53,98,43,35,7,236,不合格
19994136,79,55,98,35,32,299,不合格
19994137,45,11,45,52,30,183,不合格
19994138,36,98,54,57,5,250,不合格
19994139,94,60,78,76,42,350,合格
19994140,44,91,7,31,75,248,不合格
19994141,53,28,84,13,68,246,不合格
19994142,86,91,75,76,76,404,合格
19994143,14,94,6,35,43,192,不合格
19994144,88,92,4,66,26,276,不合格
19994145,16,54,33,59,8,170,不合格
19994146,18,25,65,17,24,149,不合格
19994147,55,6,81,28,78,248,不合格
19994148,87,30,30,94,51,292,不合格
19994149,93,61,41,66,58,319,合格
19994150,6,21,47,84,51,209,不合格
19994151,62,67,82,30,29,270,不合格
19994152,3,57,55,17,12,144,不合格
19994153,81,55,56,56,35,283,不合格
19994154,52,32,36,64,75,259,不合格
19994155,25,50,47,66,73,261,不合格
19994156,0,31,45,40,90,206,不合格
19994157,51,68,74,98,4,295,不合格
19994158,6,70,77,47,1,201,不合格
19994159,47,82,22,77,68,296,不合格
19994160,83,98,47,72,0,300,合格
19994161,32,52,35,81,75,275,不合格
19994162,11,49,44,3,87,194,不合格
19994163,31,97,14,54,63,259,不合格
19994164,47,72,15,73,66,273,不合格
19994165,15,90,86,14,35,240,不合格
19994166,79,14,73,53,6,225,不合格
19994167,53,67,29,88,60,297,不合格
19994168,29,76,25,3,14,147,不合格
19994169,28,28,15,64,12,147,不合格
19994170,56,15,10,6,97,184,不合格
19994171,7,38,46,62,37,190,不合格
19994172,37,41,36,19,51,184,不合格
19994173,16,58,13,76,6,169,不合格
19994174,20,37,98,81,80,316,合格
19994175,97,92,66,1,57,313,合格
19994176,1,77,70,19,5,172,不合格
19994177,23,15,38,52,38,166,不合格
19994178,3,19,1,69,72,164,不合格
19994179,84,37,22,62,37,242,不合格
19994180,81,52,93,76,91,393,合格
19994181,38,96,72,96,20,322,合格
19994182,75,30,64,16,8,193,不合格
19994183,97,47,38,66,36,284,不合格
19994184,25,40,50,53,77,245,不合格
19994185,39,10,73,70,43,235,不合格
19994186,12,3,79,10,96,200,不合格
19994187,44,30,59,8,61,202,不合格
19994188,97,71,58,69,71,366,合格
19994189,82,60,9,93,10,254,不合格
19994190,0,42,66,33,33,174,不合格
19994191,54,82,34,4,76,250,不合格
19994192,30,59,39,83,74,285,不合格
19994193,67,19,11,76,67,240,不合格
19994194,76,39,58,91,43,307,合格
19994195,23,48,33,86,33,223,不合格
19994196,14,63,57,26,73,233,不合格
19994197,2,1,11,82,93,189,不合格
19994198,72,68,65,99,7,311,合格
19994199,46,93,13,26,34,212,不合格
19994200,98,13,42,1,44,198,不合格
19994201,27,76,53,81,72,309,合格
19994202,20,89,68,93,77,347,合格
19994203,23,37,19,78,27,184,不合格
19994204,78,97,51,55,76,357,合格
19994205,19,29,4,6,51,109,不合格
19994206,65,41,56,46,89,297,不合格
19994207,49,63,51,39,37,239,不合格
19994208,24,2,43,41,27,137,不合格
19994209,81,52,37,86,8,264,不合格
19994210,40,50,0,8,28,126,不合格
19994211,37,81,11,50,47,226,不合格
19994212,80,84,95,27,52,338,合格
19994213,35,96,1,78,71,281,不合格
19994214,16,64,48,11,92,231,不合格
19994215,1,50,68,2,40,161,不合格
19994216,75,93,0,9,95,272,不合格
19994217,98,38,68,8,81,293,不合格
19994218,83,37,46,39,8,213,不合格
19994219,33,11,62,29,40,175,不合格
19994220,55,61,78,5,82,281,不合格
19994221,95,20,78,24,85,302,合格
19994222,25,47,59,56,75,262,不合格
19994223,63,2,92,31,77,265,不合格
19994224,45,32,15,21,51,164,不合格
19994225,19,6,2,65,41,133,不合格
19994226,63,33,21,25,85,227,不合格
19994227,48,39,20,20,49,176,不合格
19994228,49,7,40,83,57,236,不合格
19994229,66,23,95,64,68,316,合格
19994230,24,99,93,9,46,271,不合格
19994231,91,84,56,4,62,297,不合格
19994232,62,16,36,6,84,204,不合格
19994233,99,81,81,92,41,394,合格
19994234,14,39,15,73,37,178,不合格
19994235,12,45,77,54,80,268,不合格
19994236,82,11,13,70,40,216,不合格
19994237,56,67,0,53,73,249,不合格
19994238,33,86,56,2,90,267,不合格
19994239,84,54,79,47,98,362,合格
19994240,98,93,74,15,76,356,合格
19994241,42,64,1,15,77,199,不合格
19994242,37,62,91,37,32,259,不合格
19994243,76,36,85,56,94,347,合格
19994244,35,69,63,79,99,345,合格
19994245,40,24,28,24,42,158,不合格
19994246,69,10,32,4,39,154,不合格
19994247,77,7,81,27,34,226,不合格
19994248,63,59,86,15,86,309,合格
19994249,4,36,34,67,45,186,不合格
19994250,1,21,69,16,97,204,不合格
19994251,6,99,38,80,23,246,不合格
19994252,16,75,9,65,77,242,不合格
19994253,78,46,48,10,39,221,不合格
19994254,93,14,61,11,27,206,不合格
19994255,85,15,42,42,44,228,不合格
19994256,45,78,39,53,18,233,不合格
19994257,87,17,48,61,85,298,不合格
19994258,6,70,74,78,59,287,不合格
19994259,23,3,71,50,84,231,不合格
19994260,69,3,17,42,66,197,不合格
19994261,32,13,35,6,39,125,不合格
19994262,90,42,66,74,79,351,合格
19994263,43,48,29,78,43,241,不合格
19994264,15,59,41,88,4,207,不合格
19994265,26,73,68,8,97,272,不合格
19994266,75,15,97,26,19,232,不合格
19994267,45,87,12,45,22,211,不合格
19994268,81,38,84,87,58,348,合格
19994269,79,11,71,11,99,271,不合格
19994270,47,88,81,2,75,293,不合格
19994271,42,19,87,77,97,322,合格
19994272,65,32,92,76,19,284,不合格
19994273,88,36,18,47,89,278,不合格
19994274,37,89,82,8,61,277,不合格
19994275,30,21,75,28,61,215,不合格
19994276,24,96,72,89,35,316,合格
19994277,78,3,3,58,53,195,不合格
19994278,50,9,30,87,56,232,不合格
19994279,50,70,90,2,33,245,不合格
19994280,34,48,47,89,74,292,不合格
19994281,30,63,34,90,90,307,合格
19994282,58,30,72,1,65,226,不合格
19994283,5,86,2,6,97,196,不合格
19994284,2,22,91,31,17,163,不合格
19994285,10,56,87,13,47,213,不合格
19994286,16,26,12,37,73,164,不合格
19994287,56,44,17,44,83,244,不合格
19994288,10,31,18,83,87,229,不合格
19994289,63,8,77,80,58,286,不合格
19994290,75,6,9,21,4,115,不合格
19994291,51,37,57,6,10,161,不合格
19994292,59,50,58,84,39,290,不合格
19994293,92,58,28,51,2,231,不合格
19994294,63,69,58,51,85,326,合格
19994295,13,16,40,65,60,194,不合格
19994296,30,14,81,73,43,241,不合格
19994297,99,17,16,68,95,295,不合格
19994298,87,36,55,67,35,280,不合格
19994299,30,51,62,25,91,259,不合格
19994300,10,40,17,88,2,157,不合格
19994301,98,97,80,51,43,369,合格
19994302,39,4,61,89,31,224,不合格
19994303,35,51,33,41,65,225,不合格
19994304,21,53,57,29,98,258,不合格
19994305,76,39,14,37,55,221,不合格
19994306,93,48,7,77,46,271,不合格
19994307,34,30,57,44,45,210,不合格
19994308,27,23,89,79,35,253,不合格
19994309,12,62,0,15,83,172,不合格
19994310,68,45,58,97,53,321,合格
19994311,84,24,78,6,66,258,不合格
19994312,39,2,42,42,29,154,不合格
19994313,56,91,57,42,89,335,合格
19994314,79,55,73,31,29,267,不合格
19994315,30,86,44,42,61,263,不合格
19994316,62,81,70,19,9,241,不合格
19994317,70,36,38,43,24,211,不合格
19994318,49,5,28,89,7,178,不合格
19994319,57,22,25,5,78,187,不合格
19994320,71,12,56,88,19,246,不合格
19994321,50,45,54,34,36,219,不合格
19994322,96,11,88,18,32,245,不合格
19994323,19,7,62,60,81,229,不合格
19994324,81,3,59,5,6,154,不合格
19994325,86,67,12,31,27,223,不合格
19994326,95,37,61,51,63,307,合格
19994327,88,45,8,36,85,262,不合格
19994328,61,41,67,39,82,290,不合格
19994329,95,44,56,11,40,246,不合格
19994330,97,20,34,19,15,185,不合格
19994331,41,26,4,63,80,214,不合格
19994332,5,82,59,6,50,202,不合格
19994333,84,50,39,62,43,278,不合格
19994334,52,35,7,93,43,230,不合格
19994335,20,61,32,23,98,234,不合格
19994336,29,35,60,67,31,222,不合格
19994337,5,85,77,81,79,327,合格
19994338,15,35,40,20,41,151,不合格
19994339,10,51,99,64,46,270,不合格
19994340,98,73,31,65,4,271,不合格
19994341,39,85,87,38,18,267,不合格
19994342,86,46,18,56,12,218,不合格
19994343,2,33,51,81,73,240,不合格
19994344,67,75,83,22,12,259,不合格
19994345,66,28,95,62,87,338,合格
19994346,94,18,1,59,74,246,不合格
19994347,7,81,70,35,65,258,不合格
19994348,40,82,23,89,95,329,合格
19994349,52,20,40,94,12,218,不合格
19994350,85,65,66,45,4,265,不合格
19994351,45,26,26,59,43,199,不合格
19994352,86,25,27,98,71,307,合格
19994353,48,23,32,86,34,223,不合格
19994354,73,29,9,50,62,223,不合格
19994355,9,81,36,89,89,304,合格
19994356,46,89,57,52,27,271,不合格
19994357,77,25,47,0,12,161,不合格
19994358,71,35,24,22,98,250,不合格
19994359,55,89,45,11,72,272,不合格
19994360,7,33,96,22,54,212,不合格
19994361,90,64,37,4,82,277,不合格
19994362,12,99,90,19,86,306,合格
19994363,67,10,58,83,75,293,不合格
19994364,27,3,97,96,55,278,不合格
19994365,70,24,43,30,89,256,不合格
19994366,39,51,93,25,34,242,不合格
19994367,34,23,1,67,21,146,不合格
19994368,94,87,96,99,60,436,合格
19994369,81,62,15,24,4,186,不合格
19994370,98,75,38,30,92,333,合格
19994371,32,96,90,56,36,310,合格
19994372,76,98,76,32,98,380,合格
19994373,27,16,52,82,65,242,不合格
19994374,70,85,14,73,56,298,不合格
19994375,96,23,3,47,68,237,不合格
19994376,73,92,85,91,83,424,合格
19994377,34,25,92,79,79,309,合格
19994378,18,74,38,77,93,300,合格
19994379,93,75,72,51,66,357,合格
19994380,73,87,30,41,93,324,合格
19994381,74,9,31,28,0,142,不合格
19994382,14,68,77,52,37,248,不合格
19994383,22,13,69,37,71,212,不合格
19994384,0,90,52,33,69,244,不合格
19994385,28,58,6,52,81,225,不合格
19994386,55,93,53,74,85,360,合格
19994387,92,10,74,11,13,200,不合格
19994388,53,88,1,80,48,270,不合格
19994389,10,67,46,94,31,248,不合格
19994390,65,1,18,45,87,216,不合格
19994391,98,90,38,4,28,258,不合格
19994392,28,96,74,61,33,292,不合格
19994393,37,85,28,11,72,233,不合格
19994394,47,37,19,79,95,277,不合格
19994395,59,61,66,54,50,290,不合格
19994396,11,31,48,32,70,192,不合格
19994397,84,88,38,19,30,259,不合格
19994398,83,17,42,45,63,250,不合格
19994399,75,38,40,70,5,228,不合格
19994400,91,45,37,28,86,287,不合格
19994401,0,93,56,93,56,298,不合格
19994402,81,25,36,73,86,301,合格
19994403,23,71,82,52,86,314,合格
19994404,33,75,8,92,6,214,不合格
19994405,83,11,69,30,41,234,不合格
19994406,51,2,39,63,34,189,不合格
19994407,84,64,87,38,39,312,合格
19994408,75,59,22,67,74,297,不合格
19994409,92,83,73,80,9,337,合格
19994410,5,47,35,21,45,153,不合格
19994411,61,55,37,99,54,306,合格
19994412,39,3,96,23,20,181,不合格
19994413,50,27,44,95,65,281,不合格
19994414,56,31,14,0,14,115,不合格
19994415,62,7,0,87,56,212,不合格
19994416,2,53,44,24,74,197,不合格
19994417,94,89,61,64,68,376,合格
19994418,36,31,80,56,76,279,不合格
19994419,34,4,7,6,80,131,不合格
19994420,42,89,80,29,2,242,不合格
19994421,46,61,92,87,97,383,合格
19994422,78,20,93,23,60,274,不合格
19994423,2,31,19,14,17,83,不合格
19994424,25,41,44,80,44,234,不合格
19994425,90,26,7,24,19,166,不合格
19994426,51,61,30,74,74,290,不合格
19994427,46,57,94,36,71,304,合格
19994428,52,51,55,53,69,280,不合格
19994429,88,19,27,69,46,249,不合格
19994430,87,14,17,87,88,293,不合格
19994431,67,32,56,17,21,193,不合格
19994432,98,33,23,55,36,245,不合格
19994433,87,47,76,83,50,343,合格
19994434,44,35,17,60,66,222,不合格
19994435,96,92,61,16,20,285,不合格
19994436,2,69,41,84,74,270,不合格
19994437,34,4,0,74,10,122,不合格
19994438,60,64,74,84,34,316,合格
19994439,71,68,82,21,65,307,合格
19994440,56,55,27,25,41,204,不合格
19994441,71,25,31,75,18,220,不合格
19994442,36,94,63,10,96,299,不合格
19994443,71,75,81,9,98,334,合格
19994444,13,18,50,49,55,185,不合格
19994445,58,23,94,87,22,284,不合格
19994446,56,62,28,32,86,264,不合格
19994447,95,7,88,8,85,283,不合格
19994448,0,54,73,23,15,165,不合格
19994449,22,44,31,83,96,276,不合格
19994450,16,20,15,79,24,154,不合格
19994451,96,8,85,30,86,305,合格
19994452,83,51,52,56,56,298,不合格
19994453,18,19,63,18,84,202,不合格
19994454,33,64,25,82,21,225,不合格
19994455,78,69,33,12,96,288,不合格
19994456,7,29,74,27,74,211,不合格
19994457,47,76,22,24,49,218,不合格
19994458,8,45,43,41,55,192,不合格
19994459,69,6,76,60,83,294,不合格
19994460,37,62,74,13,96,282,不合格
19994461,64,99,72,15,80,330,合格
19994462,20,5,3,78,52,158,不合格
19994463,65,49,56,70,36,276,不合格
19994464,32,25,3,94,28,182,不合格
19994465,94,44,1,49,14,202,不合格
19994466,73,25,33,64,80,275,不合格
19994467,79,86,59,20,89,333,合格
19994468,14,62,93,16,46,231,不合格
19994469,11,47,74,43,97,272,不合格
19994470,50,78,2,44,67,241,不合格
19994471,43,31,51,18,27,170,不合格
19994472,25,12,59,53,96,245,不合格
19994473,13,7,21,87,72,200,不合格
19994474,76,82,55,80,45,338,合格
19994475,11,53,18,4,85,171,不合格
19994476,99,77,78,76,51,381,合格
19994477,50,69,73,81,75,348,合格
19994478,69,88,57,76,39,329,合格
19994479,38,5,67,7,67,184,不合格
19994480,69,61,10,24,48,212,不合格
19994481,41,58,53,43,94,289,不合格
19994482,87,65,42,93,91,378,合格
19994483,74,62,2,96,76,310,合格
19994484,26,30,92,85,20,253,不合格
19994485,90,67,49,54,41,301,合格
19994486,79,2,9,96,67,253,不合格
19994487,69,92,47,35,53,296,不合格
19994488,68,17,35,67,29,216,不合格
19994489,26,12,43,63,66,210,不合格
19994490,19,74,83,59,51,286,不合格
19994491,66,33,11,12,5,127,不合格
19994492,90,29,96,36,42,293,不合格
19994493,47,77,45,88,76,333,合格
19994494,90,92,79,28,26,315,合格
19994495,5,76,35,30,81,227,不合格
19994496,96,15,29,52,75,267,不合格
19994497,65,66,80,60,32,303,合格
19994498,43,38,5,65,46,197,不合格
19994499,82,68,81,52,38,321,合格
19994500,3,84,83,81,69,320,合格
19994501,35,69,41,49,0,194,不合格
19994502,94,94,38,66,6,298,不合格
19994503,60,38,27,58,78,261,不合格
19994504,35,12,55,86,44,232,不合格
19994505,87,78,99,22,96,382,合格
19994506,80,71,44,13,78,286,不合格
19994507,1,86,64,41,39,231,不合格
19994508,64,30,64,35,44,237,不合格
19994509,30,57,77,83,87,334,合格
19994510,14,70,96,25,37,242,不合格
19994511,38,62,59,22,2,183,不合格
19994512,98,27,62,53,2,242,不合格
19994513,53,63,13,5,70,204,不合格
19994514,75,26,77,74,75,327,合格
19994515,37,68,66,6,39,216,不合格
19994516,95,17,8,62,74,256,不合格
19994517,91,44,12,8,47,202,不合格
19994518,36,5,90,84,18,233,不合格
19994519,13,29,50,7,9,108,不合格
19994520,11,7,9,59,71,157,不合格
19994521,60,71,68,18,7,224,不合格
19994522,20,44,79,39,1,183,不合格
19994523,21,95,46,94,19,275,不合格
19994524,24,12,7,29,46,118,不合格
19994525,3,33,54,58,0,148,不合格
19994526,24,79,68,52,82,305,合格
19994527,78,21,8,7,87,201,不合格
19994528,70,9,45,63,90,277,不合格
19994529,90,61,13,40,92,296,不合格
19994530,40,99,17,47,69,272,不合格
19994531,39,53,99,93,76,360,合格
19994532,63,61,59,19,37,239,不合格
19994533,26,40,50,51,87,254,不合格
19994534,63,53,39,79,79,313,合格
19994535,98,31,99,47,71,346,合格
19994536,38,48,68,66,4,224,不合格
19994537,94,86,30,39,87,336,合格
19994538,25,82,47,66,36,256,不合格
19994539,97,87,20,71,42,317,合格
19994540,85,59,94,81,83,402,合格
19994541,85,84,60,43,46,318,合格
19994542,30,28,30,16,4,108,不合格
19994543,20,2,86,91,74,273,不合格
19994544,32,99,80,21,37,269,不合格
19994545,49,16,78,78,72,293,不合格
19994546,83,8,53,80,56,280,不合格
19994547,58,71,36,17,48,230,不合格
19994548,88,21,9,40,58,216,不合格
19994549,43,28,45,9,36,161,不合格
19994550,98,70,89,68,11,336,合格
19994551,29,10,25,90,83,237,不合格
19994552,54,75,69,73,47,318,合格
19994553,70,18,43,87,45,263,不合格
19994554,10,30,85,95,89,309,合格
19994555,32,43,59,35,39,208,不合格
19994556,6,60,36,22,97,221,不合格
19994557,85,64,81,23,15,268,不合格
19994558,64,37,24,96,57,278,不合格
19994559,55,9,44,81,86,275,不合格
19994560,53,2,60,70,30,215,不合格
19994561,94,6,97,51,88,336,合格
19994562,51,19,1,71,86,228,不合格
19994563,74,57,95,73,38,337,合格
19994564,9,47,25,88,49,218,不合格
19994565,40,81,69,30,11,231,不合格
19994566,88,11,8,28,42,177,不合格
19994567,95,83,16,2,70,266,不合格
19994568,71,46,50,26,31,224,不合格
19994569,2,1,23,38,97,161,不合格
19994570,25,58,57,58,53,251,不合格
19994571,93,17,85,93,34,322,合格
19994572,89,80,69,21,43,302,合格
19994573,15,80,28,56,77,256,不合格
19994574,77,84,94,29,64,348,合格
19994575,19,64,38,91,98,310,合格
19994576,11,98,36,38,94,277,不合格
19994577,53,48,17,46,82,246,不合格
19994578,94,28,84,69,79,354,合格
19994579,62,61,25,1,72,221,不合格
19994580,54,58,33,47,39,231,不合格
19994581,6,60,83,99,76,324,合格
19994582,39,31,87,46,53,256,不合格
19994583,34,17,99,97,53,300,合格
19994584,77,46,49,44,58,274,不合格
19994585,22,78,45,36,79,260,不合格
19994586,86,99,46,29,89,349,合格
19994587,70,14,57,66,88,295,不合格
19994588,77,48,3,94,86,308,合格
19994589,52,95,28,55,53,283,不合格
19994590,15,67,64,22,15,183,不合格
19994591,56,6,45,7,35,149,不合格
19994592,45,33,61,36,2,177,不合格
19994593,59,91,4,22,37,213,不合格
19994594,24,83,78,12,5,202,不合格
19994595,35,61,25,31,54,206,不合格
19994596,97,47,44,73,9,270,不合格
19994597,21,32,43,58,39,193,不合格
19994598,39,80,97,75,87,378,合格
19994599,39,3,5,48,58,153,不合格
19994600,47,18,85,66,59,275,不合格
19994601,28,32,8,24,72,164,不合格
19994602,64,24,3,58,45,194,不合格
19994603,44,78,80,7,53,262,不合格
19994604,30,71,6,46,65,218,不合格
19994605,21,79,50,71,92,313,合格
19994606,53,83,34,34,98,302,合格
19994607,61,71,0,29,92,253,不合格
19994608,4,38,19,2,14,77,不合格
19994609,20,99,13,14,96,242,不合格
19994610,81,55,2,57,18,213,不合格
19994611,69,5,37,9,31,151,不合格
19994612,12,59,56,40,60,227,不合格
19994613,1,38,8,6,46,99,不合格
19994614,38,20,49,10,67,184,不合格
19994615,46,71,61,78,23,279,不合格
19994616,19,28,77,96,62,282,不合格
19994617,65,72,23,51,78,289,不合格
19994618,58,18,77,60,84,297,不合格
19994619,12,26,12,34,15,99,不合格
19994620,57,83,69,45,63,317,合格
19994621,27,79,2,84,44,236,不合格
19994622,76,35,90,38,96,335,合格
19994623,87,66,51,62,16,282,不合格
19994624,59,34,36,73,35,237,不合格
19994625,20,7,61,53,26,167,不合格
19994626,3,27,34,82,75,221,不合格
19994627,14,81,88,99,72,354,合格
19994628,18,80,96,55,14,263,不合格
19994629,64,66,34,16,25,205,不合格
19994630,4,56,35,15,58,168,不合格
19994631,46,0,62,47,50,205,不合格
19994632,77,81,89,49,72,368,合格
19994633,15,65,36,34,90,240,不合格
19994634,8,98,89,76,43,314,合格
19994635,76,93,24,84,63,340,合格
19994636,77,15,7,2,72,173,不合格
19994637,5,85,52,11,49,202,不合格
19994638,49,62,30,52,44,237,不合格
19994639,28,52,62,25,51,218,不合格
19994640,69,38,81,61,83,332,合格
19994641,37,33,47,68,16,201,不合格
19994642,4,4,61,85,44,198,不合格
19994643,55,94,4,22,2,177,不合格
19994644,53,57,30,89,35,264,不合格
19994645,9,41,77,19,31,177,不合格
19994646,15,17,84,20,55,191,不合格
19994647,5,20,70,45,1,141,不合格
19994648,63,59,26,4,8,160,不合格
19994649,62,18,41,36,91,248,不合格
19994650,35,50,2,86,18,191,不合格
19994651,70,44,38,86,70,308,合格
19994652,50,65,85,22,23,245,不合格
19994653,99,40,70,22,36,267,不合格
19994654,71,84,79,66,13,313,合格
19994655,92,28,19,30,29,198,不合格
19994656,87,85,4,16,19,211,不合格
19994657,72,78,94,6,1,251,不合格
19994658,51,83,73,10,47,264,不合格
19994659,28,55,13,19,98,213,不合格
19994660,74,65,16,38,6,199,不合格
19994661,76,33,36,53,50,248,不合格
19994662,37,14,13,88,10,162,不合格
19994663,13,18,35,56,82,204,不合格
19994664,47,12,87,11,90,247,不合格
19994665,41,58,12,20,71,202,不合格
19994666,16,69,49,56,13,203,不合格
19994667,56,99,53,22,4,234,不合格
19994668,81,38,24,98,64,305,合格
19994669,9,8,22,62,8,109,不合格
19994670,47,26,81,98,37,289,不合格
19994671,51,87,30,82,58,308,合格
19994672,27,36,51,9,27,150,不合格
19994673,44,77,98,72,5,296,不合格
19994674,87,56,40,26,67,276,不合格
19994675,47,64,44,31,96,282,不合格
19994676,92,88,21,93,5,299,不合格
19994677,70,44,56,38,44,252,不合格
19994678,91,2,2,59,62,216,不合格
19994679,95,31,52,69,30,277,不合格
19994680,59,24,81,46,41,251,不合格
19994681,13,7,60,47,15,142,不合格
19994682,36,28,21,63,65,213,不合格
19994683,49,70,85,57,83,344,合格
19994684,49,69,66,63,44,291,不合格
19994685,13,69,27,24,15,148,不合格
19994686,56,41,16,31,26,170,不合格
19994687,83,53,25,9,96,266,不合格
19994688,18,32,16,89,39,194,不合格
19994689,53,35,28,23,31,170,不合格
19994690,96,34,6,36,14,186,不合格
19994691,51,13,9,53,19,145,不合格
19994692,20,87,16,91,85,299,不合格
19994693,0,37,86,1,91,215,不合格
19994694,96,50,66,52,42,306,合格
19994695,66,39,16,72,6,199,不合格
19994696,38,3,92,89,73,295,不合格
19994697,31,44,48,14,74,211,不合格
19994698,42,50,4,85,89,270,不合格
19994699,8,38,97,12,13,168,不合格
19994700,83,80,62,58,43,326,合格
19994701,37,34,11,15,90,187,不合格
19994702,73,25,18,15,66,197,不合格
19994703,3,62,9,67,7,148,不合格
19994704,19,78,7,95,73,272,不合格
19994705,92,41,98,74,27,332,合格
19994706,32,34,9,40,59,174,不合格
19994707,51,91,44,58,60,304,合格
19994708,90,34,70,73,43,310,合格
19994709,51,39,57,19,86,252,不合格
19994710,79,84,41,45,20,269,不合格
19994711,20,12,96,45,36,209,不合格
19994712,31,14,99,99,32,275,不合格
19994713,45,59,96,89,82,371,合格
19994714,1,38,27,56,18,140,不合格
19994715,29,7,58,80,19,193,不合格
19994716,96,29,33,76,14,248,不合格
19994717,64,45,14,66,66,255,不合格
19994718,14,46,52,0,43,155,不合格
19994719,35,20,31,64,72,222,不合格
19994720,19,81,71,65,89,325,合格
19994721,61,1,36,18,13,129,不合格
19994722,63,57,58,81,0,259,不合格
19994723,67,85,29,39,9,229,不合格
19994724,3,22,96,14,36,171,不合格
19994725,40,56,53,24,42,215,不合格
19994726,13,11,94,13,47,178,不合格
19994727,41,6,16,89,95,247,不合格
19994728,4,18,86,47,25,180,不合格
19994729,67,12,56,65,14,214,不合格
19994730,60,78,42,23,0,203,不合格
19994731,78,88,35,67,97,365,合格
19994732,65,23,61,74,4,227,不合格
19994733,12,9,31,96,53,201,不合格
19994734,69,24,13,75,14,195,不合格
19994735,0,67,68,43,26,204,不合格
19994736,0,51,67,11,83,212,不合格
19994737,68,85,36,76,98,363,合格
19994738,57,0,10,55,16,138,不合格
19994739,35,1,48,94,50,228,不合格
19994740,46,5,18,20,53,142,不合格
19994741,20,79,35,95,69,298,不合格
19994742,59,43,88,24,34,248,不合格
19994743,30,79,86,74,37,306,合格
19994744,74,19,93,86,3,275,不合格
19994745,8,50,4,94,48,204,不合格
19994746,43,79,61,91,44,318,合格
19994747,5,34,76,70,78,263,不合格
19994748,59,78,58,5,51,251,不合格
19994749,2,44,31,82,9,168,不合格
19994750,48,40,8,43,41,180,不合格
19994751,74,49,24,35,33,215,不合格
19994752,90,14,56,91,83,334,合格
19994753,54,56,64,16,21,211,不合格
19994754,80,96,59,18,16,269,不合格
19994755,16,58,80,50,91,295,不合格
19994756,61,84,94,63,46,348,合格
19994757,85,31,41,10,28,195,不合格
19994758,45,77,54,48,64,288,不合格
19994759,6,53,35,54,70,218,不合格
19994760,64,10,32,36,8,150,不合格
19994761,40,10,59,73,2,184,不合格
19994762,44,76,4,62,65,251,不合格
19994763,4,77,5,14,63,163,不合格
19994764,25,99,85,99,54,362,合格
19994765,75,55,7,33,75,245,不合格
19994766,74,66,39,74,59,312,合格
19994767,14,43,48,82,19,206,不合格
19994768,80,38,2,81,38,239,不合格
19994769,71,94,34,80,4,283,不合格
19994770,86,94,83,92,3,358,合格
19994771,40,92,92,16,0,240,不合格
19994772,47,50,70,63,55,285,不合格
19994773,62,74,10,74,42,262,不合格
19994774,24,40,75,26,61,226,不合格
19994775,52,24,58,90,77,301,合格
19994776,0,57,31,48,66,202,不合格
19994777,23,58,89,67,44,281,不合格
19994778,87,25,10,64,13,199,不合格
19994779,94,5,51,25,96,271,不合格
19994780,73,11,36,77,90,287,不合格
19994781,3,6,38,71,22,140,不合格
19994782,58,45,95,75,86,359,合格
19994783,86,88,54,45,51,324,合格
19994784,67,74,3,40,13,197,不合格
19994785,7,54,18,25,10,114,不合格
19994786,71,80,58,43,70,322,合格
19994787,7,57,60,32,22,178,不合格
19994788,66,71,81,19,83,320,合格
19994789,49,59,2,27,28,165,不合格
19994790,92,20,42,8,15,177,不合格
19994791,48,37,70,86,61,302,合格
19994792,67,36,89,67,43,302,合格
19994793,79,12,80,99,64,334,合格
19994794,16,74,12,30,56,188,不合格
19994795,89,98,26,44,48,305,合格
19994796,56,94,93,78,58,379,合格
19994797,43,2,40,71,37,193,不合格
19994798,9,46,19,78,36,188,不合格
19994799,31,35,21,33,31,151,不合格
19994800,40,24,82,69,94,309,合格
19994801,33,9,45,52,86,225,不合格
19994802,99,30,65,33,46,273,不合格
19994803,61,71,73,76,89,370,合格
19994804,0,45,61,11,87,204,不合格
19994805,87,46,22,78,40,273,不合格
19994806,43,82,36,82,82,325,合格
19994807,83,30,19,92,85,309,合格
19994808,9,63,64,64,9,209,不合格
19994809,95,25,94,83,86,383,合格
19994810,72,28,66,16,57,239,不合格
19994811,88,97,54,36,21,296,不合格
19994812,4,62,3,32,11,112,不合格
19994813,56,13,33,55,92,249,不合格
19994814,46,23,27,11,27,134,不合格
19994815,64,85,91,52,20,312,合格
19994816,7,47,14,32,72,172,不合格
19994817,91,59,97,44,28,319,合格
19994818,71,84,0,1,30,186,不合格
19994819,42,0,61,23,11,137,不合格
19994820,59,7,14,74,60,214,不合格
19994821,95,89,92,89,33,398,合格
19994822,16,38,49,83,46,232,不合格
19994823,20,21,71,36,61,209,不合格
19994824,84,49,48,99,19,299,不合格
19994825,23,50,78,78,64,293,不合格
19994826,53,37,74,53,51,268,不合格
19994827,6,33,25,1,79,144,不合格
19994828,2,27,29,30,19,107,不合格
19994829,12,94,92,91,50,339,合格
19994830,67,7,49,64,0,187,不合格
19994831,31,98,94,75,94,392,合格
19994832,70,84,99,13,43,309,合格
19994833,44,61,93,93,43,334,合格
19994834,57,95,1,57,67,277,不合格
19994835,60,61,64,50,43,278,不合格
19994836,61,57,92,88,33,331,合格
19994837,17,98,21,9,22,167,不合格
19994838,30,93,50,33,13,219,不合格
19994839,19,73,91,43,88,314,合格
19994840,26,24,92,6,4,152,不合格
19994841,7,79,49,82,98,315,合格
19994842,29,25,24,16,74,168,不合格
19994843,45,2,70,65,4,186,不合格
19994844,57,23,77,67,29,253,不合格
19994845,50,70,62,70,4,256,不合格
19994846,62,60,62,15,67,266,不合格
19994847,17,15,45,26,61,164,不合格
19994848,25,58,62,81,46,272,不合格
19994849,4,64,1,51,39,159,不合格
19994850,45,1,47,30,40,163,不合格
19994851,31,76,96,87,51,341,合格
19994852,56,50,59,51,96,312,合格
19994853,43,93,85,54,15,290,不合格
19994854,36,81,35,44,55,251,不合格
19994855,11,17,25,93,5,151,不合格
19994856,49,31,66,71,94,311,合格
19994857,32,17,60,62,21,192,不合格
19994858,29,45,43,51,56,224,不合格
19994859,51,64,11,89,41,256,不合格
19994860,75,95,83,0,42,295,不合格
19994861,74,39,29,17,85,244,不合格
19994862,7,71,53,38,65,234,不合格
19994863,19,68,10,44,87,228,不合格
19994864,81,16,27,17,19,160,不合格
19994865,49,10,95,90,71,315,合格
19994866,31,7,67,27,48,180,不合格
19994867,27,33,7,4,84,155,不合格
19994868,25,1,95,6,73,200,不合格
19994869,20,78,46,44,32,220,不合格
19994870,33,72,15,89,56,265,不合格
19994871,36,90,5,98,18,247,不合格
19994872,79,11,45,35,77,247,不合格
19994873,36,44,83,12,40,215,不合格
19994874,80,7,94,72,5,258,不合格
19994875,67,50,15,52,27,211,不合格
19994876,26,89,21,2,70,208,不合格
19994877,29,71,11,60,81,252,不合格
19994878,4,88,94,34,44,264,不合格
19994879,22,91,55,18,23,209,不合格
19994880,35,77,7,34,48,201,不合格
19994881,6,12,82,47,98,245,不合格
19994882,11,74,88,29,47,249,不合格
19994883,76,79,88,79,5,327,合格
19994884,45,79,35,52,14,225,不合格
19994885,18,98,63,25,3,207,不合格
19994886,39,37,64,1,99,240,不合格
19994887,95,66,83,87,80,411,合格
19994888,16,13,87,65,28,209,不合格
19994889,92,8,14,70,38,222,不合格
19994890,69,95,67,93,50,374,合格
19994891,15,23,53,5,6,102,不合格
19994892,2,37,42,15,18,114,不合格
19994893,35,91,39,72,21,258,不合格
19994894,78,17,1,24,26,146,不合格
19994895,56,38,61,55,36,246,不合格
19994896,87,19,1,53,72,232,不合格
19994897,9,0,73,45,24,151,不合格
19994898,43,23,47,24,70,207,不合格
19994899,34,66,96,29,87,312,合格
19994900,15,26,50,25,65,181,不合格
19994901,67,92,80,75,74,388,合格
19994902,27,41,26,93,79,266,不合格
19994903,51,73,99,58,66,347,合格
19994904,61,63,8,64,70,266,不合格
19994905,3,7,57,64,41,172,不合格
19994906,38,76,1,19,8,142,不合格
19994907,64,75,90,64,9,302,合格
19994908,87,24,8,34,49,202,不合格
19994909,56,3,6,60,51,176,不合格
19994910,20,30,72,84,84,290,不合格
19994911,60,95,56,24,58,293,不合格
19994912,87,20,35,2,10,154,不合格
19994913,91,66,50,94,97,398,合格
19994914,35,87,62,87,5,276,不合格
19994915,46,47,19,39,76,227,不合格
19994916,38,21,72,45,14,190,不合格
19994917,82,16,51,44,83,276,不合格
19994918,46,76,78,52,9,261,不合格
19994919,45,71,54,44,17,231,不合格
19994920,47,46,87,11,58,249,不合格
19994921,93,15,38,82,86,314,合格
19994922,6,11,15,24,15,71,不合格
19994923,63,80,93,72,58,366,合格
19994924,64,60,24,42,41,231,不合格
19994925,16,56,7,44,46,169,不合格
19994926,83,94,82,74,44,377,合格
19994927,72,43,77,40,21,253,不合格
19994928,0,48,59,60,2,169,不合格
19994929,68,43,28,53,78,270,不合格
19994930,69,90,19,93,68,339,合格
19994931,59,69,56,97,87,368,合格
19994932,70,78,23,53,57,281,不合格
19994933,6,62,1,42,95,206,不合格
19994934,75,64,10,26,75,250,不合格
19994935,8,37,8,82,5,140,不合格
19994936,40,27,36,37,67,207,不合格
19994937,88,57,79,55,95,374,合格
19994938,40,97,64,91,84,376,合格
19994939,62,69,87,89,32,339,合格
19994940,9,6,8,40,50,113,不合格
19994941,9,6,68,47,0,130,不合格
19994942,8,82,30,53,98,271,不合格
19994943,5,9,14,49,37,114,不合格
19994944,28,1,54,36,81,200,不合格
19994945,52,68,73,99,6,298,不合格
19994946,38,85,52,47,10,232,不合格
19994947,15,36,70,18,92,231,不合格
19994948,15,86,45,53,46,245,不合格
19994949,23,79,12,54,53,221,不合格
19994950,93,60,61,1,25,240,不合格
19994951,15,73,26,82,65,261,不合格
19994952,41,82,18,66,70,277,不合格
19994953,34,15,83,88,86,306,合格
19994954,7,89,45,40,75,256,不合格
19994955,77,13,3,95,60,248,不合格
19994956,96,65,87,68,38,354,合格
19994957,1,63,52,18,73,207,不合格
19994958,90,58,83,75,92,398,合格
19994959,93,39,88,29,68,317,合格
19994960,36,75,33,85,66,295,不合格
19994961,11,0,81,64,18,174,不合格
19994962,33,34,79,64,82,292,不合格
19994963,64,12,73,61,19,229,不合格
19994964,66,53,11,75,56,261,不合格
19994965,51,85,21,34,55,246,不合格
19994966,28,78,27,13,65,211,不合格
19994967,22,11,88,82,41,244,不合格
19994968,55,82,53,56,56,302,合格
19994969,63,21,74,81,30,269,不合格
19994970,74,93,84,55,18,324,合格
19994971,52,2,40,52,5,151,不合格
19994972,55,5,78,64,72,274,不合格
19994973,45,32,0,38,52,167,不合格
19994974,10,9,66,32,81,198,不合格
19994975,84,87,72,29,50,322,合格
19994976,62,83,11,57,91,304,合格
19994977,14,41,71,0,28,154,不合格
19994978,2,36,89,36,66,229,不合格
19994979,63,92,73,56,42,326,合格
19994980,67,27,14,59,67,234,不合格
19994981,51,47,9,37,45,189,不合格
19994982,3,43,0,45,44,135,不合格
19994983,80,78,25,81,55,319,合格
19994984,48,14,66,99,37,264,不合格
19994985,14,2,69,79,12,176,不合格
19994986,72,38,57,27,95,289,不合格
19994987,56,89,47,58,9,259,不合格
19994988,82,43,52,89,13,279,不合格
19994989,10,22,58,5,66,161,不合格
19994990,66,59,47,75,41,288,不合格
19994991,38,38,10,54,37,177,不合格
19994992,11,61,67,58,94,291,不合格
19994993,45,95,32,31,35,238,不合格
19994994,42,98,38,14,12,204,不合格
19994995,11,39,7,30,24,111,不合格
19994996,56,0,51,14,57,178,不合格
19994997,3,65,91,49,88,296,不合格
19994998,9,13,98,30,98,248,不合格
19994999,52,71,7,86,90,306,合格
19995000,70,59,0,55,64,248,不合格
19995001,59,76,57,69,38,299,不合格
19995002,75,7,32,80,50,244,不合格
19995003,78,65,36,99,7,285,不合格
19995004,11,9,21,19,7,67,不合格
19995005,72,52,59,16,88,287,不合格
19995006,19,34,21,42,68,184,不合格
19995007,40,69,67,16,52,244,不合格
19995008,38,69,7,61,51,226,不合格
19995009,10,10,5,13,94,132,不合格
19995010,38,43,78,42,91,292,不合格
19995011,94,27,68,83,0,272,不合格
19995012,43,36,75,88,20,262,不合格
19995013,55,79,0,0,9,143,不合格
19995014,52,27,26,99,78,282,不合格
19995015,28,55,74,72,55,284,不合格
19995016,82,40,71,21,79,293,不合格
19995017,75,0,55,55,74,259,不合格
19995018,89,48,23,72,85,317,合格
19995019,32,25,18,54,84,213,不合格
19995020,85,41,6,32,21,185,不合格
19995021,45,95,41,19,6,206,不合格
19995022,97,92,65,52,79,385,合格
19995023,43,24,85,85,65,302,合格
19995024,61,39,32,73,87,292,不合格
19995025,45,16,59,9,93,222,不合格
19995026,60,58,17,99,9,243,不合格
19995027,4,66,62,19,66,217,不合格
19995028,78,17,53,67,16,231,不合格
19995029,77,66,49,31,91,314,合格
19995030,55,69,70,61,33,288,不合格
19995031,43,46,90,84,41,304,合格
19995032,61,5,24,32,25,147,不合格
19995033,32,61,30,57,92,272,不合格
19995034,62,82,76,61,0,281,不合格
19995035,32,37,74,60,88,291,不合格
19995036,41,86,1,67,30,225,不合格
19995037,31,54,99,20,54,258,不合格
19995038,5,66,94,3,87,255,不合格
19995039,41,72,22,22,59,216,不合格
19995040,19,66,62,52,83,282,不合格
19995041,95,5,97,59,27,283,不合格
19995042,34,54,91,30,45,254,不合格
19995043,11,92,92,32,29,256,不合格
19995044,43,97,38,66,7,251,不合格
19995045,88,0,26,68,83,265,不合格
19995046,61,78,32,91,57,319,合格
19995047,14,79,79,65,66,303,合格
19995048,28,92,19,28,2,169,不合格
19995049,71,2,71,10,16,170,不合格
19995050,15,47,72,40,73,247,不合格
19995051,15,81,68,87,19,270,不合格
19995052,1,16,42,29,1,89,不合格
19995053,0,14,55,92,6,167,不合格
19995054,0,87,93,40,65,285,不合格
19995055,27,25,53,7,6,118,不合格
19995056,98,59,14,18,94,283,不合格
19995057,37,10,44,62,37,190,不合格
19995058,63,94,29,58,79,323,合格
19995059,11,60,79,64,25,239,不合格
19995060,83,4,42,12,36,177,不合格
19995061,91,31,73,71,44,310,合格
19995062,3,53,58,3,21,138,不合格
19995063,31,13,62,70,36,212,不合格
19995064,32,33,28,46,39,178,不合格
19995065,61,30,61,51,62,265,不合格
19995066,30,74,92,4,1,201,不合格
19995067,21,28,18,15,85,167,不合格
19995068,53,50,99,66,92,360,合格
19995069,38,88,13,89,39,267,不合格
19995070,67,0,28,99,83,277,不合格
19995071,38,21,97,36,60,252,不合格
19995072,94,63,59,0,8,224,不合格
19995073,35,60,42,55,26,218,不合格
19995074,28,21,23,63,3,138,不合格
19995075,70,17,28,54,63,232,不合格
19995076,63,63,35,31,10,202,不合格
19995077,3,57,85,28,28,201,不合格
19995078,63,74,63,73,85,358,合格
19995079,15,77,8,62,57,219,不合格
19995080,71,70,98,29,28,296,不合格
19995081,63,87,84,10,96,340,合格
19995082,46,34,95,44,70,289,不合格
19995083,89,31,51,21,56,248,不合格
19995084,73,46,0,24,7,150,不合格
19995085,81,73,61,6,61,282,不合格
19995086,1,19,95,50,12,177,不合格
19995087,85,23,45,78,46,277,不合格
19995088,64,51,55,33,45,248,不合格
19995089,11,7,53,78,86,235,不合格
19995090,40,76,9,70,34,229,不合格
19995091,45,10,57,78,59,249,不合格
19995092,45,27,31,43,13,159,不合格
19995093,45,64,72,0,40,221,不合格
19995094,68,53,19,29,59,228,不合格
19995095,57,73,99,0,27,256,不合格
19995096,19,16,35,82,28,180,不合格
19995097,58,30,35,50,48,221,不合格
19995098,51,4,49,18,44,166,不合格
19995099,20,68,12,43,6,149,不合格
19995100,42,85,9,83,59,278,不合格
19995101,2,70,82,43,96,293,不合格
19995102,89,48,34,16,40,227,不合格
19995103,38,5,29,77,38,187,不合格
19995104,88,88,97,62,78,413,合格
19995105,2,21,65,44,20,152,不合格
19995106,75,44,93,1,52,265,不合格
19995107,51,98,33,73,23,278,不合格
19995108,13,23,19,2,78,135,不合格
19995109,60,80,35,17,79,271,不合格
19995110,7,91,42,87,30,257,不合格
19995111,49,90,3,41,43,226,不合格
19995112,42,9,97,67,88,303,合格
19995113,55,71,59,97,91,373,合格
19995114,20,78,52,54,60,264,不合格
19995115,23,33,72,14,56,198,不合格
19995116,41,95,1,36,54,227,不合格
19995117,88,51,21,39,28,227,不合格
19995118,14,23,87,0,70,194,不合格
19995119,55,67,65,45,41,273,不合格
19995120,99,88,15,60,99,361,合格
19995121,41,74,6,75,35,231,不合格
19995122,1,1,87,52,52,193,不合格
19995123,99,10,68,4,17,198,不合格
19995124,44,11,74,42,28,199,不合格
19995125,38,65,86,78,23,290,不合格
19995126,75,81,67,29,97,349,合格
19995127,32,7,31,94,18,182,不合格
19995128,48,92,31,92,87,350,合格
19995129,3,50,0,18,72,143,不合格
19995130,17,18,43,61,86,225,不合格
19995131,96,38,55,82,69,340,合格
19995132,10,33,50,51,18,162,不合格
19995133,14,96,4,87,79,280,不合格
19995134,52,69,39,53,48,261,不合格
19995135,63,8,65,71,44,251,不合格
19995136,11,86,94,38,95,324,合格
19995137,71,92,30,24,51,268,不合格
19995138,13,0,9,62,80,164,不合格
19995139,3,6,48,99,81,237,不合格
19995140,90,40,16,1,94,241,不合格
19995141,56,58,18,9,69,210,不合格
19995142,99,85,30,36,17,267,不合格
19995143,33,31,13,78,53,208,不合格
19995144,83,4,37,10,72,206,不合格
19995145,51,32,72,64,20,239,不合格
19995146,54,20,2,58,29,163,不合格
19995147,71,40,23,24,98,256,不合格
19995148,60,6,30,79,81,256,不合格
19995149,91,67,46,37,17,258,不合格
19995150,42,72,8,58,38,218,不合格
19995151,6,28,38,31,58,161,不合格
19995152,29,23,52,40,46,190,不合格
19995153,23,55,20,55,87,240,不合格
19995154,42,43,52,83,39,259,不合格
19995155,83,40,11,98,22,254,不合格
19995156,4,20,33,56,94,207,不合格
19995157,56,82,83,89,61,371,合格
19995158,3,61,99,99,83,345,合格
19995159,8,90,71,71,19,259,不合格
19995160,59,61,97,33,17,267,不合格
19995161,98,93,35,5,55,286,不合格
19995162,21,42,57,23,38,181,不合格
19995163,89,57,94,22,22,284,不合格
19995164,91,49,11,7,91,249,不合格
19995165,11,64,98,24,68,265,不合格
19995166,40,59,55,54,66,274,不合格
19995167,49,44,34,46,55,228,不合格
19995168,41,29,19,82,31,202,不合格
19995169,49,68,46,82,50,295,不合格
19995170,86,30,99,40,90,345,合格
19995171,68,85,82,26,46,307,合格
19995172,85,79,4,67,20,255,不合格
19995173,94,48,62,45,68,317,合格
19995174,52,77,98,59,76,362,合格
19995175,17,79,72,8,73,249,不合格
19995176,31,71,67,17,82,268,不合格
19995177,49,1,5,91,14,160,不合格
19995178,61,18,95,69,27,270,不合格
19995179,15,1,81,97,15,209,不合格
19995180,16,3,54,88,29,190,不合格
19995181,19,13,42,37,81,192,不合格
19995182,76,29,88,94,14,301,合格
19995183,23,51,25,36,14,149,不合格
19995184,26,51,84,37,80,278,不合格
19995185,54,60,79,56,42,291,不合格
19995186,50,95,74,80,8,307,合格
19995187,53,41,82,93,26,295,不合格
19995188,17,9,17,79,97,219,不合格
19995189,47,0,8,87,40,182,不合格
19995190,44,38,84,11,92,269,不合格
19995191,57,22,26,4,20,129,不合格
19995192,67,14,64,68,0,213,不合格
19995193,33,91,85,17,39,265,不合格
19995194,2,53,85,39,85,264,不合格
19995195,58,87,61,33,65,304,合格
19995196,44,6,55,54,69,228,不合格
19995197,46,51,40,64,7,208,不合格
19995198,4,0,50,86,64,204,不合格
19995199,61,97,28,8,65,259,不合格
19995200,65,29,88,77,62,321,合格
19995201,66,88,34,86,25,299,不合格
19995202,51,45,83,60,2,241,不合格
19995203,96,84,15,85,55,335,合格
19995204,65,3,24,3,70,165,不合格
19995205,76,10,24,31,61,202,不合格
19995206,36,11,7,38,6,98,不合格
19995207,70,96,34,57,25,282,不合格
19995208,62,90,67,15,17,251,不合格
19995209,75,45,84,98,29,331,合格
19995210,45,86,31,34,18,214,不合格
19995211,5,30,22,76,26,159,不合格
19995212,54,20,88,73,67,302,合格
19995213,93,49,44,92,85,363,合格
19995214,18,18,60,1,19,116,不合格
19995215,23,22,25,81,51,202,不合格
19995216,31,90,0,75,63,259,不合格
19995217,4,6,63,94,56,223,不合格
19995218,87,78,0,73,46,284,不合格
19995219,8,70,52,96,4,230,不合格
19995220,38,76,90,27,4,235,不合格
19995221,67,49,25,81,76,298,不合格
19995222,69,47,56,73,3,248,不合格
19995223,90,63,67,86,19,325,合格
19995224,27,44,5,80,68,224,不合格
19995225,90,78,74,9,15,266,不合格
19995226,15,42,2,86,2,147,不合格
19995227,15,21,42,52,71,201,不合格
19995228,55,44,91,23,14,227,不合格
19995229,41,83,4,69,33,230,不合格
19995230,77,79,21,6,68,251,不合格
19995231,59,18,73,84,25,259,不合格
19995232,23,87,13,79,22,224,不合格
19995233,62,19,49,95,35,260,不合格
19995234,19,53,21,60,36,189,不合格
19995235,77,24,84,47,80,312,合格
19995236,34,62,85,53,32,266,不合格
19995237,75,34,39,13,44,205,不合格
19995238,89,0,22,35,59,205,不合格
19995239,89,87,77,71,50,374,合格
19995240,44,51,38,71,38,242,不合格
19995241,31,71,19,35,13,169,不合格
19995242,69,2,21,27,88,207,不合格
19995243,30,81,7,50,13,181,不合格
19995244,54,23,32,55,96,260,不合格
19995245,15,45,29,12,32,133,不合格
19995246,39,12,69,27,17,164,不合格
19995247,3,55,12,80,80,230,不合格
19995248,82,14,12,68,99,275,不合格
19995249,62,25,52,75,99,313,合格
19995250,93,42,41,84,57,317,合格
19995251,58,89,44,52,60,303,合格
19995252,71,9,2,75,42,199,不合格
19995253,62,88,61,97,82,390,合格
19995254,3,90,51,56,57,257,不合格
19995255,93,74,52,17,37,273,不合格
19995256,26,46,82,89,12,255,不合格
19995257,5,27,51,99,6,188,不合格
19995258,81,52,21,96,81,331,合格
19995259,81,48,14,2,58,203,不合格
19995260,59,5,83,5,1,153,不合格
19995261,27,54,93,22,1,197,不合格
19995262,68,48,86,6,41,249,不合格
19995263,38,84,91,39,18,270,不合格
19995264,20,50,50,96,78,294,不合格
19995265,63,10,36,33,17,159,不合格
19995266,99,53,26,39,34,251,不合格
19995267,41,46,82,72,7,248,不合格
19995268,50,35,67,38,57,247,不合格
19995269,6,14,51,28,44,143,不合格
19995270,66,77,63,27,80,313,合格
19995271,95,25,11,24,64,219,不合格
19995272,40,16,54,58,89,257,不合格
19995273,99,29,49,46,16,239,不合格
19995274,89,66,81,51,9,296,不合格
19995275,17,57,96,94,66,330,合格
19995276,86,45,31,12,2,176,不合格
19995277,70,70,29,63,63,295,不合格
19995278,42,50,29,26,99,246,不合格
19995279,42,10,13,29,63,157,不合格
19995280,61,27,85,24,10,207,不合格
19995281,23,2,36,39,39,139,不合格
19995282,2,47,37,15,38,139,不合格
19995283,65,38,60,22,48,233,不合格
19995284,6,17,35,5,32,95,不合格
19995285,37,10,14,26,93,180,不合格
19995286,20,89,3,17,53,182,不合格
19995287,88,36,57,32,48,261,不合格
19995288,62,31,31,18,1,143,不合格
19995289,11,59,64,39,81,254,不合格
19995290,9,81,67,31,34,222,不合格
19995291,19,78,95,27,96,315,合格
19995292,31,70,85,39,52,277,不合格
19995293,34,8,14,43,59,158,不合格
19995294,67,21,75,74,43,280,不合格
19995295,80,50,59,49,71,309,合格
19995296,86,5,62,62,63,278,不合格
19995297,93,99,39,32,1,264,不合格
19995298,59,84,43,9,91,286,不合格
19995299,79,7,75,89,90,340,合格
19995300,64,56,53,18,38,229,不合格
19995301,64,81,22,30,61,258,不合格
19995302,99,74,63,43,16,295,不合格
19995303,17,38,45,73,93,266,不合格
19995304,9,84,44,40,12,189,不合格
19995305,3,57,87,96,52,295,不合格
19995306,85,29,81,18,65,278,不合格
19995307,73,21,48,35,4,181,不合格
19995308,77,49,12,23,34,195,不合格
19995309,5,3,62,82,3,155,不合格
19995310,93,31,66,54,4,248,不合格
19995311,11,83,9,50,39,192,不合格
19995312,99,35,31,37,20,222,不合格
19995313,74,78,41,81,56,330,合格
19995314,60,56,83,74,54,327,合格
19995315,81,75,44,12,44,256,不合格
19995316,62,60,18,86,72,298,不合格
19995317,89,40,23,36,48,236,不合格
19995318,97,81,36,25,43,282,不合格
19995319,8,40,4,42,22,116,不合格
19995320,99,18,57,77,97,348,合格
19995321,94,86,20,4,56,260,不合格
19995322,82,68,43,30,65,288,不合格
19995323,70,71,5,15,94,255,不合格
19995324,96,26,9,37,61,229,不合格
19995325,24,93,88,40,31,276,不合格
19995326,68,93,93,68,20,342,合格
19995327,59,49,75,36,56,275,不合格
19995328,52,61,66,84,17,280,不合格
19995329,35,29,16,3,6,89,不合格
19995330,59,59,58,90,64,330,合格
19995331,19,83,44,42,95,283,不合格
19995332,67,45,28,54,84,278,不合格
19995333,29,35,34,52,90,240,不合格
19995334,80,70,29,38,4,221,不合格
19995335,57,10,67,67,12,213,不合格
19995336,34,38,10,83,19,184,不合格
19995337,44,91,67,81,7,290,不合格
19995338,68,32,7,90,45,242,不合格
19995339,66,35,41,36,83,261,不合格
19995340,93,68,48,36,15,260,不合格
19995341,70,74,69,23,47,283,不合格
19995342,11,59,81,70,94,315,合格
19995343,6,19,64,12,48,149,不合格
19995344,23,82,33,19,62,219,不合格
19995345,26,76,77,17,50,246,不合格
19995346,70,33,21,85,62,271,不合格
19995347,85,62,0,31,41,219,不合格
19995348,63,64,41,20,71,259,不合格
19995349,42,9,33,65,7,156,不合格
19995350,19,44,74,49,86,272,不合格
19995351,6,40,93,8,96,243,不合格
19995352,22,88,28,34,96,268,不合格
19995353,23,40,11,57,53,184,不合格
19995354,31,76,64,72,50,293,不合格
19995355,62,55,25,61,7,210,不合格
19995356,18,9,46,65,59,197,不合格
19995357,23,15,61,69,23,191,不合格
19995358,69,51,47,58,48,273,不合格
19995359,81,55,58,97,1,292,不合格
19995360,51,43,95,7,50,246,不合格
19995361,28,51,63,16,52,210,不合格
19995362,39,49,89,58,20,255,不合格
19995363,95,79,15,51,55,295,不合格
19995364,43,54,11,54,98,260,不合格
19995365,53,57,13,3,33,159,不合格
19995366,32,20,11,93,62,218,不合格
19995367,91,40,97,6,44,278,不合格
19995368,2,25,49,49,66,191,不合格
19995369,88,46,40,88,28,290,不合格
19995370,92,36,88,52,24,292,不合格
19995371,4,72,81,10,57,224,不合格
19995372,6,20,25,92,17,160,不合格
19995373,88,28,29,46,9,200,不合格
19995374,88,19,6,2,29,144,不合格
19995375,79,86,99,17,74,355,合格
19995376,13,57,67,31,90,258,不合格
19995377,44,77,43,33,62,259,不合格
19995378,13,89,59,90,15,266,不合格
19995379,94,72,29,0,51,246,不合格
19995380,14,27,18,18,2,79,不合格
19995381,6,4,87,62,25,184,不合格
19995382,80,99,57,82,81,399,合格
19995383,98,7,17,39,45,206,不合格
19995384,52,37,99,69,50,307,合格
19995385,3,72,51,61,94,281,不合格
19995386,48,42,10,20,35,155,不合格
19995387,74,31,25,46,14,190,不合格
19995388,17,94,43,57,20,231,不合格
19995389,92,94,24,92,48,350,合格
19995390,19,38,11,76,7,151,不合格
19995391,21,46,61,0,3,131,不合格
19995392,72,29,51,40,74,266,不合格
19995393,69,83,72,80,12,316,合格
19995394,15,75,27,57,4,178,不合格
19995395,13,96,52,49,79,289,不合格
19995396,56,45,12,48,92,253,不合格
19995397,12,55,75,88,5,235,不合格
19995398,61,46,2,3,5,117,不合格
19995399,76,7,27,42,17,169,不合格
19995400,92,75,17,62,31,277,不合格
19995401,69,12,52,41,75,249,不合格
19995402,13,44,38,74,7,176,不合格
19995403,56,26,42,56,63,243,不合格
19995404,92,93,59,88,24,356,合格
19995405,32,54,29,19,14,148,不合格
19995406,30,2,68,55,90,245,不合格
19995407,96,35,89,22,27,269,不合格
19995408,76,94,5,28,20,223,不合格
19995409,7,47,21,70,15,160,不合格
19995410,11,84,70,75,92,332,合格
19995411,44,45,13,85,31,218,不合格
19995412,6,23,68,9,11,117,不合格
19995413,50,51,62,49,59,271,不合格
19995414,21,87,27,3,94,232,不合格
19995415,90,33,43,69,89,324,合格
19995416,62,66,7,49,89,273,不合格
19995417,25,78,73,94,35,305,合格
19995418,21,10,91,5,48,175,不合格
19995419,58,91,59,60,64,332,合格
19995420,65,94,1,31,9,200,不合格
19995421,37,23,77,82,59,278,不合格
19995422,49,27,73,56,56,261,不合格
19995423,72,66,34,24,91,287,不合格
19995424,24,28,6,68,13,139,不合格
19995425,17,28,97,46,56,244,不合格
19995426,52,37,19,10,73,191,不合格
19995427,16,55,99,30,45,245,不合格
19995428,67,46,83,82,43,321,合格
19995429,23,59,7,77,48,214,不合格
19995430,79,65,72,98,73,387,合格
19995431,85,25,50,75,25,260,不合格
19995432,10,39,95,5,51,200,不合格
19995433,73,81,3,47,82,286,不合格
19995434,27,36,39,37,33,172,不合格
19995435,42,24,71,54,22,213,不合格
19995436,30,17,97,13,50,207,不合格
19995437,62,73,7,58,6,206,不合格
19995438,68,15,24,98,23,228,不合格
19995439,49,78,50,83,98,358,合格
19995440,18,43,54,31,30,176,不合格
19995441,77,73,8,59,24,241,不合格
19995442,48,22,95,52,84,301,合格
19995443,72,62,4,42,54,234,不合格
19995444,18,10,53,99,30,210,不合格
19995445,4,38,51,54,36,183,不合格
19995446,32,42,8,35,35,152,不合格
19995447,2,2,37,80,9,130,不合格
19995448,63,74,68,16,51,272,不合格
19995449,34,43,44,43,78,242,不合格
19995450,59,75,56,4,3,197,不合格
19995451,27,23,74,24,89,237,不合格
19995452,58,98,69,62,55,342,合格
19995453,74,57,67,7,99,304,合格
19995454,26,22,97,38,25,208,不合格
19995455,91,73,98,90,18,370,合格
19995456,22,11,90,1,97,221,不合格
19995457,30,67,87,94,9,287,不合格
19995458,4,3,55,91,74,227,不合格
19995459,51,20,85,88,49,293,不合格
19995460,70,33,11,93,69,276,不合格
19995461,10,83,67,25,15,200,不合格
19995462,12,94,23,20,49,198,不合格
19995463,87,14,42,35,99,277,不合格
19995464,16,67,32,90,69,274,不合格
19995465,10,39,62,96,61,268,不合格
19995466,14,93,6,16,46,175,不合格
19995467,71,94,57,51,80,353,合格
19995468,74,94,62,31,84,345,合格
19995469,52,8,97,55,30,242,不合格
19995470,81,80,18,27,78,284,不合格
19995471,8,73,0,16,64,161,不合格
19995472,34,63,89,90,78,354,合格
19995473,82,76,18,78,57,311,合格
19995474,14,29,56,59,83,241,不合格
19995475,73,25,59,37,45,239,不合格
19995476,58,93,8,71,38,268,不合格
19995477,37,14,53,61,94,259,不合格
19995478,67,90,72,80,26,335,合格
19995479,80,13,62,76,50,281,不合格
19995480,76,3,25,24,69,197,不合格
19995481,42,63,27,66,74,272,不合格
19995482,11,3,37,23,88,162,不合格
19995483,45,47,22,35,32,181,不合格
19995484,91,83,71,3,0,248,不合格
19995485,74,4,27,44,56,205,不合格
19995486,0,5,66,99,43,213,不合格
19995487,3,23,54,57,9,146,不合格
19995488,7,24,28,44,55,158,不合格
19995489,83,11,30,77,41,242,不合格
19995490,61,57,0,70,36,224,不合格
19995491,10,68,83,18,1,180,不合格
19995492,59,25,61,41,69,255,不合格
19995493,51,32,78,80,88,329,合格
19995494,92,48,12,39,84,275,不合格
19995495,34,32,72,92,82,312,合格
19995496,39,6,13,86,78,222,不合格
19995497,52,12,8,79,77,228,不合格
19995498,60,94,33,94,61,342,合格
19995499,48,70,42,74,40,274,不合格
19995500,81,29,35,76,10,231,不合格
