ID,国語,数学,英語,理科,社会,合計,判定
20020001,68,42,44,76,69,299,不合格
20020002,94,87,56,91,86,414,合格
20020003,47,38,88,26,65,264,不合格
20020004,34,35,1,71,41,182,不合格
20020005,9,26,4,28,93,160,不合格
20020006,74,68,12,57,20,231,不合格
20020007,87,16,97,6,98,304,合格
20020008,47,78,72,1,9,207,不合格
20020009,64,58,63,24,10,219,不合格
20020010,80,64,58,14,92,308,合格
20020011,54,35,52,41,92,274,不合格
20020012,89,65,64,6,17,241,不合格
20020013,81,22,54,7,93,257,不合格
20020014,82,46,87,66,53,334,合格
20020015,91,86,36,37,30,280,不合格
20020016,96,85,99,85,21,386,合格
20020017,46,35,75,93,82,331,合格
20020018,14,31,8,5,99,157,不合格
20020019,81,98,50,56,10,295,不合格
20020020,23,3,69,43,52,190,不合格
20020021,75,77,36,76,55,319,合格
20020022,12,60,40,69,79,260,不合格
20020023,9,94,24,98,49,274,不合格
20020024,74,24,79,21,98,296,不合格
20020025,42,65,12,94,98,311,合格
20020026,25,18,75,17,85,220,不合格
20020027,36,80,91,4,58,269,不合格
20020028,46,81,68,91,80,366,合格
20020029,31,49,59,18,56,213,不合格
20020030,28,36,2,8,41,115,不合格
20020031,65,34,75,69,72,315,合格
20020032,60,98,30,33,14,235,不合格
20020033,7,50,28,61,42,188,不合格
20020034,34,71,90,68,46,309,合格
20020035,46,44,5,30,61,186,不合格
20020036,68,60,9,4,72,213,不合格
20020037,78,82,42,7,36,245,不合格
20020038,43,23,74,93,93,326,合格
20020039,63,56,58,78,5,260,不合格
20020040,56,88,87,84,67,382,合格
20020041,40,95,84,85,51,355,合格
20020042,16,62,95,95,99,367,合格
20020043,8,49,62,54,99,272,不合格
20020044,38,8,54,85,66,251,不合格
20020045,58,54,11,63,19,205,不合格
20020046,97,49,77,43,42,308,合格
20020047,31,7,36,66,88,228,不合格
20020048,9,67,39,87,68,270,不合格
20020049,93,55,82,99,0,329,合格
20020050,9,40,99,91,16,255,不合格
20020051,76,45,83,29,78,311,合格
20020052,11,90,6,55,80,242,不合格
20020053,46,61,61,11,28,207,不合格
20020054,17,88,14,52,50,221,不合格
20020055,35,16,10,37,87,185,不合格
20020056,22,61,33,68,84,268,不合格
20020057,66,18,17,68,26,195,不合格
20020058,96,46,69,59,86,356,合格
20020059,12,86,84,68,14,264,不合格
20020060,52,6,7,34,17,116,不合格
20020061,21,34,35,4,74,168,不合格
20020062,20,30,96,18,13,177,不合格
20020063,12,53,33,85,22,205,不合格
20020064,19,14,66,97,90,286,不合格
20020065,24,69,34,22,1,150,不合格
20020066,10,48,29,88,82,257,不合格
20020067,68,38,80,20,41,247,不合格
20020068,1,38,3,64,29,135,不合格
20020069,65,16,78,88,30,277,不合格
20020070,68,82,21,60,2,233,不合格
20020071,70,26,35,79,38,248,不合格
20020072,36,68,11,24,79,218,不合格
20020073,43,70,49,56,22,240,不合格
20020074,37,88,57,0,16,198,不合格
20020075,2,32,61,17,4,116,不合格
20020076,62,24,52,91,1,230,不合格
20020077,31,54,64,53,31,233,不合格
20020078,25,30,25,64,91,235,不合格
20020079,27,74,88,72,81,342,合格
20020080,37,10,97,36,88,268,不合格
20020081,30,95,84,63,74,346,合格
20020082,11,20,78,48,98,255,不合格
20020083,25,30,25,22,61,163,不合格
20020084,12,28,44,0,98,182,不合格
20020085,23,47,90,93,96,349,合格
20020086,67,80,29,42,15,233,不合格
20020087,44,87,51,23,24,229,不合格
20020088,76,19,80,23,29,227,不合格
20020089,87,30,23,82,92,314,合格
20020090,20,69,43,39,83,254,不合格
20020091,34,10,48,75,34,201,不合格
20020092,95,20,49,31,11,206,不合格
20020093,69,73,45,47,92,326,合格
20020094,60,28,10,96,53,247,不合格
20020095,96,21,51,61,12,241,不合格
20020096,54,54,76,23,79,286,不合格
20020097,79,36,59,68,26,268,不合格
20020098,33,64,24,39,59,219,不合格
20020099,49,68,91,61,96,365,合格
20020100,97,39,58,24,89,307,合格
20020101,51,88,4,61,59,263,不合格
20020102,68,48,78,23,78,295,不合格
20020103,43,35,83,12,64,237,不合格
20020104,95,73,55,9,50,282,不合格
20020105,42,12,16,84,83,237,不合格
20020106,49,8,26,16,89,188,不合格
20020107,67,87,95,89,46,384,合格
20020108,26,23,97,95,31,272,不合格
20020109,83,36,62,74,48,303,合格
20020110,88,58,30,83,79,338,合格
20020111,78,75,56,33,2,244,不合格
20020112,74,87,54,82,84,381,合格
20020113,23,40,71,15,51,200,不合格
20020114,85,85,32,1,59,262,不合格
20020115,89,22,22,87,73,293,不合格
20020116,11,47,77,19,15,169,不合格
20020117,77,97,92,35,10,311,合格
20020118,21,48,92,33,88,282,不合格
20020119,26,36,2,58,63,185,不合格
20020120,47,72,62,86,21,288,不合格
20020121,19,66,18,60,73,236,不合格
20020122,17,43,90,42,92,284,不合格
20020123,55,26,8,32,9,130,不合格
20020124,33,4,0,15,48,100,不合格
20020125,95,56,44,66,51,312,合格
20020126,71,96,9,56,62,294,不合格
20020127,93,93,68,16,12,282,不合格
20020128,97,7,83,29,63,279,不合格
20020129,98,25,37,70,64,294,不合格
20020130,61,76,31,5,52,225,不合格
20020131,37,86,0,80,16,219,不合格
20020132,97,51,54,87,45,334,合格
20020133,60,50,63,87,7,267,不合格
20020134,2,14,54,12,7,89,不合格
20020135,64,93,30,14,6,207,不合格
20020136,79,6,36,69,60,250,不合格
20020137,95,70,86,20,14,285,不合格
20020138,40,23,23,85,99,270,不合格
20020139,58,82,59,89,36,324,合格
20020140,39,85,27,93,76,320,合格
20020141,80,87,33,74,23,297,不合格
20020142,29,28,32,5,61,155,不合格
20020143,58,93,97,8,63,319,合格
20020144,14,54,10,59,5,142,不合格
20020145,53,13,15,55,53,189,不合格
20020146,86,1,42,8,24,161,不合格
20020147,83,70,69,2,3,227,不合格
20020148,88,68,27,28,17,228,不合格
20020149,91,59,49,20,18,237,不合格
20020150,29,16,14,80,19,158,不合格
20020151,4,61,1,77,22,165,不合格
20020152,19,57,24,82,6,188,不合格
20020153,83,39,5,81,74,282,不合格
20020154,24,10,13,37,93,177,不合格
20020155,46,6,95,76,28,251,不合格
20020156,69,9,62,70,67,277,不合格
20020157,22,36,35,87,48,228,不合格
20020158,68,78,33,4,49,232,不合格
20020159,15,42,93,61,44,255,不合格
20020160,74,9,42,35,6,166,不合格
20020161,21,98,40,48,71,278,不合格
20020162,11,52,79,56,65,263,不合格
20020163,23,7,52,67,10,159,不合格
20020164,16,34,92,83,82,307,合格
20020165,12,36,69,10,62,189,不合格
20020166,54,4,5,60,20,143,不合格
20020167,37,88,65,86,44,320,合格
20020168,21,79,36,28,32,196,不合格
20020169,22,46,9,77,67,221,不合格
20020170,94,76,42,52,65,329,合格
20020171,80,13,60,67,70,290,不合格
20020172,10,59,54,1,78,202,不合格
20020173,3,46,96,65,73,283,不合格
20020174,22,25,90,18,90,245,不合格
20020175,31,11,8,11,50,111,不合格
20020176,91,12,68,3,14,188,不合格
20020177,33,55,54,54,95,291,不合格
20020178,37,19,11,86,62,215,不合格
20020179,66,17,49,51,20,203,不合格
20020180,85,82,25,61,23,276,不合格
20020181,23,86,32,40,6,187,不合格
20020182,23,61,79,12,25,200,不合格
20020183,88,50,19,42,4,203,不合格
20020184,2,47,23,88,67,227,不合格
20020185,8,15,49,57,92,221,不合格
20020186,74,3,90,77,62,306,合格
20020187,51,17,8,21,3,100,不合格
20020188,37,65,12,47,80,241,不合格
20020189,54,62,26,91,80,313,合格
20020190,84,82,35,23,93,317,合格
20020191,34,5,7,24,92,162,不合格
20020192,65,48,2,62,54,231,不合格
20020193,17,57,88,56,40,258,不合格
20020194,74,27,63,44,90,298,不合格
20020195,8,51,72,49,79,259,不合格
20020196,48,80,53,85,87,353,合格
20020197,57,68,19,65,28,237,不合格
20020198,22,66,7,83,47,225,不合格
20020199,29,77,50,83,98,337,合格
20020200,5,48,39,69,57,218,不合格
20020201,21,85,54,94,55,309,合格
20020202,96,61,70,56,71,354,合格
20020203,8,43,42,93,40,226,不合格
20020204,92,80,33,69,21,295,不合格
20020205,7,34,84,75,17,217,不合格
20020206,21,74,11,91,1,198,不合格
20020207,22,88,68,32,26,236,不合格
20020208,66,2,55,89,41,253,不合格
20020209,30,44,17,69,70,230,不合格
20020210,77,47,55,86,55,320,合格
20020211,67,2,42,45,27,183,不合格
20020212,30,73,91,16,81,291,不合格
20020213,93,14,3,83,99,292,不合格
20020214,94,49,25,52,44,264,不合格
20020215,26,92,82,41,28,269,不合格
20020216,91,0,95,40,16,242,不合格
20020217,34,35,18,65,77,229,不合格
20020218,87,3,93,0,9,192,不合格
20020219,11,1,4,29,72,117,不合格
20020220,32,33,86,11,18,180,不合格
20020221,37,32,67,29,70,235,不合格
20020222,37,83,93,49,76,338,合格
20020223,94,14,11,85,68,272,不合格
20020224,28,16,26,5,4,79,不合格
20020225,21,20,62,44,21,168,不合格
20020226,5,23,74,66,15,183,不合格
20020227,90,61,85,3,67,306,合格
20020228,76,49,20,56,50,251,不合格
20020229,74,51,36,25,2,188,不合格
20020230,50,45,51,81,47,274,不合格
20020231,22,99,32,0,23,176,不合格
20020232,71,16,51,82,91,311,合格
20020233,81,77,29,35,86,308,合格
20020234,46,37,55,73,51,262,不合格
20020235,76,19,34,65,16,210,不合格
20020236,4,98,75,29,8,214,不合格
20020237,61,54,38,94,69,316,合格
20020238,98,92,8,20,59,277,不合格
20020239,32,70,45,1,58,206,不合格
20020240,2,1,19,43,23,88,不合格
20020241,22,4,42,86,80,234,不合格
20020242,45,20,99,78,83,325,合格
20020243,59,18,47,39,59,222,不合格
20020244,18,64,30,35,25,172,不合格
20020245,63,62,2,80,89,296,不合格
20020246,1,67,1,47,91,207,不合格
20020247,96,72,45,14,68,295,不合格
20020248,0,56,70,80,93,299,不合格
20020249,6,85,72,77,85,325,合格
20020250,70,79,83,23,16,271,不合格
20020251,66,49,15,14,74,218,不合格
20020252,3,30,90,26,39,188,不合格
20020253,11,53,56,96,72,288,不合格
20020254,65,44,86,99,10,304,合格
20020255,53,57,35,80,17,242,不合格
20020256,90,75,49,95,47,356,合格
20020257,78,98,66,49,92,383,合格
20020258,48,26,24,60,8,166,不合格
20020259,24,19,4,33,66,146,不合格
20020260,28,50,38,24,99,239,不合格
20020261,65,72,62,25,85,309,合格
20020262,21,66,84,89,15,275,不合格
20020263,20,23,13,75,60,191,不合格
20020264,14,28,69,1,28,140,不合格
20020265,35,40,91,96,97,359,合格
20020266,76,94,70,8,29,277,不合格
20020267,64,40,88,34,21,247,不合格
20020268,46,89,66,33,61,295,不合格
20020269,57,97,89,75,9,327,合格
20020270,83,78,15,9,91,276,不合格
20020271,56,73,3,73,3,208,不合格
20020272,51,86,13,28,71,249,不合格
20020273,30,15,86,51,15,197,不合格
20020274,52,74,41,21,82,270,不合格
20020275,80,6,67,87,99,339,合格
20020276,72,71,43,98,78,362,合格
20020277,80,46,30,13,8,177,不合格
20020278,46,81,78,1,62,268,不合格
20020279,33,89,11,31,13,177,不合格
20020280,69,35,86,40,60,290,不合格
20020281,45,57,36,89,92,319,合格
20020282,42,45,85,15,65,252,不合格
20020283,66,15,62,34,2,179,不合格
20020284,18,64,77,45,73,277,不合格
20020285,4,51,19,17,63,154,不合格
20020286,7,87,54,86,21,255,不合格
20020287,4,80,66,20,31,201,不合格
20020288,84,58,42,93,93,370,合格
20020289,44,70,98,85,2,299,不合格
20020290,17,96,0,64,62,239,不合格
20020291,85,89,31,14,21,240,不合格
20020292,21,47,63,49,75,255,不合格
20020293,34,1,50,73,81,239,不合格
20020294,25,46,31,10,81,193,不合格
20020295,7,50,8,26,28,119,不合格
20020296,11,4,29,20,70,134,不合格
20020297,42,61,36,92,77,308,合格
20020298,11,0,73,10,1,95,不合格
20020299,42,77,61,87,70,337,合格
20020300,39,9,64,99,74,285,不合格
20020301,34,61,5,60,54,214,不合格
20020302,92,49,4,87,31,263,不合格
20020303,35,69,39,23,39,205,不合格
20020304,23,97,25,24,77,246,不合格
20020305,59,88,68,59,40,314,合格
20020306,0,42,57,93,87,279,不合格
20020307,24,70,15,69,28,206,不合格
20020308,51,8,57,32,56,204,不合格
20020309,47,32,58,53,32,222,不合格
20020310,80,14,61,85,51,291,不合格
20020311,66,0,22,2,26,116,不合格
20020312,17,99,81,60,33,290,不合格
20020313,21,69,99,16,22,227,不合格
20020314,4,15,48,36,21,124,不合格
20020315,7,69,48,22,18,164,不合格
20020316,86,14,58,32,72,262,不合格
20020317,22,40,56,85,10,213,不合格
20020318,67,47,99,90,14,317,合格
20020319,68,91,99,57,11,326,合格
20020320,9,80,25,57,63,234,不合格
20020321,71,25,3,26,74,199,不合格
20020322,7,86,9,85,92,279,不合格
20020323,43,49,49,56,56,253,不合格
20020324,33,75,49,17,73,247,不合格
20020325,24,62,53,42,95,276,不合格
20020326,48,60,84,41,57,290,不合格
20020327,17,19,78,71,97,282,不合格
20020328,31,13,58,76,29,207,不合格
20020329,92,45,87,92,53,369,合格
20020330,66,37,43,18,36,200,不合格
20020331,23,5,15,54,71,168,不合格
20020332,77,94,63,43,67,344,合格
20020333,70,99,93,99,16,377,合格
20020334,16,57,35,86,31,225,不合格
20020335,10,16,7,29,13,75,不合格
20020336,87,64,79,59,71,360,合格
20020337,22,42,71,32,50,217,不合格
20020338,52,22,39,52,58,223,不合格
20020339,66,54,64,47,38,269,不合格
20020340,4,77,56,73,19,229,不合格
20020341,14,86,14,60,44,218,不合格
20020342,34,56,93,41,39,263,不合格
20020343,31,40,27,76,7,181,不合格
20020344,45,1,22,68,98,234,不合格
20020345,19,77,83,99,69,347,合格
20020346,48,26,77,3,11,165,不合格
20020347,11,86,31,4,66,198,不合格
20020348,41,6,55,73,86,261,不合格
20020349,50,0,94,51,32,227,不合格
20020350,22,2,43,89,92,248,不合格
20020351,79,43,29,53,57,261,不合格
20020352,95,10,0,2,52,159,不合格
20020353,17,14,22,57,98,208,不合格
20020354,67,42,71,78,35,293,不合格
20020355,92,82,81,3,17,275,不合格
20020356,27,62,79,2,38,208,不合格
20020357,36,41,32,35,47,191,不合格
20020358,26,8,58,77,31,200,不合格
20020359,62,20,91,61,28,262,不合格
20020360,0,56,21,52,20,149,不合格
20020361,69,13,79,28,80,269,不合格
20020362,25,69,46,55,61,256,不合格
20020363,7,54,7,34,2,104,不合格
20020364,9,28,57,92,29,215,不合格
20020365,88,38,24,23,2,175,不合格
20020366,26,26,80,93,68,293,不合格
20020367,24,30,71,77,78,280,不合格
20020368,10,19,5,26,0,60,不合格
20020369,51,12,80,81,87,311,合格
20020370,54,77,79,99,22,331,合格
20020371,68,29,33,81,72,283,不合格
20020372,23,77,92,23,11,226,不合格
20020373,52,19,57,52,11,191,不合格
20020374,38,81,8,23,78,228,不合格
20020375,64,29,79,40,10,222,不合格
20020376,38,91,4,76,13,222,不合格
20020377,7,9,73,26,49,164,不合格
20020378,78,65,93,88,85,409,合格
20020379,51,65,45,59,47,267,不合格
20020380,23,16,52,21,48,160,不合格
20020381,88,92,21,52,40,293,不合格
20020382,36,39,60,68,81,284,不合格
20020383,77,30,88,62,59,316,合格
20020384,42,84,38,71,73,308,合格
20020385,5,33,65,56,9,168,不合格
20020386,35,68,91,90,99,383,合格
20020387,52,89,29,9,77,256,不合格
20020388,86,45,54,19,25,229,不合格
20020389,32,15,7,44,65,163,不合格
20020390,38,38,59,62,87,284,不合格
20020391,58,15,77,72,2,224,不合格
20020392,54,23,4,29,4,114,不合格
20020393,19,75,96,23,99,312,合格
20020394,57,40,59,41,35,232,不合格
20020395,75,85,64,41,87,352,合格
20020396,58,22,20,8,67,175,不合格
20020397,91,58,43,43,44,279,不合格
20020398,13,1,11,1,74,100,不合格
20020399,60,48,8,26,77,219,不合格
20020400,10,28,23,26,50,137,不合格
20020401,86,56,96,63,5,306,合格
20020402,65,76,81,60,51,333,合格
20020403,17,75,83,2,17,194,不合格
20020404,82,87,23,33,89,314,合格
20020405,35,40,20,9,63,167,不合格
20020406,18,61,49,9,54,191,不合格
20020407,42,97,47,65,32,283,不合格
20020408,56,25,51,25,5,162,不合格
20020409,17,39,94,73,4,227,不合格
20020410,5,98,98,71,16,288,不合格
20020411,23,60,62,85,21,251,不合格
20020412,26,20,71,20,56,193,不合格
20020413,84,85,6,26,59,260,不合格
20020414,6,95,99,54,30,284,不合格
20020415,5,19,69,68,0,161,不合格
20020416,44,41,11,95,66,257,不合格
20020417,65,19,36,33,9,162,不合格
20020418,95,7,82,10,89,283,不合格
20020419,85,10,57,2,59,213,不合格
20020420,43,49,99,71,78,340,合格
20020421,20,63,81,67,80,311,合格
20020422,16,10,31,79,34,170,不合格
20020423,68,17,72,71,23,251,不合格
20020424,77,54,27,94,72,324,合格
20020425,5,47,57,36,55,200,不合格
20020426,43,65,56,78,76,318,合格
20020427,21,8,66,6,91,192,不合格
20020428,13,67,92,91,33,296,不合格
20020429,99,25,93,33,4,254,不合格
20020430,51,63,96,31,58,299,不合格
20020431,83,0,45,20,25,173,不合格
20020432,59,64,38,96,19,276,不合格
20020433,85,23,98,67,48,321,合格
20020434,39,61,99,31,30,260,不合格
20020435,13,89,46,87,49,284,不合格
20020436,17,43,69,20,61,210,不合格
20020437,54,66,84,70,52,326,合格
20020438,14,34,81,56,66,251,不合格
20020439,26,19,35,7,52,139,不合格
20020440,86,87,30,81,16,300,合格
20020441,98,81,10,19,62,270,不合格
20020442,34,48,89,30,71,272,不合格
20020443,63,41,91,64,37,296,不合格
20020444,11,80,49,26,72,238,不合格
20020445,97,17,14,66,76,270,不合格
20020446,30,71,89,4,30,224,不合格
20020447,58,93,85,79,64,379,合格
20020448,9,83,1,47,24,164,不合格
20020449,3,44,52,17,42,158,不合格
20020450,55,60,37,96,78,326,合格
20020451,10,71,85,85,56,307,合格
20020452,35,43,54,30,5,167,不合格
20020453,8,6,30,57,82,183,不合格
20020454,23,9,57,65,84,238,不合格
20020455,88,54,31,51,21,245,不合格
20020456,29,74,26,39,1,169,不合格
20020457,80,11,47,82,3,223,不合格
20020458,31,62,34,70,86,283,不合格
20020459,25,1,55,52,26,159,不合格
20020460,29,93,43,57,35,257,不合格
20020461,62,97,2,69,8,238,不合格
20020462,19,52,58,44,41,214,不合格
20020463,16,90,16,92,92,306,合格
20020464,93,85,44,78,21,321,合格
20020465,77,84,2,86,23,272,不合格
20020466,41,30,94,1,81,247,不合格
20020467,26,36,42,18,55,177,不合格
20020468,23,72,9,96,35,235,不合格
20020469,29,70,16,5,44,164,不合格
20020470,24,36,18,70,5,153,不合格
20020471,89,23,73,14,94,293,不合格
20020472,43,91,43,66,6,249,不合格
20020473,42,28,48,30,47,195,不合格
20020474,29,29,74,34,64,230,不合格
20020475,11,24,32,93,89,249,不合格
20020476,83,97,81,39,70,370,合格
20020477,54,63,10,52,48,227,不合格
20020478,28,46,82,46,15,217,不合格
20020479,32,97,41,82,98,350,合格
20020480,13,10,33,46,28,130,不合格
20020481,11,84,61,95,55,306,合格
20020482,10,96,17,36,66,225,不合格
20020483,40,11,80,45,4,180,不合格
20020484,45,54,0,92,6,197,不合格
20020485,69,23,92,26,30,240,不合格
20020486,48,99,4,41,10,202,不合格
20020487,19,82,90,59,82,332,合格
20020488,75,34,32,77,80,298,不合格
20020489,68,42,73,81,64,328,合格
20020490,75,99,34,93,60,361,合格
20020491,58,1,71,29,27,186,不合格
20020492,19,90,64,14,41,228,不合格
20020493,66,14,78,47,81,286,不合格
20020494,61,61,99,3,70,294,不合格
20020495,94,18,82,65,39,298,不合格
20020496,90,28,86,40,64,308,合格
20020497,57,28,77,19,90,271,不合格
20020498,24,10,35,1,18,88,不合格
20020499,87,80,58,17,28,270,不合格
20020500,75,0,77,33,65,250,不合格
20020501,72,27,85,38,94,316,合格
20020502,38,68,18,41,85,250,不合格
20020503,52,91,32,74,6,255,不合格
20020504,17,29,96,30,13,185,不合格
20020505,96,67,63,47,80,353,合格
20020506,30,60,26,15,43,174,不合格
20020507,98,81,11,80,46,316,合格
20020508,51,50,94,37,71,303,合格
20020509,47,76,67,99,80,369,合格
20020510,15,33,20,54,76,198,不合格
20020511,46,14,78,16,23,177,不合格
20020512,89,32,25,47,84,277,不合格
20020513,16,3,23,45,67,154,不合格
20020514,77,62,73,12,69,293,不合格
20020515,49,74,74,7,60,264,不合格
20020516,43,67,3,0,88,201,不合格
20020517,2,24,68,70,71,235,不合格
20020518,94,41,34,5,21,195,不合格
20020519,65,80,16,24,30,215,不合格
20020520,87,72,79,80,93,411,合格
20020521,17,55,38,3,76,189,不合格
20020522,75,25,68,13,37,218,不合格
20020523,57,89,22,28,7,203,不合格
20020524,57,97,86,31,47,318,合格
20020525,85,90,56,85,16,332,合格
20020526,5,49,47,18,16,135,不合格
20020527,88,85,51,99,87,410,合格
20020528,69,2,84,90,80,325,合格
20020529,81,42,74,14,76,287,不合格
20020530,79,51,20,77,28,255,不合格
20020531,33,18,50,42,98,241,不合格
20020532,35,43,47,12,47,184,不合格
20020533,6,34,60,80,86,266,不合格
20020534,85,52,74,78,28,317,合格
20020535,15,33,73,29,96,246,不合格
20020536,58,35,9,0,93,195,不合格
20020537,58,75,28,94,7,262,不合格
20020538,84,19,48,90,18,259,不合格
20020539,15,21,42,15,67,160,不合格
20020540,45,99,2,65,34,245,不合格
20020541,57,19,75,30,72,253,不合格
20020542,38,51,3,13,97,202,不合格
20020543,21,30,19,14,55,139,不合格
20020544,15,87,45,36,65,248,不合格
20020545,23,5,59,31,22,140,不合格
20020546,44,3,4,16,67,134,不合格
20020547,26,25,39,76,47,213,不合格
20020548,71,62,89,51,69,342,合格
20020549,43,59,3,30,2,137,不合格
20020550,50,23,37,52,99,261,不合格
20020551,84,14,17,68,69,252,不合格
20020552,37,46,57,35,10,185,不合格
20020553,89,80,54,70,95,388,合格
20020554,58,15,46,99,51,269,不合格
20020555,62,88,98,78,42,368,合格
20020556,61,55,53,30,3,202,不合格
20020557,31,14,7,24,65,141,不合格
20020558,31,29,46,85,31,222,不合格
20020559,68,75,23,64,58,288,不合格
20020560,29,16,73,76,81,275,不合格
20020561,56,6,44,76,35,217,不合格
20020562,95,81,21,48,12,257,不合格
20020563,51,46,91,13,51,252,不合格
20020564,19,18,55,23,62,177,不合格
20020565,22,49,32,77,89,269,不合格
20020566,57,69,95,52,96,369,合格
20020567,21,88,41,97,98,345,合格
20020568,0,1,15,30,47,93,不合格
20020569,95,63,45,67,36,306,合格
20020570,53,66,90,82,43,334,合格
20020571,24,36,98,53,91,302,合格
20020572,97,24,46,13,29,209,不合格
20020573,36,64,42,12,68,222,不合格
20020574,87,66,97,24,21,295,不合格
20020575,47,75,62,99,66,349,合格
20020576,20,32,54,95,21,222,不合格
20020577,17,55,24,58,23,177,不合格
20020578,58,23,92,42,47,262,不合格
20020579,24,28,46,15,11,124,不合格
20020580,15,64,92,38,60,269,不合格
20020581,55,11,63,13,16,158,不合格
20020582,98,16,28,10,5,157,不合格
20020583,29,65,31,72,32,229,不合格
20020584,81,60,4,86,34,265,不合格
20020585,53,50,98,95,95,391,合格
20020586,18,78,53,16,7,172,不合格
20020587,80,26,95,33,88,322,合格
20020588,87,62,24,17,19,209,不合格
20020589,85,66,59,32,98,340,合格
20020590,91,40,21,81,83,316,合格
20020591,1,34,1,97,26,159,不合格
20020592,91,43,25,85,60,304,合格
20020593,71,77,81,30,99,358,合格
20020594,83,46,95,49,20,293,不合格
20020595,88,32,47,20,3,190,不合格
20020596,23,25,0,10,30,88,不合格
20020597,39,31,74,31,83,258,不合格
20020598,39,43,72,74,33,261,不合格
20020599,29,84,22,72,13,220,不合格
20020600,1,36,94,89,55,275,不合格
20020601,26,71,86,31,97,311,合格
20020602,67,39,80,28,37,251,不合格
20020603,79,16,33,2,74,204,不合格
20020604,83,38,11,49,48,229,不合格
20020605,3,68,40,63,46,220,不合格
20020606,23,69,13,85,38,228,不合格
20020607,36,31,92,76,78,313,合格
20020608,95,39,62,28,48,272,不合格
20020609,5,72,83,0,35,195,不合格
20020610,27,55,88,34,85,289,不合格
20020611,42,49,44,38,72,245,不合格
20020612,57,17,41,20,71,206,不合格
20020613,92,16,32,96,2,238,不合格
20020614,18,14,51,36,99,218,不合格
20020615,99,7,39,42,73,260,不合格
20020616,67,92,65,17,65,306,合格
20020617,27,38,92,12,64,233,不合格
20020618,65,96,41,97,0,299,不合格
20020619,13,5,16,9,48,91,不合格
20020620,90,40,24,97,23,274,不合格
20020621,54,54,32,22,4,166,不合格
20020622,93,34,13,93,89,322,合格
20020623,69,56,83,6,67,281,不合格
20020624,92,30,22,32,61,237,不合格
20020625,25,24,93,96,98,336,合格
20020626,2,2,80,44,55,183,不合格
20020627,5,11,93,87,78,274,不合格
20020628,71,2,99,93,48,313,合格
20020629,28,13,71,14,61,187,不合格
20020630,31,70,79,44,17,241,不合格
20020631,68,57,48,19,75,267,不合格
20020632,69,58,22,36,82,267,不合格
20020633,52,21,88,37,40,238,不合格
20020634,70,62,96,92,36,356,合格
20020635,77,86,1,98,81,343,合格
20020636,33,24,10,20,75,162,不合格
20020637,98,77,70,28,16,289,不合格
20020638,36,91,16,68,81,292,不合格
20020639,49,18,28,44,47,186,不合格
20020640,54,18,92,29,80,273,不合格
20020641,41,28,1,81,26,177,不合格
20020642,46,19,51,50,94,260,不合格
20020643,99,99,19,32,25,274,不合格
20020644,87,58,53,20,79,297,不合格
20020645,3,71,10,1,34,119,不合格
20020646,34,68,58,34,42,236,不合格
20020647,25,34,58,15,56,188,不合格
20020648,79,26,49,72,99,325,合格
20020649,61,31,41,11,36,180,不合格
20020650,0,48,75,57,93,273,不合格
20020651,33,0,72,93,10,208,不合格
20020652,71,97,21,15,12,216,不合格
20020653,57,5,50,71,70,253,不合格
20020654,24,79,55,70,65,293,不合格
20020655,25,94,42,78,10,249,不合格
20020656,0,21,50,37,15,123,不合格
20020657,94,41,68,51,89,343,合格
20020658,26,23,7,84,21,161,不合格
20020659,34,78,61,8,0,181,不合格
20020660,75,58,13,28,21,195,不合格
20020661,94,5,28,64,18,209,不合格
20020662,82,22,98,14,17,233,不合格
20020663,36,44,59,99,71,309,合格
20020664,97,81,51,92,31,352,合格
20020665,89,30,52,20,72,263,不合格
20020666,25,26,26,61,91,229,不合格
20020667,46,25,2,91,43,207,不合格
20020668,10,11,35,28,62,146,不合格
20020669,89,64,53,92,30,328,合格
20020670,3,66,9,15,80,173,不合格
20020671,93,72,41,62,8,276,不合格
20020672,23,79,81,39,55,277,不合格
20020673,34,36,89,49,13,221,不合格
20020674,71,49,14,8,53,195,不合格
20020675,18,18,65,51,57,209,不合格
20020676,77,42,48,2,29,198,不合格
20020677,97,61,29,9,84,280,不合格
20020678,24,28,25,26,26,129,不合格
20020679,67,29,39,3,62,200,不合格
20020680,66,43,36,66,53,264,不合格
20020681,97,84,2,84,11,278,不合格
20020682,90,55,1,98,29,273,不合格
20020683,66,50,97,25,23,261,不合格
20020684,76,72,87,72,89,396,合格
20020685,45,30,28,21,1,125,不合格
20020686,45,19,5,6,43,118,不合格
20020687,11,79,82,45,4,221,不合格
20020688,65,52,38,96,4,255,不合格
20020689,16,22,18,37,89,182,不合格
20020690,80,1,57,82,13,233,不合格
20020691,69,84,76,31,16,276,不合格
20020692,73,5,37,1,6,122,不合格
20020693,32,81,31,96,85,325,合格
20020694,61,54,39,25,18,197,不合格
20020695,0,20,21,98,69,208,不合格
20020696,45,96,0,51,62,254,不合格
20020697,48,98,85,2,19,252,不合格
20020698,72,45,29,16,65,227,不合格
20020699,45,67,8,19,32,171,不合格
20020700,99,97,26,97,70,389,合格
20020701,18,99,10,42,50,219,不合格
20020702,69,31,74,85,84,343,合格
20020703,21,33,46,18,1,119,不合格
20020704,6,58,75,67,63,269,不合格
20020705,87,65,32,25,82,291,不合格
20020706,18,34,88,49,21,210,不合格
20020707,49,76,53,66,98,342,合格
20020708,24,57,49,66,50,246,不合格
20020709,86,37,16,1,24,164,不合格
20020710,76,23,28,79,50,256,不合格
20020711,41,0,68,65,76,250,不合格
20020712,11,18,14,49,74,166,不合格
20020713,27,30,31,38,70,196,不合格
20020714,89,7,49,32,75,252,不合格
20020715,81,87,35,75,4,282,不合格
20020716,18,3,15,35,52,123,不合格
20020717,79,39,97,39,54,308,合格
20020718,7,46,67,56,92,268,不合格
20020719,36,65,48,56,52,257,不合格
20020720,26,51,54,16,31,178,不合格
20020721,16,44,75,52,1,188,不合格
20020722,69,79,16,20,82,266,不合格
20020723,10,68,51,22,47,198,不合格
20020724,97,18,68,99,65,347,合格
20020725,93,16,83,13,18,223,不合格
20020726,37,75,98,51,19,280,不合格
20020727,76,25,56,45,90,292,不合格
20020728,5,44,76,67,44,236,不合格
20020729,30,56,82,75,29,272,不合格
20020730,86,23,76,84,90,359,合格
20020731,87,23,81,24,98,313,合格
20020732,95,49,29,93,62,328,合格
20020733,35,55,50,60,32,232,不合格
20020734,33,56,84,32,82,287,不合格
20020735,4,19,36,50,46,155,不合格
20020736,58,16,45,5,0,124,不合格
20020737,75,21,75,35,79,285,不合格
20020738,56,73,80,83,39,331,合格
20020739,19,78,91,16,13,217,不合格
20020740,78,64,10,2,33,187,不合格
20020741,8,29,28,5,16,86,不合格
20020742,98,5,97,45,99,344,合格
20020743,2,32,2,66,97,199,不合格
20020744,29,27,67,0,38,161,不合格
20020745,16,46,82,78,93,315,合格
20020746,78,88,51,42,22,281,不合格
20020747,79,12,35,31,15,172,不合格
20020748,50,75,16,42,86,269,不合格
20020749,92,73,98,8,37,308,合格
20020750,21,40,60,66,63,250,不合格
20020751,65,79,78,6,98,326,合格
20020752,6,13,89,8,17,133,不合格
20020753,7,28,14,73,67,189,不合格
20020754,30,85,71,22,30,238,不合格
20020755,89,28,25,69,32,243,不合格
20020756,37,21,80,36,37,211,不合格
20020757,28,64,51,64,99,306,合格
20020758,82,63,45,87,26,303,合格
20020759,54,78,18,93,5,248,不合格
20020760,53,18,22,43,44,180,不合格
20020761,55,52,29,11,19,166,不合格
20020762,92,53,78,80,68,371,合格
20020763,75,60,41,66,89,331,合格
20020764,60,51,9,14,59,193,不合格
20020765,53,25,16,88,97,279,不合格
20020766,93,3,54,56,51,257,不合格
20020767,80,55,14,34,8,191,不合格
20020768,60,75,86,86,45,352,合格
20020769,3,62,64,92,37,258,不合格
20020770,82,31,52,99,27,291,不合格
20020771,67,87,9,64,26,253,不合格
20020772,9,0,50,60,54,173,不合格
20020773,60,29,53,54,40,236,不合格
20020774,53,17,23,31,65,189,不合格
20020775,32,24,24,41,97,218,不合格
20020776,51,91,62,80,0,284,不合格
20020777,35,61,22,47,39,204,不合格
20020778,87,62,48,0,70,267,不合格
20020779,70,21,66,54,65,276,不合格
20020780,78,19,90,25,60,272,不合格
20020781,19,0,62,54,36,171,不合格
20020782,75,97,27,43,20,262,不合格
20020783,4,2,62,47,73,188,不合格
20020784,26,84,88,72,23,293,不合格
20020785,35,32,4,20,92,183,不合格
20020786,70,69,68,70,76,353,合格
20020787,96,43,3,45,21,208,不合格
20020788,63,17,34,21,85,220,不合格
20020789,50,68,57,86,5,266,不合格
20020790,62,44,39,34,56,235,不合格
20020791,54,30,93,77,87,341,合格
20020792,58,23,68,68,30,247,不合格
20020793,65,33,34,99,45,276,不合格
20020794,51,82,3,14,96,246,不合格
20020795,0,73,95,76,50,294,不合格
20020796,91,79,98,48,83,399,合格
20020797,12,24,65,86,9,196,不合格
20020798,0,92,64,1,63,220,不合格
20020799,68,53,68,49,57,295,不合格
20020800,52,25,40,17,7,141,不合格
20020801,28,79,94,27,67,295,不合格
20020802,75,36,76,58,10,255,不合格
20020803,31,11,85,60,62,249,不合格
20020804,85,90,10,10,66,261,不合格
20020805,56,35,81,79,28,279,不合格
20020806,31,22,37,6,75,171,不合格
20020807,57,55,82,31,34,259,不合格
20020808,14,6,20,66,39,145,不合格
20020809,35,84,9,97,43,268,不合格
20020810,8,66,18,81,96,269,不合格
20020811,72,17,59,89,73,310,合格
20020812,96,55,94,18,52,315,合格
20020813,12,55,72,19,90,248,不合格
20020814,75,39,17,21,46,198,不合格
20020815,89,12,19,0,76,196,不合格
20020816,39,59,45,79,46,268,不合格
20020817,21,45,3,32,87,188,不合格
20020818,42,37,61,4,0,144,不合格
20020819,7,95,52,21,26,201,不合格
20020820,16,52,60,25,92,245,不合格
20020821,67,91,63,73,26,320,合格
20020822,76,41,64,81,50,312,合格
20020823,60,56,51,98,80,345,合格
20020824,5,53,2,18,72,150,不合格
20020825,42,46,81,26,61,256,不合格
20020826,78,10,94,37,71,290,不合格
20020827,7,21,53,25,43,149,不合格
20020828,48,74,61,39,51,273,不合格
20020829,32,46,54,92,4,228,不合格
20020830,9,64,37,97,19,226,不合格
20020831,41,72,43,13,32,201,不合格
20020832,93,25,95,22,71,306,合格
20020833,73,33,79,79,59,323,合格
20020834,95,21,1,42,83,242,不合格
20020835,20,85,64,22,90,281,不合格
20020836,81,82,11,29,91,294,不合格
20020837,41,9,88,32,13,183,不合格
20020838,34,30,81,70,51,266,不合格
20020839,59,61,22,22,45,209,不合格
20020840,89,10,58,88,46,291,不合格
20020841,81,0,52,55,40,228,不合格
20020842,83,49,33,29,15,209,不合格
20020843,6,61,87,11,13,178,不合格
20020844,86,94,10,25,80,295,不合格
20020845,52,76,59,22,16,225,不合格
20020846,2,3,79,61,98,243,不合格
20020847,38,62,22,23,54,199,不合格
20020848,77,36,51,36,69,269,不合格
20020849,90,65,56,69,94,374,合格
20020850,77,20,18,8,71,194,不合格
20020851,91,27,1,71,9,199,不合格
20020852,25,5,18,8,65,121,不合格
20020853,26,92,99,21,58,296,不合格
20020854,3,55,12,40,78,188,不合格
20020855,8,20,30,46,66,170,不合格
20020856,49,13,59,44,72,237,不合格
20020857,44,85,62,32,24,247,不合格
20020858,56,43,62,82,80,323,合格
20020859,17,79,28,21,71,216,不合格
20020860,90,78,95,31,65,359,合格
20020861,13,41,51,87,27,219,不合格
20020862,19,17,42,86,26,190,不合格
20020863,23,97,9,63,97,289,不合格
20020864,61,87,17,55,44,264,不合格
20020865,7,38,91,50,90,276,不合格
20020866,56,6,14,40,66,182,不合格
20020867,63,43,68,39,25,238,不合格
20020868,51,11,56,6,12,136,不合格
20020869,65,19,58,25,18,185,不合格
20020870,50,36,10,8,95,199,不合格
20020871,2,16,70,81,60,229,不合格
20020872,7,24,20,15,44,110,不合格
20020873,75,46,9,34,66,230,不合格
20020874,95,78,76,26,76,351,合格
20020875,93,5,16,0,63,177,不合格
20020876,22,45,98,19,94,278,不合格
20020877,38,79,42,14,40,213,不合格
20020878,88,13,76,18,9,204,不合格
20020879,35,57,14,27,43,176,不合格
20020880,48,45,48,99,91,331,合格
20020881,33,71,89,89,18,300,合格
20020882,33,20,15,70,44,182,不合格
20020883,66,66,20,43,70,265,不合格
20020884,41,27,34,65,41,208,不合格
20020885,53,15,6,52,65,191,不合格
20020886,41,62,87,90,55,335,合格
20020887,28,48,34,47,95,252,不合格
20020888,37,24,22,96,56,235,不合格
20020889,28,33,75,45,39,220,不合格
20020890,31,92,96,27,23,269,不合格
20020891,84,26,83,74,69,336,合格
20020892,23,15,65,46,80,229,不合格
20020893,81,92,85,47,40,345,合格
20020894,70,78,10,5,31,194,不合格
20020895,46,8,57,49,9,169,不合格
20020896,55,56,3,21,38,173,不合格
20020897,66,10,61,54,72,263,不合格
20020898,82,21,36,70,10,219,不合格
20020899,81,78,31,32,61,283,不合格
20020900,77,74,59,60,94,364,合格
20020901,6,85,99,38,14,242,不合格
20020902,62,99,66,99,42,368,合格
20020903,89,11,61,52,87,300,合格
20020904,50,96,39,12,47,244,不合格
20020905,75,67,45,63,80,330,合格
20020906,32,4,2,45,41,124,不合格
20020907,47,62,0,50,61,220,不合格
20020908,18,26,93,64,84,285,不合格
20020909,15,66,19,89,68,257,不合格
20020910,99,38,4,69,58,268,不合格
20020911,70,70,56,74,85,355,合格
20020912,49,57,35,93,5,239,不合格
20020913,55,78,19,85,47,284,不合格
20020914,62,39,11,49,99,260,不合格
20020915,88,80,43,34,98,343,合格
20020916,65,22,23,0,86,196,不合格
20020917,90,53,20,86,9,258,不合格
20020918,47,45,74,67,19,252,不合格
20020919,44,69,73,59,5,250,不合格
20020920,89,73,82,17,48,309,合格
20020921,60,35,21,14,25,155,不合格
20020922,96,12,87,59,72,326,合格
20020923,54,42,78,91,83,348,合格
20020924,99,60,64,8,1,232,不合格
20020925,31,24,68,42,15,180,不合格
20020926,57,71,2,14,31,175,不合格
20020927,61,95,28,26,48,258,不合格
20020928,98,69,96,82,36,381,合格
20020929,12,4,35,28,18,97,不合格
20020930,75,29,58,27,66,255,不合格
20020931,44,30,32,55,41,202,不合格
20020932,70,12,38,37,15,172,不合格
20020933,63,91,64,37,81,336,合格
20020934,30,63,50,3,74,220,不合格
20020935,96,26,82,65,29,298,不合格
20020936,80,16,1,17,14,128,不合格
20020937,99,85,71,40,33,328,合格
20020938,77,94,78,35,37,321,合格
20020939,82,60,29,70,35,276,不合格
20020940,17,24,18,93,3,155,不合格
20020941,88,26,45,46,77,282,不合格
20020942,72,76,94,66,76,384,合格
20020943,15,48,95,15,2,175,不合格
20020944,7,59,29,2,21,118,不合格
20020945,91,22,83,94,2,292,不合格
20020946,62,6,94,73,55,290,不合格
20020947,95,27,11,13,19,165,不合格
20020948,52,30,63,32,96,273,不合格
20020949,41,67,22,35,72,237,不合格
20020950,62,92,22,85,40,301,合格
20020951,25,80,12,13,9,139,不合格
20020952,89,91,74,81,18,353,合格
20020953,7,92,88,17,55,259,不合格
20020954,84,1,6,27,92,210,不合格
20020955,95,49,18,82,38,282,不合格
20020956,78,85,62,82,19,326,合格
20020957,37,16,74,13,60,200,不合格
20020958,46,6,95,10,44,201,不合格
20020959,70,71,96,8,57,302,合格
20020960,42,34,53,99,7,235,不合格
20020961,66,80,56,7,19,228,不合格
20020962,68,98,79,16,71,332,合格
20020963,41,82,27,5,90,245,不合格
20020964,91,2,79,57,23,252,不合格
20020965,21,8,61,40,97,227,不合格
20020966,14,86,35,93,40,268,不合格
20020967,62,81,5,87,72,307,合格
20020968,78,32,27,90,29,256,不合格
20020969,83,14,17,93,85,292,不合格
20020970,8,4,70,23,98,203,不合格
20020971,63,50,72,67,10,262,不合格
20020972,36,7,93,91,12,239,不合格
20020973,78,95,51,57,94,375,合格
20020974,53,58,39,82,69,301,合格
20020975,46,53,41,12,83,235,不合格
20020976,19,50,26,91,31,217,不合格
20020977,54,23,61,28,88,254,不合格
20020978,96,1,77,51,81,306,合格
20020979,3,29,79,8,93,212,不合格
20020980,3,34,57,25,25,144,不合格
20020981,81,7,9,89,73,259,不合格
20020982,84,24,96,92,45,341,合格
20020983,69,22,10,96,52,249,不合格
20020984,25,48,79,68,49,269,不合格
20020985,84,28,47,45,30,234,不合格
20020986,76,33,97,78,64,348,合格
20020987,78,75,15,94,30,292,不合格
20020988,50,9,88,55,67,269,不合格
20020989,79,58,79,48,8,272,不合格
20020990,5,95,51,65,93,309,合格
20020991,33,31,11,55,91,221,不合格
20020992,88,16,16,63,40,223,不合格
20020993,5,38,3,0,14,60,不合格
20020994,11,65,55,77,53,261,不合格
20020995,37,52,83,73,33,278,不合格
20020996,65,2,44,14,41,166,不合格
20020997,2,89,85,4,78,258,不合格
20020998,26,68,31,84,8,217,不合格
20020999,69,30,4,23,7,133,不合格
20021000,68,25,16,48,8,165,不合格
20021001,49,42,31,30,48,200,不合格
20021002,91,54,38,14,93,290,不合格
20021003,59,98,21,98,52,328,合格
20021004,72,68,79,31,21,271,不合格
20021005,86,65,90,40,16,297,不合格
20021006,48,32,98,82,44,304,合格
20021007,45,35,68,58,21,227,不合格
20021008,52,45,24,54,22,197,不合格
20021009,46,28,37,75,35,221,不合格
20021010,28,84,2,25,54,193,不合格
20021011,84,26,55,12,6,183,不合格
20021012,2,0,58,74,56,190,不合格
20021013,33,46,92,29,59,259,不合格
20021014,91,46,18,69,56,280,不合格
20021015,49,27,48,11,3,138,不合格
20021016,94,23,10,33,1,161,不合格
20021017,38,76,45,75,69,303,合格
20021018,36,47,5,48,10,146,不合格
20021019,96,34,33,29,92,284,不合格
20021020,80,42,60,98,96,376,合格
20021021,76,84,94,68,73,395,合格
20021022,97,34,68,19,5,223,不合格
20021023,75,28,74,66,2,245,不合格
20021024,84,97,5,96,40,322,合格
20021025,15,76,16,47,60,214,不合格
20021026,42,63,2,23,48,178,不合格
20021027,88,17,19,66,82,272,不合格
20021028,86,93,88,16,42,325,合格
20021029,33,23,40,55,75,226,不合格
20021030,59,42,97,59,76,333,合格
20021031,55,93,28,41,13,230,不合格
20021032,19,99,81,46,43,288,不合格
20021033,96,82,90,92,35,395,合格
20021034,88,24,82,72,15,281,不合格
20021035,99,75,32,6,83,295,不合格
20021036,51,17,38,54,42,202,不合格
20021037,82,55,50,95,85,367,合格
20021038,97,80,25,59,53,314,合格
20021039,8,84,8,44,98,242,不合格
20021040,30,8,12,72,93,215,不合格
20021041,75,89,76,16,52,308,合格
20021042,94,3,89,51,35,272,不合格
20021043,29,88,49,28,37,231,不合格
20021044,78,99,19,28,32,256,不合格
20021045,41,31,2,39,48,161,不合格
20021046,6,4,76,94,83,263,不合格
20021047,28,59,14,80,90,271,不合格
20021048,42,56,93,33,40,264,不合格
20021049,19,25,52,97,12,205,不合格
20021050,48,94,23,44,95,304,合格
20021051,53,2,67,11,58,191,不合格
20021052,16,31,62,94,26,229,不合格
20021053,33,99,63,1,31,227,不合格
20021054,51,28,52,92,30,253,不合格
20021055,63,65,46,62,83,319,合格
20021056,71,72,79,2,93,317,合格
20021057,62,44,65,52,54,277,不合格
20021058,12,1,60,80,30,183,不合格
20021059,72,21,88,41,39,261,不合格
20021060,70,17,69,40,4,200,不合格
20021061,32,73,44,53,41,243,不合格
20021062,38,77,98,61,64,338,合格
20021063,42,7,31,51,21,152,不合格
20021064,94,15,13,52,37,211,不合格
20021065,77,55,44,56,60,292,不合格
20021066,19,67,91,41,9,227,不合格
20021067,25,7,92,59,42,225,不合格
20021068,33,20,74,32,62,221,不合格
20021069,90,46,18,22,67,243,不合格
20021070,94,9,28,47,84,262,不合格
20021071,89,37,14,12,64,216,不合格
20021072,32,7,40,21,79,179,不合格
20021073,87,62,46,15,80,290,不合格
20021074,54,75,82,97,46,354,合格
20021075,40,85,17,13,36,191,不合格
20021076,56,27,50,17,6,156,不合格
20021077,71,8,39,73,28,219,不合格
20021078,39,87,76,85,77,364,合格
20021079,43,67,0,50,41,201,不合格
20021080,17,78,4,90,87,276,不合格
20021081,96,68,53,71,70,358,合格
20021082,54,2,65,69,99,289,不合格
20021083,48,45,17,56,36,202,不合格
20021084,41,5,80,66,93,285,不合格
20021085,40,78,85,96,94,393,合格
20021086,23,99,24,24,93,263,不合格
20021087,10,75,96,16,16,213,不合格
20021088,83,9,23,60,88,263,不合格
20021089,28,51,82,79,1,241,不合格
20021090,67,63,60,6,43,239,不合格
20021091,82,89,52,82,27,332,合格
20021092,56,13,3,50,13,135,不合格
20021093,69,27,64,56,50,266,不合格
20021094,60,75,96,60,52,343,合格
20021095,17,27,59,98,32,233,不合格
20021096,20,40,98,79,30,267,不合格
20021097,31,16,43,21,55,166,不合格
20021098,62,77,64,39,56,298,不合格
20021099,47,77,14,9,6,153,不合格
20021100,24,92,16,90,33,255,不合格
20021101,21,10,39,22,95,187,不合格
20021102,91,46,68,36,56,297,不合格
20021103,44,30,75,30,31,210,不合格
20021104,78,27,5,27,91,228,不合格
20021105,52,48,70,20,40,230,不合格
20021106,7,54,78,5,41,185,不合格
20021107,88,66,16,69,3,242,不合格
20021108,45,73,31,32,91,272,不合格
20021109,22,35,33,69,56,215,不合格
20021110,96,78,55,70,99,398,合格
20021111,11,19,85,20,47,182,不合格
20021112,50,19,78,65,50,262,不合格
20021113,77,25,29,31,20,182,不合格
20021114,99,22,37,80,56,294,不合格
20021115,18,92,44,68,53,275,不合格
20021116,12,43,2,40,23,120,不合格
20021117,93,3,14,61,1,172,不合格
20021118,42,33,46,77,64,262,不合格
20021119,58,65,59,78,93,353,合格
20021120,91,40,80,31,44,286,不合格
20021121,37,21,82,57,27,224,不合格
20021122,4,54,59,83,69,269,不合格
20021123,62,2,11,99,81,255,不合格
20021124,78,19,5,31,34,167,不合格
20021125,51,43,66,86,68,314,合格
20021126,73,11,27,77,7,195,不合格
20021127,29,74,85,32,8,228,不合格
20021128,67,9,31,42,81,230,不合格
20021129,52,54,49,32,81,268,不合格
20021130,95,28,24,28,8,183,不合格
20021131,70,98,2,78,83,331,合格
20021132,1,58,72,26,43,200,不合格
20021133,64,90,60,37,21,272,不合格
20021134,95,22,26,47,68,258,不合格
20021135,59,57,6,58,44,224,不合格
20021136,91,82,21,38,15,247,不合格
20021137,12,57,72,46,82,269,不合格
20021138,36,20,96,51,90,293,不合格
20021139,94,86,83,89,60,412,合格
20021140,77,73,27,19,41,237,不合格
20021141,6,96,3,5,26,136,不合格
20021142,75,10,85,34,29,233,不合格
20021143,81,97,47,34,14,273,不合格
20021144,14,49,4,72,56,195,不合格
20021145,87,46,27,24,72,256,不合格
20021146,56,55,81,34,17,243,不合格
20021147,77,83,72,42,38,312,合格
20021148,68,41,64,43,98,314,合格
20021149,11,27,17,66,18,139,不合格
20021150,86,80,65,55,62,348,合格
20021151,97,82,17,91,57,344,合格
20021152,84,97,40,89,18,328,合格
20021153,83,75,61,80,3,302,合格
20021154,21,91,99,32,25,268,不合格
20021155,25,2,70,44,19,160,不合格
20021156,73,80,15,36,91,295,不合格
20021157,18,85,4,36,1,144,不合格
20021158,43,2,35,51,90,221,不合格
20021159,22,65,18,32,93,230,不合格
20021160,40,61,87,83,14,285,不合格
20021161,66,35,32,85,87,305,合格
20021162,25,82,68,36,40,251,不合格
20021163,41,54,12,44,66,217,不合格
20021164,52,32,23,65,21,193,不合格
20021165,86,71,13,26,11,207,不合格
20021166,91,73,27,97,82,370,合格
20021167,17,47,12,15,55,146,不合格
20021168,97,7,92,61,75,332,合格
20021169,72,17,63,36,85,273,不合格
20021170,90,44,33,34,2,203,不合格
20021171,2,66,81,43,58,250,不合格
20021172,70,10,10,1,75,166,不合格
20021173,59,93,63,6,43,264,不合格
20021174,40,50,91,55,8,244,不合格
20021175,44,16,49,90,94,293,不合格
20021176,50,14,59,17,69,209,不合格
20021177,58,33,19,94,56,260,不合格
20021178,89,7,37,60,21,214,不合格
20021179,82,89,5,12,96,284,不合格
20021180,83,9,77,6,81,256,不合格
20021181,22,15,38,43,80,198,不合格
20021182,67,68,75,66,80,356,合格
20021183,80,24,63,58,93,318,合格
20021184,26,61,36,16,98,237,不合格
20021185,55,1,76,73,95,300,合格
20021186,66,34,72,8,49,229,不合格
20021187,7,7,72,35,91,212,不合格
20021188,3,28,55,96,6,188,不合格
20021189,72,83,23,37,80,295,不合格
20021190,66,13,23,42,83,227,不合格
20021191,44,50,57,96,62,309,合格
20021192,60,77,42,19,6,204,不合格
20021193,39,69,26,92,39,265,不合格
20021194,31,49,42,34,73,229,不合格
20021195,93,98,74,51,23,339,合格
20021196,29,4,41,71,39,184,不合格
20021197,77,43,4,77,82,283,不合格
20021198,99,5,12,18,83,217,不合格
20021199,75,89,81,68,50,363,合格
20021200,16,0,93,75,45,229,不合格
20021201,44,53,3,71,12,183,不合格
20021202,52,90,58,21,58,279,不合格
20021203,80,26,29,45,41,221,不合格
20021204,19,14,51,15,60,159,不合格
20021205,19,10,93,29,87,238,不合格
20021206,25,63,4,44,9,145,不合格
20021207,71,80,64,33,33,281,不合格
20021208,98,71,41,26,87,323,合格
20021209,63,29,10,91,7,200,不合格
20021210,86,11,35,94,1,227,不合格
20021211,44,47,18,20,54,183,不合格
20021212,89,21,40,83,63,296,不合格
20021213,85,11,31,88,88,303,合格
20021214,82,80,99,21,50,332,合格
20021215,51,71,23,57,83,285,不合格
20021216,51,97,92,53,70,363,合格
20021217,31,5,19,0,27,82,不合格
20021218,78,65,97,38,52,330,合格
20021219,36,80,7,8,63,194,不合格
20021220,20,76,96,18,51,261,不合格
20021221,2,99,4,26,18,149,不合格
20021222,86,89,13,0,90,278,不合格
20021223,63,65,20,41,51,240,不合格
20021224,21,29,5,9,48,112,不合格
20021225,43,41,32,16,34,166,不合格
20021226,36,5,15,90,88,234,不合格
20021227,68,4,50,53,82,257,不合格
20021228,36,73,46,73,7,235,不合格
20021229,87,3,19,94,1,204,不合格
20021230,58,87,82,92,57,376,合格
20021231,69,93,58,4,13,237,不合格
20021232,35,38,34,88,12,207,不合格
20021233,53,27,78,53,99,310,合格
20021234,70,73,28,57,91,319,合格
20021235,76,89,23,0,73,261,不合格
20021236,63,68,94,67,56,348,合格
20021237,95,65,11,1,9,181,不合格
20021238,27,9,63,49,98,246,不合格
20021239,2,47,64,25,18,156,不合格
20021240,13,54,18,20,83,188,不合格
20021241,14,82,14,33,52,195,不合格
20021242,64,33,59,90,10,256,不合格
20021243,62,96,16,57,68,299,不合格
20021244,35,25,59,31,18,168,不合格
20021245,45,18,27,54,56,200,不合格
20021246,62,16,87,43,19,227,不合格
20021247,3,56,43,46,45,193,不合格
20021248,14,0,26,35,38,113,不合格
20021249,59,31,80,65,67,302,合格
20021250,30,16,41,68,19,174,不合格
20021251,26,9,91,12,91,229,不合格
20021252,97,46,82,73,91,389,合格
20021253,45,84,53,36,67,285,不合格
20021254,49,87,46,46,94,322,合格
20021255,41,79,80,11,32,243,不合格
20021256,41,9,61,70,87,268,不合格
20021257,81,88,6,93,33,301,合格
20021258,49,78,45,41,88,301,合格
20021259,9,64,30,6,90,199,不合格
20021260,76,72,77,99,78,402,合格
20021261,41,67,70,62,74,314,合格
20021262,10,2,89,53,81,235,不合格
20021263,62,55,3,71,56,247,不合格
20021264,38,36,88,86,14,262,不合格
20021265,83,66,84,85,89,407,合格
20021266,47,55,48,18,61,229,不合格
20021267,64,49,32,21,68,234,不合格
20021268,82,46,7,90,17,242,不合格
20021269,94,61,73,14,57,299,不合格
20021270,47,32,67,7,56,209,不合格
20021271,35,28,6,12,46,127,不合格
20021272,10,29,44,88,6,177,不合格
20021273,37,26,43,62,69,237,不合格
20021274,67,31,21,44,33,196,不合格
20021275,94,15,74,22,35,240,不合格
20021276,80,96,92,94,1,363,合格
20021277,4,28,41,80,3,156,不合格
20021278,59,61,73,44,8,245,不合格
20021279,91,2,82,31,67,273,不合格
20021280,28,82,29,66,92,297,不合格
20021281,6,97,66,46,0,215,不合格
20021282,63,33,35,30,93,254,不合格
20021283,91,67,2,0,54,214,不合格
20021284,60,17,17,8,51,153,不合格
20021285,11,66,27,92,66,262,不合格
20021286,26,50,45,46,26,193,不合格
20021287,15,31,20,57,24,147,不合格
20021288,41,72,27,7,61,208,不合格
20021289,85,74,15,88,58,320,合格
20021290,1,54,16,49,76,196,不合格
20021291,61,60,10,99,45,275,不合格
20021292,25,6,99,17,59,206,不合格
20021293,15,55,22,42,9,143,不合格
20021294,2,12,51,84,68,217,不合格
20021295,1,64,20,67,24,176,不合格
20021296,52,86,85,73,37,333,合格
20021297,32,77,65,77,32,283,不合格
20021298,64,86,38,61,61,310,合格
20021299,19,93,82,74,9,277,不合格
20021300,8,38,48,64,7,165,不合格
20021301,65,94,96,3,60,318,合格
20021302,44,2,66,70,40,222,不合格
20021303,5,71,14,15,76,181,不合格
20021304,42,64,78,93,70,347,合格
20021305,99,56,69,88,28,340,合格
20021306,53,66,2,39,96,256,不合格
20021307,61,66,94,41,99,361,合格
20021308,92,57,13,59,44,265,不合格
20021309,85,75,83,29,28,300,合格
20021310,58,71,38,35,43,245,不合格
20021311,80,77,69,6,11,243,不合格
20021312,25,3,94,96,44,262,不合格
20021313,58,71,44,96,12,281,不合格
20021314,55,76,6,28,72,237,不合格
20021315,34,87,58,96,87,362,合格
20021316,7,50,88,11,99,255,不合格
20021317,65,45,86,69,33,298,不合格
20021318,9,19,99,85,75,287,不合格
20021319,31,96,57,45,33,262,不合格
20021320,53,4,89,71,70,287,不合格
20021321,12,27,87,27,32,185,不合格
20021322,71,86,48,47,10,262,不合格
20021323,99,5,21,33,66,224,不合格
20021324,24,59,34,21,64,202,不合格
20021325,97,83,98,46,1,325,合格
20021326,58,50,67,68,76,319,合格
20021327,42,6,47,96,93,284,不合格
20021328,13,15,7,48,48,131,不合格
20021329,89,17,61,82,4,253,不合格
20021330,77,95,66,65,81,384,合格
20021331,74,65,40,6,59,244,不合格
20021332,98,81,24,42,92,337,合格
20021333,17,98,59,96,44,314,合格
20021334,61,93,58,54,1,267,不合格
20021335,39,11,36,73,45,204,不合格
20021336,90,19,53,4,49,215,不合格
20021337,13,72,70,57,47,259,不合格
20021338,6,87,22,1,57,173,不合格
20021339,16,80,99,16,4,215,不合格
20021340,90,85,42,2,69,288,不合格
20021341,44,32,45,26,38,185,不合格
20021342,91,74,91,20,95,371,合格
20021343,78,43,62,14,1,198,不合格
20021344,43,72,19,74,73,281,不合格
20021345,82,50,76,25,46,279,不合格
20021346,90,49,23,14,58,234,不合格
20021347,66,88,36,60,60,310,合格
20021348,99,94,15,90,26,324,合格
20021349,33,38,78,23,62,234,不合格
20021350,55,3,31,72,78,239,不合格
20021351,17,62,58,16,69,222,不合格
20021352,92,32,32,17,57,230,不合格
20021353,40,34,65,37,67,243,不合格
20021354,81,74,88,77,10,330,合格
20021355,89,34,49,70,36,278,不合格
20021356,41,42,68,10,97,258,不合格
20021357,71,76,59,17,25,248,不合格
20021358,2,60,67,68,60,257,不合格
20021359,59,7,42,69,74,251,不合格
20021360,37,97,43,17,62,256,不合格
20021361,8,47,47,20,59,181,不合格
20021362,95,48,11,58,82,294,不合格
20021363,5,30,56,42,3,136,不合格
20021364,10,49,13,87,97,256,不合格
20021365,19,9,56,45,98,227,不合格
20021366,69,37,90,35,34,265,不合格
20021367,57,32,6,42,70,207,不合格
20021368,79,15,18,65,47,224,不合格
20021369,81,25,36,12,17,171,不合格
20021370,5,12,85,8,58,168,不合格
20021371,27,57,44,89,83,300,合格
20021372,85,23,48,98,73,327,合格
20021373,0,58,69,47,22,196,不合格
20021374,28,46,67,97,92,330,合格
20021375,82,6,56,22,42,208,不合格
20021376,55,2,70,67,14,208,不合格
20021377,43,6,76,49,34,208,不合格
20021378,88,1,51,9,57,206,不合格
20021379,54,52,43,19,0,168,不合格
20021380,10,31,19,39,70,169,不合格
20021381,7,62,37,32,47,185,不合格
20021382,91,35,57,96,0,279,不合格
20021383,30,85,96,42,86,339,合格
20021384,78,93,62,28,51,312,合格
20021385,55,13,63,45,81,257,不合格
20021386,80,39,19,42,0,180,不合格
20021387,65,34,17,17,36,169,不合格
20021388,33,95,3,71,53,255,不合格
20021389,75,62,99,45,50,331,合格
20021390,4,83,37,68,13,205,不合格
20021391,47,45,51,39,18,200,不合格
20021392,66,99,16,13,70,264,不合格
20021393,27,23,62,92,53,257,不合格
20021394,32,0,45,38,85,200,不合格
20021395,90,59,60,36,65,310,合格
20021396,75,43,7,61,12,198,不合格
20021397,11,65,62,86,65,289,不合格
20021398,62,62,79,34,50,287,不合格
20021399,55,71,15,96,88,325,合格
20021400,41,88,28,20,79,256,不合格
20021401,73,57,78,67,56,331,合格
20021402,23,53,87,97,95,355,合格
20021403,15,37,6,33,94,185,不合格
20021404,43,55,67,16,94,275,不合格
20021405,9,93,73,25,5,205,不合格
20021406,67,59,72,43,11,252,不合格
20021407,88,3,34,72,11,208,不合格
20021408,79,33,10,29,2,153,不合格
20021409,23,11,17,24,16,91,不合格
20021410,38,26,72,48,48,232,不合格
20021411,56,53,62,0,77,248,不合格
20021412,26,37,22,46,72,203,不合格
20021413,74,28,3,16,32,153,不合格
20021414,51,74,91,80,70,366,合格
20021415,62,61,3,3,3,132,不合格
20021416,31,35,70,80,89,305,合格
20021417,31,66,33,38,41,209,不合格
20021418,20,34,30,25,69,178,不合格
20021419,59,27,99,71,9,265,不合格
20021420,65,88,31,64,76,324,合格
20021421,78,70,91,19,54,312,合格
20021422,9,0,98,82,41,230,不合格
20021423,97,13,36,39,9,194,不合格
20021424,90,3,0,64,10,167,不合格
20021425,73,72,89,52,8,294,不合格
20021426,58,25,79,9,89,260,不合格
20021427,50,50,31,81,97,309,合格
20021428,82,96,62,25,31,296,不合格
20021429,98,89,9,27,35,258,不合格
20021430,77,96,45,46,60,324,合格
20021431,59,59,64,37,23,242,不合格
20021432,39,74,57,68,52,290,不合格
20021433,25,96,18,59,75,273,不合格
20021434,79,82,92,7,29,289,不合格
20021435,11,61,89,85,29,275,不合格
20021436,81,19,11,44,88,243,不合格
20021437,62,22,43,78,34,239,不合格
20021438,26,81,82,74,48,311,合格
20021439,20,37,87,48,89,281,不合格
20021440,20,29,83,56,54,242,不合格
20021441,41,34,81,33,50,239,不合格
20021442,24,23,86,23,43,199,不合格
20021443,27,55,30,28,94,234,不合格
20021444,15,74,95,46,10,240,不合格
20021445,96,28,44,88,73,329,合格
20021446,66,40,42,93,5,246,不合格
20021447,90,7,23,2,43,165,不合格
20021448,51,98,85,6,39,279,不合格
20021449,64,25,63,44,78,274,不合格
20021450,95,18,62,2,59,236,不合格
20021451,58,28,13,47,7,153,不合格
20021452,89,88,60,61,98,396,合格
20021453,29,72,45,33,7,186,不合格
20021454,97,34,84,31,23,269,不合格
20021455,27,16,75,31,99,248,不合格
20021456,35,67,9,67,26,204,不合格
20021457,89,33,57,20,4,203,不合格
20021458,10,54,83,19,92,258,不合格
20021459,1,68,1,4,83,157,不合格
20021460,77,45,15,47,28,212,不合格
20021461,56,34,33,6,56,185,不合格
20021462,78,85,44,10,40,257,不合格
20021463,21,34,32,8,53,148,不合格
20021464,40,53,1,21,90,205,不合格
20021465,85,12,11,26,91,225,不合格
20021466,10,21,53,81,1,166,不合格
20021467,58,57,79,52,0,246,不合格
20021468,42,46,54,8,53,203,不合格
20021469,69,27,25,61,61,243,不合格
20021470,5,41,97,55,44,242,不合格
20021471,54,48,72,94,71,339,合格
20021472,20,94,22,60,2,198,不合格
20021473,10,43,68,41,52,214,不合格
20021474,0,47,81,94,4,226,不合格
20021475,21,61,33,33,57,205,不合格
20021476,79,51,20,22,86,258,不合格
20021477,87,29,55,89,39,299,不合格
20021478,89,49,42,22,90,292,不合格
20021479,1,76,91,0,30,198,不合格
20021480,84,50,22,78,38,272,不合格
20021481,35,10,83,99,73,300,合格
20021482,75,6,58,3,81,223,不合格
20021483,66,58,94,55,75,348,合格
20021484,14,78,71,79,52,294,不合格
20021485,34,51,0,18,83,186,不合格
20021486,95,1,75,32,64,267,不合格
20021487,90,28,9,13,31,171,不合格
20021488,14,11,22,50,61,158,不合格
20021489,0,77,57,10,42,186,不合格
20021490,72,22,66,95,92,347,合格
20021491,95,43,67,28,37,270,不合格
20021492,90,76,72,67,78,383,合格
20021493,81,55,5,53,21,215,不合格
20021494,49,23,68,27,45,212,不合格
20021495,79,5,46,39,95,264,不合格
20021496,11,46,13,33,3,106,不合格
20021497,72,39,67,83,76,337,合格
20021498,85,0,96,8,21,210,不合格
20021499,59,75,52,87,32,305,合格
20021500,46,95,54,9,18,222,不合格
20021501,1,33,88,59,66,247,不合格
20021502,11,58,76,69,55,269,不合格
20021503,86,60,71,22,88,327,合格
20021504,98,16,28,37,39,218,不合格
20021505,77,56,80,0,42,255,不合格
20021506,45,59,61,36,37,238,不合格
20021507,28,50,44,81,81,284,不合格
20021508,86,32,89,14,51,272,不合格
20021509,50,92,66,86,47,341,合格
20021510,37,44,83,8,86,258,不合格
20021511,11,18,23,75,70,197,不合格
20021512,34,51,82,22,73,262,不合格
20021513,25,23,20,15,9,92,不合格
20021514,96,67,98,46,31,338,合格
20021515,19,43,0,97,10,169,不合格
20021516,91,24,24,49,52,240,不合格
20021517,52,99,55,15,27,248,不合格
20021518,83,18,86,76,91,354,合格
20021519,58,46,71,89,24,288,不合格
20021520,52,75,53,40,70,290,不合格
20021521,12,76,59,56,93,296,不合格
20021522,38,77,13,24,68,220,不合格
20021523,96,35,39,48,5,223,不合格
20021524,44,66,2,14,16,142,不合格
20021525,95,6,31,56,1,189,不合格
20021526,65,89,63,12,3,232,不合格
20021527,18,61,33,6,50,168,不合格
20021528,54,6,19,35,67,181,不合格
20021529,84,71,79,51,20,305,合格
20021530,84,20,4,45,67,220,不合格
20021531,55,55,31,85,54,280,不合格
20021532,59,13,81,79,5,237,不合格
20021533,60,89,7,1,69,226,不合格
20021534,35,7,97,49,68,256,不合格
20021535,80,64,29,60,14,247,不合格
20021536,98,74,5,87,28,292,不合格
20021537,76,79,40,46,12,253,不合格
20021538,51,4,97,67,11,230,不合格
20021539,2,80,72,62,38,254,不合格
20021540,59,56,27,81,39,262,不合格
20021541,3,70,91,3,87,254,不合格
20021542,51,95,91,85,43,365,合格
20021543,19,22,59,77,40,217,不合格
20021544,38,43,12,12,63,168,不合格
20021545,18,32,22,11,51,134,不合格
20021546,13,57,85,59,35,249,不合格
20021547,71,83,74,35,78,341,合格
20021548,82,24,44,78,88,316,合格
20021549,39,39,26,25,91,220,不合格
20021550,96,21,12,83,54,266,不合格
20021551,68,72,68,32,94,334,合格
20021552,99,60,24,61,26,270,不合格
20021553,81,60,42,45,4,232,不合格
20021554,30,35,19,12,47,143,不合格
20021555,48,60,47,14,40,209,不合格
20021556,8,75,47,83,66,279,不合格
20021557,5,88,89,66,12,260,不合格
20021558,16,64,63,56,81,280,不合格
20021559,40,72,86,71,29,298,不合格
20021560,61,69,16,54,69,269,不合格
20021561,27,94,78,79,18,296,不合格
20021562,53,36,91,63,59,302,合格
20021563,99,19,53,57,89,317,合格
20021564,70,29,79,62,78,318,合格
20021565,74,6,57,55,98,290,不合格
20021566,87,91,52,78,39,347,合格
20021567,98,97,84,19,96,394,合格
20021568,12,62,46,41,48,209,不合格
20021569,31,22,51,74,20,198,不合格
20021570,96,61,77,99,87,420,合格
20021571,65,72,77,66,95,375,合格
20021572,18,27,2,32,24,103,不合格
20021573,30,55,72,95,54,306,合格
20021574,59,85,86,14,16,260,不合格
20021575,75,0,94,90,91,350,合格
20021576,96,8,67,88,15,274,不合格
20021577,14,60,45,39,95,253,不合格
20021578,90,66,44,78,97,375,合格
20021579,17,9,36,73,14,149,不合格
20021580,43,70,10,44,39,206,不合格
20021581,43,57,90,94,87,371,合格
20021582,68,30,77,54,74,303,合格
20021583,60,47,38,59,23,227,不合格
20021584,86,10,93,35,44,268,不合格
20021585,84,71,98,68,49,370,合格
20021586,37,36,36,99,78,286,不合格
20021587,30,4,71,79,2,186,不合格
20021588,4,29,25,46,82,186,不合格
20021589,64,29,48,46,0,187,不合格
20021590,69,77,9,43,35,233,不合格
20021591,64,82,57,28,59,290,不合格
20021592,12,85,45,35,1,178,不合格
20021593,64,12,25,43,78,222,不合格
20021594,34,79,24,70,37,244,不合格
20021595,98,21,33,58,32,242,不合格
20021596,66,72,98,28,58,322,合格
20021597,5,82,64,18,23,192,不合格
20021598,95,58,46,19,84,302,合格
20021599,60,65,47,19,9,200,不合格
20021600,81,71,77,56,33,318,合格
20021601,61,95,70,5,49,280,不合格
20021602,13,23,74,61,34,205,不合格
20021603,45,43,31,25,18,162,不合格
20021604,86,25,35,11,95,252,不合格
20021605,23,97,83,69,9,281,不合格
20021606,10,43,62,13,4,132,不合格
20021607,50,86,64,29,33,262,不合格
20021608,5,78,75,34,42,234,不合格
20021609,52,41,91,34,39,257,不合格
20021610,45,98,53,27,7,230,不合格
20021611,17,70,28,90,54,259,不合格
20021612,63,13,70,1,22,169,不合格
20021613,5,19,65,94,41,224,不合格
20021614,11,27,88,15,82,223,不合格
20021615,22,66,52,17,36,193,不合格
20021616,44,60,75,90,50,319,合格
20021617,40,51,68,78,11,248,不合格
20021618,89,93,57,6,74,319,合格
20021619,6,10,35,31,95,177,不合格
20021620,43,44,14,59,59,219,不合格
20021621,15,82,44,10,50,201,不合格
20021622,47,91,48,45,21,252,不合格
20021623,55,95,86,72,16,324,合格
20021624,41,87,28,2,65,223,不合格
20021625,79,61,1,60,67,268,不合格
20021626,87,6,51,14,55,213,不合格
20021627,53,83,89,90,67,382,合格
20021628,70,58,59,2,5,194,不合格
20021629,98,21,37,43,59,258,不合格
20021630,67,87,89,59,69,371,合格
20021631,46,78,81,46,66,317,合格
20021632,24,25,93,11,96,249,不合格
20021633,41,2,33,52,32,160,不合格
20021634,52,5,66,3,91,217,不合格
20021635,38,51,39,23,8,159,不合格
20021636,85,38,64,12,95,294,不合格
20021637,51,17,68,98,78,312,合格
20021638,25,20,77,46,32,200,不合格
20021639,92,60,30,42,73,297,不合格
20021640,91,6,41,73,8,219,不合格
20021641,42,14,11,25,51,143,不合格
20021642,39,5,23,92,26,185,不合格
20021643,0,50,80,72,19,221,不合格
20021644,68,73,61,85,33,320,合格
20021645,41,8,61,25,75,210,不合格
20021646,2,17,27,15,27,88,不合格
20021647,16,17,62,76,34,205,不合格
20021648,81,2,28,63,63,237,不合格
20021649,91,30,87,74,85,367,合格
20021650,30,5,96,55,49,235,不合格
20021651,43,71,67,87,51,319,合格
20021652,89,71,82,37,15,294,不合格
20021653,70,25,45,96,33,269,不合格
20021654,13,66,9,13,47,148,不合格
20021655,15,60,3,8,36,122,不合格
20021656,65,42,79,27,55,268,不合格
20021657,62,35,20,76,54,247,不合格
20021658,17,72,95,92,43,319,合格
20021659,92,1,56,99,94,342,合格
20021660,18,87,85,33,80,303,合格
20021661,30,49,68,59,41,247,不合格
20021662,79,58,65,99,9,310,合格
20021663,80,72,29,55,96,332,合格
20021664,75,88,31,42,48,284,不合格
20021665,91,64,2,26,18,201,不合格
20021666,29,10,52,88,87,266,不合格
20021667,39,7,50,87,5,188,不合格
20021668,84,72,12,30,48,246,不合格
20021669,7,84,36,95,70,292,不合格
20021670,18,29,4,19,96,166,不合格
20021671,66,6,92,31,59,254,不合格
20021672,12,63,36,19,69,199,不合格
20021673,68,56,47,33,3,207,不合格
20021674,95,10,20,31,53,209,不合格
20021675,64,32,70,85,40,291,不合格
20021676,30,20,30,95,37,212,不合格
20021677,59,58,93,79,86,375,合格
20021678,3,80,4,72,68,227,不合格
20021679,65,96,50,63,28,302,合格
20021680,34,52,5,56,74,221,不合格
20021681,76,40,12,36,25,189,不合格
20021682,87,18,5,82,33,225,不合格
20021683,8,13,25,90,56,192,不合格
20021684,30,77,72,14,64,257,不合格
20021685,61,8,14,59,46,188,不合格
20021686,45,45,23,16,7,136,不合格
20021687,52,99,50,17,24,242,不合格
20021688,0,14,88,70,98,270,不合格
20021689,48,39,13,76,90,266,不合格
20021690,87,81,46,79,17,310,合格
20021691,6,18,7,3,11,45,不合格
20021692,25,93,48,56,13,235,不合格
20021693,24,57,91,86,54,312,合格
20021694,35,23,77,33,82,250,不合格
20021695,34,20,30,99,81,264,不合格
20021696,76,97,1,22,54,250,不合格
20021697,21,21,15,17,7,81,不合格
20021698,91,31,92,33,31,278,不合格
20021699,78,8,1,32,71,190,不合格
20021700,30,86,74,1,49,240,不合格
20021701,95,46,28,42,57,268,不合格
20021702,59,5,59,0,11,134,不合格
20021703,86,70,69,31,88,344,合格
20021704,11,86,28,66,23,214,不合格
20021705,8,72,98,58,30,266,不合格
20021706,47,70,76,65,75,333,合格
20021707,74,73,13,52,16,228,不合格
20021708,3,64,50,87,54,258,不合格
20021709,50,88,56,2,57,253,不合格
20021710,59,52,53,32,5,201,不合格
20021711,16,78,60,61,31,246,不合格
20021712,42,74,91,39,51,297,不合格
20021713,30,74,32,37,78,251,不合格
20021714,31,31,25,76,54,217,不合格
20021715,49,12,99,36,75,271,不合格
20021716,9,57,82,88,57,293,不合格
20021717,25,48,70,19,13,175,不合格
20021718,38,90,82,45,70,325,合格
20021719,24,31,24,35,30,144,不合格
20021720,31,49,43,4,27,154,不合格
20021721,36,29,44,83,43,235,不合格
20021722,74,30,24,44,96,268,不合格
20021723,45,19,59,25,47,195,不合格
20021724,47,5,77,96,86,311,合格
20021725,85,44,94,94,14,331,合格
20021726,9,9,9,33,7,67,不合格
20021727,27,97,35,57,45,261,不合格
20021728,70,43,24,29,60,226,不合格
20021729,41,98,20,30,58,247,不合格
20021730,63,76,89,22,10,260,不合格
20021731,74,31,0,15,94,214,不合格
20021732,47,30,4,11,66,158,不合格
20021733,89,74,82,91,23,359,合格
20021734,60,73,68,24,30,255,不合格
20021735,57,64,94,78,89,382,合格
20021736,52,95,69,19,40,275,不合格
20021737,5,88,55,65,8,221,不合格
20021738,69,24,48,4,31,176,不合格
20021739,20,36,71,29,73,229,不合格
20021740,90,74,47,35,80,326,合格
20021741,45,37,14,4,71,171,不合格
20021742,92,59,96,81,62,390,合格
20021743,10,44,13,91,38,196,不合格
20021744,17,8,53,55,17,150,不合格
20021745,90,13,13,44,9,169,不合格
20021746,86,77,84,59,97,403,合格
20021747,58,91,10,30,91,280,不合格
20021748,44,72,71,74,31,292,不合格
20021749,65,30,15,81,16,207,不合格
20021750,14,52,29,83,75,253,不合格
20021751,98,93,4,96,76,367,合格
20021752,24,98,32,96,56,306,合格
20021753,89,77,1,42,35,244,不合格
20021754,88,48,10,82,3,231,不合格
20021755,67,59,29,12,76,243,不合格
20021756,2,43,9,10,43,107,不合格
20021757,89,44,31,40,75,279,不合格
20021758,76,82,38,63,63,322,合格
20021759,87,43,29,98,99,356,合格
20021760,11,38,54,46,2,151,不合格
20021761,45,73,58,63,39,278,不合格
20021762,85,67,64,97,74,387,合格
20021763,62,34,63,93,81,333,合格
20021764,71,68,18,36,3,196,不合格
20021765,36,20,67,26,76,225,不合格
20021766,26,84,61,19,47,237,不合格
20021767,69,44,30,92,56,291,不合格
20021768,4,23,6,91,85,209,不合格
20021769,71,2,44,6,75,198,不合格
20021770,2,93,34,15,23,167,不合格
20021771,85,95,25,7,69,281,不合格
20021772,21,44,89,45,51,250,不合格
20021773,21,16,80,81,42,240,不合格
20021774,99,37,60,25,39,260,不合格
20021775,26,77,42,20,5,170,不合格
20021776,38,73,40,86,6,243,不合格
20021777,79,70,56,75,2,282,不合格
20021778,87,36,58,54,44,279,不合格
20021779,47,14,95,53,57,266,不合格
20021780,51,14,45,54,87,251,不合格
20021781,81,73,67,51,64,336,合格
20021782,86,89,46,8,95,324,合格
20021783,23,35,43,26,94,221,不合格
20021784,70,89,77,77,45,358,合格
20021785,61,76,26,39,49,251,不合格
20021786,65,98,36,93,39,331,合格
20021787,26,44,88,94,93,345,合格
20021788,34,73,42,1,96,246,不合格
20021789,22,52,51,7,32,164,不合格
20021790,48,39,84,0,1,172,不合格
20021791,48,62,76,5,99,290,不合格
20021792,94,96,52,63,11,316,合格
20021793,54,4,25,80,74,237,不合格
20021794,83,40,91,24,92,330,合格
20021795,39,19,61,9,56,184,不合格
20021796,57,63,39,32,5,196,不合格
20021797,93,1,97,50,6,247,不合格
20021798,20,0,74,51,25,170,不合格
20021799,8,60,7,44,92,211,不合格
20021800,89,51,96,50,95,381,合格
20021801,31,61,82,63,41,278,不合格
20021802,69,46,93,24,82,314,合格
20021803,58,98,55,74,31,316,合格
20021804,21,61,64,10,52,208,不合格
20021805,11,17,35,89,23,175,不合格
20021806,54,14,47,48,60,223,不合格
20021807,98,88,66,11,53,316,合格
20021808,69,28,63,15,98,273,不合格
20021809,51,56,12,49,39,207,不合格
20021810,50,3,14,74,85,226,不合格
20021811,62,31,36,84,95,308,合格
20021812,54,92,35,34,64,279,不合格
20021813,74,12,46,10,58,200,不合格
20021814,44,58,86,37,6,231,不合格
20021815,42,50,90,76,54,312,合格
20021816,90,77,16,66,34,283,不合格
20021817,22,66,90,1,32,211,不合格
20021818,18,28,47,36,94,223,不合格
20021819,39,31,48,4,68,190,不合格
20021820,8,53,54,57,52,224,不合格
20021821,3,52,59,87,35,236,不合格
20021822,44,63,96,61,25,289,不合格
20021823,98,99,34,74,14,319,合格
20021824,55,63,20,68,6,212,不合格
20021825,89,47,45,59,31,271,不合格
20021826,56,88,97,46,82,369,合格
20021827,45,38,14,88,90,275,不合格
20021828,46,95,87,88,61,377,合格
20021829,47,13,27,37,47,171,不合格
20021830,60,64,50,25,31,230,不合格
20021831,30,56,28,78,71,263,不合格
20021832,43,57,73,59,73,305,合格
20021833,35,67,30,78,24,234,不合格
20021834,10,54,0,33,10,107,不合格
20021835,37,6,73,17,31,164,不合格
20021836,30,27,17,10,14,98,不合格
20021837,74,65,26,13,50,228,不合格
20021838,73,91,85,36,85,370,合格
20021839,54,71,95,98,60,378,合格
20021840,30,86,55,9,74,254,不合格
20021841,56,62,59,73,6,256,不合格
20021842,97,44,47,28,30,246,不合格
20021843,11,9,89,87,67,263,不合格
20021844,34,85,74,84,1,278,不合格
20021845,39,7,65,24,61,196,不合格
20021846,57,2,37,71,26,193,不合格
20021847,19,68,20,7,82,196,不合格
20021848,0,48,79,13,53,193,不合格
20021849,19,67,52,27,89,254,不合格
20021850,66,96,63,47,24,296,不合格
20021851,86,18,45,49,91,289,不合格
20021852,34,75,75,67,79,330,合格
20021853,5,6,18,39,29,97,不合格
20021854,21,90,45,57,67,280,不合格
20021855,65,71,93,29,32,290,不合格
20021856,56,43,14,14,42,169,不合格
20021857,41,23,68,61,67,260,不合格
20021858,30,90,0,41,90,251,不合格
20021859,41,48,98,38,15,240,不合格
20021860,98,92,58,35,67,350,合格
20021861,72,90,34,31,52,279,不合格
20021862,25,60,84,2,82,253,不合格
20021863,20,32,43,91,44,230,不合格
20021864,43,80,67,74,48,312,合格
20021865,42,96,51,70,11,270,不合格
20021866,73,10,5,81,52,221,不合格
20021867,45,4,99,55,24,227,不合格
20021868,86,45,73,46,41,291,不合格
20021869,56,0,86,14,53,209,不合格
20021870,0,12,41,64,69,186,不合格
20021871,1,42,95,74,5,217,不合格
20021872,0,79,11,81,11,182,不合格
20021873,35,0,0,27,35,97,不合格
20021874,18,38,45,47,39,187,不合格
20021875,25,89,45,25,0,184,不合格
20021876,76,98,70,68,44,356,合格
20021877,23,78,4,67,93,265,不合格
20021878,37,53,17,9,90,206,不合格
20021879,11,71,31,67,92,272,不合格
20021880,22,69,21,60,24,196,不合格
20021881,46,78,18,63,5,210,不合格
20021882,40,49,31,78,41,239,不合格
20021883,64,90,0,84,65,303,合格
20021884,49,30,79,20,8,186,不合格
20021885,42,6,65,24,91,228,不合格
20021886,54,54,21,89,78,296,不合格
20021887,60,65,17,25,7,174,不合格
20021888,54,30,23,78,22,207,不合格
20021889,47,85,34,49,56,271,不合格
20021890,22,46,61,87,54,270,不合格
20021891,23,73,67,14,25,202,不合格
20021892,13,93,95,31,27,259,不合格
20021893,93,64,50,2,48,257,不合格
20021894,59,42,35,49,69,254,不合格
20021895,33,68,47,15,44,207,不合格
20021896,94,86,96,35,36,347,合格
20021897,18,60,2,77,83,240,不合格
20021898,87,53,45,18,40,243,不合格
20021899,69,39,77,55,64,304,合格
20021900,65,43,9,94,24,235,不合格
20021901,83,89,62,94,85,413,合格
20021902,98,62,16,1,17,194,不合格
20021903,88,1,83,96,37,305,合格
20021904,55,81,36,68,1,241,不合格
20021905,0,27,53,32,67,179,不合格
20021906,96,26,46,96,97,361,合格
20021907,88,96,13,84,99,380,合格
20021908,37,27,36,59,71,230,不合格
20021909,2,21,30,93,87,233,不合格
20021910,8,34,66,74,86,268,不合格
20021911,87,30,4,65,29,215,不合格
20021912,32,89,82,86,51,340,合格
20021913,73,98,91,64,91,417,合格
20021914,33,17,9,27,1,87,不合格
20021915,87,84,90,5,87,353,合格
20021916,51,49,29,89,72,290,不合格
20021917,50,68,85,39,10,252,不合格
20021918,28,13,15,32,74,162,不合格
20021919,11,64,19,73,37,204,不合格
20021920,90,45,59,41,12,247,不合格
20021921,72,91,25,77,81,346,合格
20021922,25,58,93,39,90,305,合格
20021923,73,61,31,61,24,250,不合格
20021924,4,95,38,32,72,241,不合格
20021925,46,8,19,15,86,174,不合格
20021926,24,74,44,45,13,200,不合格
20021927,84,96,98,27,29,334,合格
20021928,46,97,3,53,45,244,不合格
20021929,51,48,48,69,37,253,不合格
20021930,26,30,6,77,34,173,不合格
20021931,0,2,52,19,86,159,不合格
20021932,97,5,36,77,20,235,不合格
20021933,18,87,31,48,89,273,不合格
20021934,95,58,23,23,39,238,不合格
20021935,21,17,38,78,4,158,不合格
20021936,5,78,87,34,57,261,不合格
20021937,57,8,54,2,0,121,不合格
20021938,69,55,47,14,62,247,不合格
20021939,83,72,81,48,66,350,合格
20021940,35,82,91,42,30,280,不合格
20021941,40,7,0,49,18,114,不合格
20021942,28,58,42,37,31,196,不合格
20021943,98,65,96,97,59,415,合格
20021944,3,28,8,85,37,161,不合格
20021945,1,89,7,39,47,183,不合格
20021946,55,88,84,46,27,300,合格
20021947,60,75,97,71,20,323,合格
20021948,61,34,42,52,51,240,不合格
20021949,46,33,26,56,59,220,不合格
20021950,45,98,2,58,44,247,不合格
20021951,64,69,91,93,53,370,合格
20021952,47,10,5,42,50,154,不合格
20021953,16,72,48,18,20,174,不合格
20021954,34,55,81,84,85,339,合格
20021955,11,89,77,86,76,339,合格
20021956,51,27,13,22,62,175,不合格
20021957,85,57,31,25,81,279,不合格
20021958,24,26,98,35,8,191,不合格
20021959,16,60,48,53,35,212,不合格
20021960,28,75,23,41,12,179,不合格
20021961,65,54,12,9,77,217,不合格
20021962,76,1,12,87,46,222,不合格
20021963,83,43,1,9,41,177,不合格
20021964,31,26,4,64,13,138,不合格
20021965,64,55,12,68,62,261,不合格
20021966,44,32,95,72,16,259,不合格
20021967,67,18,61,35,51,232,不合格
20021968,65,25,2,99,29,220,不合格
20021969,97,6,29,33,69,234,不合格
20021970,65,55,29,7,71,227,不合格
20021971,68,60,2,97,12,239,不合格
20021972,58,54,47,16,45,220,不合格
20021973,41,95,73,54,11,274,不合格
20021974,73,26,37,85,47,268,不合格
20021975,31,98,79,27,43,278,不合格
20021976,15,59,9,55,58,196,不合格
20021977,91,35,82,48,35,291,不合格
20021978,65,42,42,38,2,189,不合格
20021979,73,64,2,78,11,228,不合格
20021980,35,26,40,51,75,227,不合格
20021981,67,7,38,69,90,271,不合格
20021982,35,19,28,57,24,163,不合格
20021983,93,30,11,48,18,200,不合格
20021984,54,31,78,96,96,355,合格
20021985,8,31,54,38,99,230,不合格
20021986,32,88,87,1,92,300,合格
20021987,36,35,78,55,46,250,不合格
20021988,45,60,60,83,18,266,不合格
20021989,46,82,76,10,49,263,不合格
20021990,50,26,55,63,37,231,不合格
20021991,52,53,48,4,32,189,不合格
20021992,11,81,75,88,70,325,合格
20021993,22,42,96,99,87,346,合格
20021994,10,66,74,64,51,265,不合格
20021995,90,46,71,70,90,367,合格
20021996,50,3,63,99,60,275,不合格
20021997,76,46,47,59,77,305,合格
20021998,76,28,76,87,4,271,不合格
20021999,63,20,43,69,48,243,不合格
20022000,3,27,74,47,19,170,不合格
20022001,21,30,17,8,40,116,不合格
20022002,6,85,60,19,56,226,不合格
20022003,68,82,57,33,93,333,合格
20022004,41,80,75,28,72,296,不合格
20022005,87,71,41,85,32,316,合格
20022006,61,70,68,4,3,206,不合格
20022007,98,54,72,85,46,355,合格
20022008,63,60,85,21,18,247,不合格
20022009,36,62,92,44,5,239,不合格
20022010,35,62,77,36,82,292,不合格
20022011,57,39,91,5,99,291,不合格
20022012,94,11,45,77,91,318,合格
20022013,57,59,61,16,35,228,不合格
20022014,30,90,79,18,8,225,不合格
20022015,70,54,95,32,12,263,不合格
20022016,89,3,19,20,65,196,不合格
20022017,3,85,70,97,39,294,不合格
20022018,95,8,81,35,59,278,不合格
20022019,75,65,92,32,7,271,不合格
20022020,97,99,72,27,1,296,不合格
20022021,98,0,56,3,16,173,不合格
20022022,9,89,37,84,33,252,不合格
20022023,93,88,82,90,94,447,合格
20022024,9,38,39,16,19,121,不合格
20022025,45,42,77,34,30,228,不合格
20022026,11,92,47,45,35,230,不合格
20022027,73,93,60,33,68,327,合格
20022028,99,23,85,97,63,367,合格
20022029,96,40,74,59,96,365,合格
20022030,91,63,55,4,69,282,不合格
20022031,35,98,16,54,56,259,不合格
20022032,59,68,28,0,13,168,不合格
20022033,65,1,41,4,72,183,不合格
20022034,22,83,27,86,78,296,不合格
20022035,35,84,43,59,96,317,合格
20022036,89,90,1,42,84,306,合格
20022037,42,25,82,40,35,224,不合格
20022038,62,70,68,56,92,348,合格
20022039,37,3,93,42,75,250,不合格
20022040,75,69,3,43,46,236,不合格
20022041,47,9,79,73,61,269,不合格
20022042,8,69,53,17,87,234,不合格
20022043,59,25,98,9,70,261,不合格
20022044,46,19,28,88,1,182,不合格
20022045,80,22,76,91,82,351,合格
20022046,19,42,18,15,18,112,不合格
20022047,11,81,83,94,92,361,合格
20022048,24,57,57,95,85,318,合格
20022049,35,73,17,39,91,255,不合格
20022050,2,76,58,65,63,264,不合格
20022051,21,5,45,47,94,212,不合格
20022052,75,26,65,60,74,300,合格
20022053,21,87,47,26,19,200,不合格
20022054,74,68,9,52,33,236,不合格
20022055,91,75,20,51,61,298,不合格
20022056,97,6,36,37,55,231,不合格
20022057,50,73,50,73,25,271,不合格
20022058,68,75,26,4,49,222,不合格
20022059,43,92,26,97,11,269,不合格
20022060,85,82,86,27,97,377,合格
20022061,27,14,38,45,27,151,不合格
20022062,85,45,95,34,0,259,不合格
20022063,61,50,77,77,97,362,合格
20022064,55,85,57,40,12,249,不合格
20022065,82,13,55,10,37,197,不合格
20022066,41,6,58,66,44,215,不合格
20022067,67,49,78,50,61,305,合格
20022068,71,43,95,98,40,347,合格
20022069,17,23,91,47,7,185,不合格
20022070,17,77,7,41,68,210,不合格
20022071,77,85,98,55,67,382,合格
20022072,94,86,49,98,96,423,合格
20022073,43,43,21,83,92,282,不合格
20022074,98,74,9,77,65,323,合格
20022075,59,1,25,76,13,174,不合格
20022076,91,30,35,13,48,217,不合格
20022077,99,86,94,64,72,415,合格
20022078,91,16,14,5,36,162,不合格
20022079,0,68,96,42,18,224,不合格
20022080,5,87,89,76,9,266,不合格
20022081,53,59,76,28,24,240,不合格
20022082,35,85,1,21,90,232,不合格
20022083,37,79,12,81,2,211,不合格
20022084,67,42,79,74,53,315,合格
20022085,75,11,46,90,65,287,不合格
20022086,73,71,62,73,82,361,合格
20022087,79,50,45,3,66,243,不合格
20022088,63,80,15,45,46,249,不合格
20022089,38,27,57,43,93,258,不合格
20022090,46,9,6,59,3,123,不合格
20022091,72,1,39,72,43,227,不合格
20022092,0,57,90,33,70,250,不合格
20022093,69,43,23,54,48,237,不合格
20022094,35,41,30,6,93,205,不合格
20022095,24,54,22,11,26,137,不合格
20022096,67,37,11,94,21,230,不合格
20022097,87,47,2,7,79,222,不合格
20022098,94,63,99,98,41,395,合格
20022099,68,41,70,4,65,248,不合格
20022100,18,62,17,54,56,207,不合格
20022101,46,67,99,57,48,317,合格
20022102,69,46,42,33,17,207,不合格
20022103,91,72,50,10,84,307,合格
20022104,90,75,82,57,42,346,合格
20022105,22,59,33,6,30,150,不合格
20022106,60,16,74,13,42,205,不合格
20022107,25,79,62,24,11,201,不合格
20022108,31,65,45,51,42,234,不合格
20022109,83,38,53,63,63,300,合格
20022110,88,77,55,6,61,287,不合格
20022111,49,24,81,36,20,210,不合格
20022112,36,62,44,99,62,303,合格
20022113,4,68,54,78,1,205,不合格
20022114,89,73,16,33,9,220,不合格
20022115,23,21,55,90,40,229,不合格
20022116,42,47,30,19,89,227,不合格
20022117,5,94,19,36,80,234,不合格
20022118,20,19,94,95,18,246,不合格
20022119,80,74,92,4,78,328,合格
20022120,37,7,22,22,83,171,不合格
20022121,98,63,99,14,49,323,合格
20022122,5,23,26,29,73,156,不合格
20022123,73,31,43,18,29,194,不合格
20022124,90,56,89,28,57,320,合格
20022125,24,37,22,7,67,157,不合格
20022126,3,94,12,27,17,153,不合格
20022127,66,77,89,99,12,343,合格
20022128,9,55,67,91,59,281,不合格
20022129,49,84,70,60,14,277,不合格
20022130,48,62,83,80,85,358,合格
20022131,72,68,68,0,22,230,不合格
20022132,7,38,76,73,50,244,不合格
20022133,25,93,26,29,84,257,不合格
20022134,93,19,77,42,61,292,不合格
20022135,27,97,37,90,39,290,不合格
20022136,95,32,95,26,62,310,合格
20022137,13,10,78,86,63,250,不合格
20022138,45,73,96,74,68,356,合格
20022139,87,32,26,75,18,238,不合格
20022140,55,69,30,78,20,252,不合格
20022141,97,30,50,53,40,270,不合格
20022142,34,70,89,65,74,332,合格
20022143,89,14,90,7,64,264,不合格
20022144,53,22,41,19,56,191,不合格
20022145,20,2,65,11,39,137,不合格
20022146,2,97,76,72,6,253,不合格
20022147,63,89,0,35,65,252,不合格
20022148,27,86,66,12,80,271,不合格
20022149,30,71,85,82,63,331,合格
20022150,67,12,86,98,48,311,合格
20022151,22,3,99,0,67,191,不合格
20022152,38,7,73,62,5,185,不合格
20022153,97,27,70,57,87,338,合格
20022154,8,22,61,69,61,221,不合格
20022155,95,81,49,0,20,245,不合格
20022156,63,28,62,51,78,282,不合格
20022157,50,40,6,1,15,112,不合格
20022158,7,92,65,24,64,252,不合格
20022159,85,97,98,80,73,433,合格
20022160,21,9,28,55,39,152,不合格
20022161,70,87,9,34,72,272,不合格
20022162,65,78,75,48,64,330,合格
20022163,75,52,16,9,28,180,不合格
20022164,12,78,15,8,40,153,不合格
20022165,86,77,3,61,34,261,不合格
20022166,9,68,60,15,34,186,不合格
20022167,52,97,40,92,4,285,不合格
20022168,92,16,42,50,28,228,不合格
20022169,77,80,42,46,25,270,不合格
20022170,13,66,96,26,77,278,不合格
20022171,59,40,75,10,13,197,不合格
20022172,13,44,14,84,24,179,不合格
20022173,37,81,29,79,83,309,合格
20022174,48,53,89,94,41,325,合格
20022175,78,2,69,40,24,213,不合格
20022176,70,89,84,9,2,254,不合格
20022177,7,53,80,4,26,170,不合格
20022178,35,60,58,41,44,238,不合格
20022179,35,94,75,67,67,338,合格
20022180,1,63,93,80,34,271,不合格
20022181,54,19,1,65,69,208,不合格
20022182,16,62,14,40,94,226,不合格
20022183,54,35,79,20,77,265,不合格
20022184,74,55,83,12,27,251,不合格
20022185,93,96,41,9,56,295,不合格
20022186,95,2,0,14,51,162,不合格
20022187,93,45,50,15,66,269,不合格
20022188,87,82,7,27,79,282,不合格
20022189,7,7,61,34,71,180,不合格
20022190,49,25,39,85,62,260,不合格
20022191,30,81,79,97,96,383,合格
20022192,49,3,0,75,26,153,不合格
20022193,32,35,78,46,42,233,不合格
20022194,47,64,92,68,81,352,合格
20022195,69,66,38,78,91,342,合格
20022196,42,86,89,76,80,373,合格
20022197,16,9,50,17,60,152,不合格
20022198,69,74,10,50,51,254,不合格
20022199,39,78,28,69,5,219,不合格
20022200,7,42,35,71,20,175,不合格
20022201,25,49,27,29,23,153,不合格
20022202,92,82,61,59,37,331,合格
20022203,74,15,89,22,61,261,不合格
20022204,40,37,55,10,32,174,不合格
20022205,3,13,41,83,60,200,不合格
20022206,1,76,76,87,62,302,合格
20022207,69,80,71,69,67,356,合格
20022208,60,91,97,63,3,314,合格
20022209,87,32,1,43,41,204,不合格
20022210,41,54,31,67,75,268,不合格
20022211,75,62,4,30,69,240,不合格
20022212,84,55,8,73,43,263,不合格
20022213,83,25,59,29,93,289,不合格
20022214,52,17,3,71,49,192,不合格
20022215,75,27,4,73,72,251,不合格
20022216,63,28,14,45,45,195,不合格
20022217,1,13,79,23,47,163,不合格
20022218,22,63,74,95,94,348,合格
20022219,82,66,23,79,66,316,合格
20022220,1,93,27,48,22,191,不合格
20022221,37,22,90,26,0,175,不合格
20022222,16,21,85,35,97,254,不合格
20022223,32,5,23,60,56,176,不合格
20022224,93,27,74,45,72,311,合格
20022225,54,89,74,23,54,294,不合格
20022226,98,39,4,13,48,202,不合格
20022227,25,65,18,59,83,250,不合格
20022228,63,93,49,79,51,335,合格
20022229,20,0,35,26,65,146,不合格
20022230,1,93,43,92,37,266,不合格
20022231,68,7,17,3,40,135,不合格
20022232,86,6,59,90,69,310,合格
20022233,57,96,18,81,93,345,合格
20022234,13,7,57,61,1,139,不合格
20022235,11,18,74,62,28,193,不合格
20022236,20,6,74,72,8,180,不合格
20022237,33,94,80,51,94,352,合格
20022238,57,59,94,5,23,238,不合格
20022239,69,66,40,4,22,201,不合格
20022240,9,70,22,5,35,141,不合格
20022241,61,71,8,4,85,229,不合格
20022242,40,57,70,21,76,264,不合格
20022243,56,1,54,10,68,189,不合格
20022244,90,63,95,80,24,352,合格
20022245,99,63,20,56,3,241,不合格
20022246,25,5,9,65,79,183,不合格
20022247,58,67,44,99,66,334,合格
20022248,5,49,18,52,67,191,不合格
20022249,51,21,40,95,12,219,不合格
20022250,72,22,98,1,64,257,不合格
20022251,57,67,51,97,17,289,不合格
20022252,39,20,50,51,39,199,不合格
20022253,95,99,51,69,32,346,合格
20022254,81,95,66,71,9,322,合格
20022255,57,22,78,63,69,289,不合格
20022256,73,46,24,64,43,250,不合格
20022257,81,34,46,13,58,232,不合格
20022258,72,30,64,97,60,323,合格
20022259,25,15,86,81,3,210,不合格
20022260,37,29,52,35,59,212,不合格
20022261,54,47,14,48,19,182,不合格
20022262,46,50,32,83,84,295,不合格
20022263,78,20,54,41,14,207,不合格
20022264,20,65,45,60,4,194,不合格
20022265,63,16,25,48,51,203,不合格
20022266,49,24,48,9,93,223,不合格
20022267,11,2,29,32,73,147,不合格
20022268,97,91,71,15,33,307,合格
20022269,45,7,95,73,44,264,不合格
20022270,80,66,76,38,44,304,合格
20022271,67,68,38,47,45,265,不合格
20022272,82,55,21,33,53,244,不合格
20022273,74,51,25,33,95,278,不合格
20022274,0,28,99,52,14,193,不合格
20022275,68,89,26,50,69,302,合格
20022276,47,59,62,57,27,252,不合格
20022277,33,53,46,92,97,321,合格
20022278,29,29,88,7,90,243,不合格
20022279,87,33,51,53,87,311,合格
20022280,0,99,73,86,11,269,不合格
20022281,0,80,3,97,43,223,不合格
20022282,18,75,93,27,66,279,不合格
20022283,86,23,42,12,72,235,不合格
20022284,38,26,60,0,39,163,不合格
20022285,82,82,14,99,85,362,合格
20022286,68,3,89,15,78,253,不合格
20022287,18,14,21,9,73,135,不合格
20022288,55,26,43,77,26,227,不合格
20022289,67,10,66,4,8,155,不合格
20022290,91,56,89,92,59,387,合格
20022291,30,36,26,46,56,194,不合格
20022292,3,41,58,34,8,144,不合格
20022293,64,10,17,48,16,155,不合格
20022294,91,40,97,76,18,322,合格
20022295,41,59,76,46,64,286,不合格
20022296,94,96,82,16,77,365,合格
20022297,65,91,99,4,54,313,合格
20022298,84,12,10,32,13,151,不合格
20022299,19,63,41,90,50,263,不合格
20022300,93,0,76,91,73,333,合格
20022301,40,7,97,36,29,209,不合格
20022302,24,68,38,16,20,166,不合格
20022303,84,52,5,42,78,261,不合格
20022304,19,45,15,40,20,139,不合格
20022305,87,49,37,83,73,329,合格
20022306,92,24,45,55,0,216,不合格
20022307,54,58,17,82,55,266,不合格
20022308,95,71,84,42,96,388,合格
20022309,67,19,75,86,95,342,合格
20022310,65,98,88,53,79,383,合格
20022311,47,83,37,61,15,243,不合格
20022312,61,96,18,28,26,229,不合格
20022313,36,79,94,98,45,352,合格
20022314,14,88,96,92,54,344,合格
20022315,32,83,35,81,98,329,合格
20022316,39,4,5,10,32,90,不合格
20022317,88,59,52,33,95,327,合格
20022318,70,14,35,9,86,214,不合格
20022319,74,90,52,59,77,352,合格
20022320,47,34,40,22,4,147,不合格
20022321,79,16,6,36,84,221,不合格
20022322,90,13,21,52,87,263,不合格
20022323,85,52,74,20,98,329,合格
20022324,28,6,61,21,5,121,不合格
20022325,95,37,47,95,8,282,不合格
20022326,79,93,74,77,32,355,合格
20022327,7,84,34,78,19,222,不合格
20022328,30,27,14,10,79,160,不合格
20022329,42,19,86,43,2,192,不合格
20022330,1,4,52,40,65,162,不合格
20022331,93,17,97,99,36,342,合格
20022332,2,91,50,64,82,289,不合格
20022333,89,56,63,78,25,311,合格
20022334,43,1,87,15,13,159,不合格
20022335,21,34,32,88,81,256,不合格
20022336,45,69,75,38,30,257,不合格
20022337,10,56,72,1,93,232,不合格
20022338,45,78,10,63,83,279,不合格
20022339,84,37,67,96,90,374,合格
20022340,54,4,30,80,39,207,不合格
20022341,90,34,78,24,42,268,不合格
20022342,97,93,75,12,98,375,合格
20022343,59,7,42,8,10,126,不合格
20022344,12,81,66,78,18,255,不合格
20022345,30,11,63,97,18,219,不合格
20022346,91,77,67,46,40,321,合格
20022347,73,77,62,36,1,249,不合格
20022348,66,45,40,86,58,295,不合格
20022349,68,20,58,2,33,181,不合格
20022350,92,89,8,54,92,335,合格
20022351,38,12,54,19,29,152,不合格
20022352,73,60,12,26,88,259,不合格
20022353,43,23,67,58,84,275,不合格
20022354,70,4,42,99,6,221,不合格
20022355,14,31,67,27,89,228,不合格
20022356,59,85,2,66,1,213,不合格
20022357,78,11,56,38,92,275,不合格
20022358,44,27,21,95,51,238,不合格
20022359,26,68,0,63,65,222,不合格
20022360,31,14,59,5,68,177,不合格
20022361,29,81,25,82,1,218,不合格
20022362,84,21,77,31,1,214,不合格
20022363,41,51,58,83,80,313,合格
20022364,71,86,28,50,33,268,不合格
20022365,12,43,22,42,6,125,不合格
20022366,40,2,42,84,17,185,不合格
20022367,84,99,91,47,42,363,合格
20022368,8,58,2,61,83,212,不合格
20022369,75,28,25,36,78,242,不合格
20022370,60,17,74,46,70,267,不合格
20022371,75,94,85,32,43,329,合格
20022372,7,75,15,68,71,236,不合格
20022373,97,54,35,63,40,289,不合格
20022374,34,57,84,38,18,231,不合格
20022375,65,68,60,85,67,345,合格
20022376,35,16,39,25,15,130,不合格
20022377,18,71,32,78,50,249,不合格
20022378,59,30,75,94,25,283,不合格
20022379,90,16,1,23,56,186,不合格
20022380,95,64,5,63,96,323,合格
20022381,2,7,32,2,36,79,不合格
20022382,61,57,94,59,30,301,合格
20022383,5,50,35,65,40,195,不合格
20022384,90,80,12,68,23,273,不合格
20022385,36,48,86,55,15,240,不合格
20022386,12,15,5,20,0,52,不合格
20022387,8,83,56,12,27,186,不合格
20022388,78,18,36,95,22,249,不合格
20022389,17,80,39,68,58,262,不合格
20022390,80,61,22,82,79,324,合格
20022391,26,47,18,72,10,173,不合格
20022392,87,20,89,19,3,218,不合格
20022393,76,43,71,33,12,235,不合格
20022394,77,48,56,25,70,276,不合格
20022395,80,43,41,86,23,273,不合格
20022396,25,37,81,20,79,242,不合格
20022397,28,88,91,42,26,275,不合格
20022398,58,79,7,85,37,266,不合格
20022399,1,91,95,11,52,250,不合格
20022400,6,52,52,68,82,260,不合格
20022401,66,65,21,93,34,279,不合格
20022402,99,21,36,69,35,260,不合格
20022403,8,91,86,75,5,265,不合格
20022404,27,66,81,37,49,260,不合格
20022405,20,35,38,7,45,145,不合格
20022406,48,96,23,37,78,282,不合格
20022407,88,29,32,95,35,279,不合格
20022408,16,77,91,13,25,222,不合格
20022409,87,81,88,41,87,384,合格
20022410,0,13,93,40,21,167,不合格
20022411,70,98,65,1,62,296,不合格
20022412,81,19,15,90,31,236,不合格
20022413,31,27,32,20,85,195,不合格
20022414,73,66,80,79,18,316,合格
20022415,38,67,0,17,44,166,不合格
20022416,41,59,31,25,84,240,不合格
20022417,66,76,24,10,83,259,不合格
20022418,4,49,28,89,27,197,不合格
20022419,39,44,21,73,31,208,不合格
20022420,93,43,65,93,6,300,合格
20022421,79,2,31,20,38,170,不合格
20022422,49,0,94,57,4,204,不合格
20022423,35,55,33,95,4,222,不合格
20022424,91,35,76,27,96,325,合格
20022425,77,35,92,4,11,219,不合格
20022426,69,81,95,71,96,412,合格
20022427,53,95,98,15,78,339,合格
20022428,38,51,4,97,34,224,不合格
20022429,1,41,27,9,80,158,不合格
20022430,26,52,6,17,81,182,不合格
20022431,18,52,39,26,67,202,不合格
20022432,34,18,54,14,7,127,不合格
20022433,37,94,38,34,50,253,不合格
20022434,37,11,92,28,58,226,不合格
20022435,60,2,57,30,96,245,不合格
20022436,5,92,89,5,33,224,不合格
20022437,55,65,60,30,1,211,不合格
20022438,72,43,56,38,80,289,不合格
20022439,9,25,32,69,39,174,不合格
20022440,1,11,50,1,0,63,不合格
20022441,79,4,92,67,74,316,合格
20022442,18,96,47,13,31,205,不合格
20022443,64,28,65,40,10,207,不合格
20022444,13,49,8,97,82,249,不合格
20022445,62,34,87,97,18,298,不合格
20022446,20,12,30,77,78,217,不合格
20022447,52,15,60,64,21,212,不合格
20022448,57,85,12,3,3,160,不合格
20022449,43,48,41,46,11,189,不合格
20022450,62,38,68,14,68,250,不合格
20022451,28,86,89,4,9,216,不合格
20022452,92,42,43,41,73,291,不合格
20022453,0,17,62,95,93,267,不合格
20022454,25,32,76,38,93,264,不合格
20022455,58,16,66,40,9,189,不合格
20022456,99,0,45,22,44,210,不合格
20022457,88,31,55,79,73,326,合格
20022458,70,20,13,50,43,196,不合格
20022459,89,8,1,15,99,212,不合格
20022460,17,23,45,34,18,137,不合格
20022461,42,88,4,11,92,237,不合格
20022462,29,28,81,50,96,284,不合格
20022463,32,96,3,84,93,308,合格
20022464,1,93,37,29,69,229,不合格
20022465,78,32,20,83,29,242,不合格
20022466,69,36,99,75,92,371,合格
20022467,92,4,18,49,13,176,不合格
20022468,91,95,30,98,74,388,合格
20022469,80,30,29,64,7,210,不合格
20022470,41,93,77,96,21,328,合格
20022471,12,18,22,82,11,145,不合格
20022472,87,11,14,50,9,171,不合格
20022473,6,28,89,81,0,204,不合格
20022474,5,19,22,81,96,223,不合格
20022475,25,47,2,88,14,176,不合格
20022476,89,67,1,2,19,178,不合格
20022477,70,3,11,21,10,115,不合格
20022478,76,90,6,72,78,322,合格
20022479,9,8,23,89,96,225,不合格
20022480,61,8,56,72,56,253,不合格
20022481,59,49,54,69,44,275,不合格
20022482,98,12,76,59,50,295,不合格
20022483,93,76,77,23,53,322,合格
20022484,59,45,88,12,12,216,不合格
20022485,24,83,11,72,89,279,不合格
20022486,2,38,89,86,34,249,不合格
20022487,65,63,25,96,57,306,合格
20022488,21,62,12,14,59,168,不合格
20022489,68,64,40,71,26,269,不合格
20022490,63,81,99,88,33,364,合格
20022491,33,37,13,66,57,206,不合格
20022492,35,15,40,20,35,145,不合格
20022493,55,44,1,48,2,150,不合格
20022494,21,86,78,71,0,256,不合格
20022495,7,70,17,20,87,201,不合格
20022496,43,17,21,39,40,160,不合格
20022497,28,67,21,97,29,242,不合格
20022498,49,18,17,40,84,208,不合格
20022499,19,82,2,97,38,238,不合格
20022500,0,53,86,2,90,231,不合格
20022501,5,82,12,56,8,163,不合格
20022502,58,31,62,59,83,293,不合格
20022503,3,77,22,71,73,246,不合格
20022504,34,37,33,10,64,178,不合格
20022505,25,40,63,42,65,235,不合格
20022506,87,87,96,85,98,453,合格
20022507,87,22,86,17,89,301,合格
20022508,22,98,17,40,61,238,不合格
20022509,83,52,74,22,80,311,合格
20022510,19,46,12,74,85,236,不合格
20022511,28,78,15,88,22,231,不合格
20022512,70,76,37,30,85,298,不合格
20022513,42,3,57,65,10,177,不合格
20022514,83,52,79,70,83,367,合格
20022515,69,56,65,51,40,281,不合格
20022516,20,22,62,5,48,157,不合格
20022517,72,45,42,92,8,259,不合格
20022518,32,87,87,63,59,328,合格
20022519,65,25,31,39,46,206,不合格
20022520,18,11,89,45,38,201,不合格
20022521,38,7,49,86,82,262,不合格
20022522,70,75,96,13,50,304,合格
20022523,12,12,46,78,97,245,不合格
20022524,51,97,56,99,57,360,合格
20022525,89,30,4,34,8,165,不合格
20022526,71,69,22,82,2,246,不合格
20022527,39,5,17,70,24,155,不合格
20022528,23,97,77,12,33,242,不合格
20022529,43,26,61,56,91,277,不合格
20022530,69,0,27,9,73,178,不合格
20022531,31,9,72,73,36,221,不合格
20022532,31,2,41,10,42,126,不合格
20022533,2,43,67,51,66,229,不合格
20022534,66,51,5,19,46,187,不合格
20022535,65,71,19,51,82,288,不合格
20022536,41,85,83,72,48,329,合格
20022537,53,39,96,72,75,335,合格
20022538,81,40,81,12,84,298,不合格
20022539,58,44,35,39,68,244,不合格
20022540,8,96,72,83,36,295,不合格
20022541,80,52,91,34,87,344,合格
20022542,2,54,28,95,51,230,不合格
20022543,32,27,20,9,44,132,不合格
20022544,35,55,39,55,82,266,不合格
20022545,3,86,28,79,72,268,不合格
20022546,16,98,50,45,57,266,不合格
20022547,19,91,5,71,96,282,不合格
20022548,67,88,66,43,57,321,合格
20022549,31,64,78,34,37,244,不合格
20022550,86,41,90,57,81,355,合格
20022551,89,20,83,50,92,334,合格
20022552,51,78,62,83,5,279,不合格
20022553,47,48,50,33,22,200,不合格
20022554,61,64,59,30,28,242,不合格
20022555,10,1,19,53,4,87,不合格
20022556,92,91,19,25,94,321,合格
20022557,53,52,8,11,45,169,不合格
20022558,39,62,22,87,45,255,不合格
20022559,23,97,92,49,54,315,合格
20022560,2,88,1,36,78,205,不合格
20022561,66,67,77,43,41,294,不合格
20022562,84,92,0,33,24,233,不合格
20022563,36,19,62,50,58,225,不合格
20022564,45,83,94,40,90,352,合格
20022565,15,87,62,54,61,279,不合格
20022566,52,48,22,1,67,190,不合格
20022567,49,26,92,81,56,304,合格
20022568,83,18,21,49,83,254,不合格
20022569,16,43,48,23,49,179,不合格
20022570,88,97,70,93,57,405,合格
20022571,79,0,25,33,29,166,不合格
20022572,29,17,78,8,5,137,不合格
20022573,53,88,5,16,12,174,不合格
20022574,32,28,48,83,63,254,不合格
20022575,50,56,51,21,99,277,不合格
20022576,15,41,44,44,10,154,不合格
20022577,52,98,52,68,39,309,合格
20022578,34,70,7,21,6,138,不合格
20022579,6,75,27,10,17,135,不合格
20022580,63,68,55,16,93,295,不合格
20022581,50,53,78,72,53,306,合格
20022582,8,95,86,4,32,225,不合格
20022583,39,34,85,5,62,225,不合格
20022584,25,48,35,32,56,196,不合格
20022585,76,67,10,96,78,327,合格
20022586,14,64,92,94,45,309,合格
20022587,63,56,50,85,99,353,合格
20022588,14,59,20,91,19,203,不合格
20022589,4,92,78,4,92,270,不合格
20022590,52,73,42,25,96,288,不合格
20022591,10,59,22,71,30,192,不合格
20022592,30,81,74,74,6,265,不合格
20022593,53,48,64,12,78,255,不合格
20022594,80,75,11,43,60,269,不合格
20022595,89,29,38,94,28,278,不合格
20022596,98,69,2,41,32,242,不合格
20022597,90,57,74,50,86,357,合格
20022598,65,74,38,57,24,258,不合格
20022599,42,15,73,5,53,188,不合格
20022600,62,41,49,45,33,230,不合格
20022601,26,78,61,0,2,167,不合格
20022602,91,21,91,10,54,267,不合格
20022603,76,45,37,83,63,304,合格
20022604,34,19,84,93,16,246,不合格
20022605,90,89,48,83,95,405,合格
20022606,9,86,20,31,1,147,不合格
20022607,21,38,99,96,53,307,合格
20022608,78,33,67,19,69,266,不合格
20022609,4,99,13,10,40,166,不合格
20022610,27,80,69,58,25,259,不合格
20022611,61,44,61,17,40,223,不合格
20022612,82,62,43,5,51,243,不合格
20022613,53,53,1,74,87,268,不合格
20022614,7,81,99,80,11,278,不合格
20022615,71,97,23,0,26,217,不合格
20022616,71,14,75,29,13,202,不合格
20022617,89,68,23,46,92,318,合格
20022618,26,21,17,42,94,200,不合格
20022619,92,53,76,24,48,293,不合格
20022620,0,30,84,5,78,197,不合格
20022621,41,93,64,94,56,348,合格
20022622,50,10,3,29,27,119,不合格
20022623,46,2,3,81,92,224,不合格
20022624,49,70,53,36,81,289,不合格
20022625,25,97,74,70,35,301,合格
20022626,8,15,69,67,92,251,不合格
20022627,69,8,14,76,92,259,不合格
20022628,8,62,67,81,55,273,不合格
20022629,16,83,89,40,89,317,合格
20022630,25,4,21,84,6,140,不合格
20022631,90,22,18,7,79,216,不合格
20022632,82,2,92,17,30,223,不合格
20022633,99,65,80,57,46,347,合格
20022634,49,34,78,36,4,201,不合格
20022635,61,50,25,69,14,219,不合格
20022636,12,27,68,41,88,236,不合格
20022637,2,27,90,34,42,195,不合格
20022638,60,53,2,3,96,214,不合格
20022639,66,7,70,4,43,190,不合格
20022640,27,38,75,55,80,275,不合格
20022641,52,37,50,75,70,284,不合格
20022642,7,96,73,5,14,195,不合格
20022643,10,96,62,42,66,276,不合格
20022644,19,41,42,92,17,211,不合格
20022645,21,21,50,75,97,264,不合格
20022646,66,2,10,13,55,146,不合格
20022647,79,26,24,0,45,174,不合格
20022648,68,59,87,86,40,340,合格
20022649,43,72,45,46,96,302,合格
20022650,34,91,81,68,70,344,合格
20022651,89,24,60,93,73,339,合格
20022652,0,91,49,52,82,274,不合格
20022653,10,71,43,23,92,239,不合格
20022654,34,25,58,2,73,192,不合格
20022655,88,56,90,58,95,387,合格
20022656,94,70,99,7,38,308,合格
20022657,72,34,8,97,91,302,合格
20022658,52,0,80,97,1,230,不合格
20022659,75,75,54,79,26,309,合格
20022660,34,7,63,56,82,242,不合格
20022661,10,39,45,89,85,268,不合格
20022662,89,21,53,97,59,319,合格
20022663,64,24,98,93,38,317,合格
20022664,22,36,80,26,7,171,不合格
20022665,46,23,39,53,4,165,不合格
20022666,49,32,69,48,86,284,不合格
20022667,62,81,80,96,28,347,合格
20022668,97,71,30,60,64,322,合格
20022669,50,51,54,54,58,267,不合格
20022670,47,48,43,36,6,180,不合格
20022671,21,82,39,16,73,231,不合格
20022672,88,20,26,74,11,219,不合格
20022673,39,96,39,80,85,339,合格
20022674,34,35,33,60,57,219,不合格
20022675,48,18,19,33,50,168,不合格
20022676,82,90,80,86,10,348,合格
20022677,63,34,46,52,64,259,不合格
20022678,21,90,11,8,72,202,不合格
20022679,19,66,31,3,23,142,不合格
20022680,49,87,73,84,70,363,合格
20022681,89,21,44,16,79,249,不合格
20022682,54,66,24,95,30,269,不合格
20022683,92,49,82,94,39,356,合格
20022684,90,60,40,54,40,284,不合格
20022685,43,77,31,89,11,251,不合格
20022686,12,42,10,35,13,112,不合格
20022687,9,43,28,78,25,183,不合格
20022688,46,68,31,71,98,314,合格
20022689,9,70,79,15,79,252,不合格
20022690,13,33,94,9,71,220,不合格
20022691,68,68,12,48,86,282,不合格
20022692,78,91,3,89,96,357,合格
20022693,77,67,84,51,64,343,合格
20022694,0,62,52,94,83,291,不合格
20022695,55,52,7,43,92,249,不合格
20022696,30,22,82,70,71,275,不合格
20022697,45,29,54,12,11,151,不合格
20022698,3,69,68,70,47,257,不合格
20022699,58,57,46,12,9,182,不合格
20022700,77,0,46,70,42,235,不合格
20022701,96,94,56,20,58,324,合格
20022702,72,11,77,73,0,233,不合格
20022703,95,38,3,27,32,195,不合格
20022704,25,23,77,12,28,165,不合格
20022705,47,98,94,62,61,362,合格
20022706,31,41,12,45,31,160,不合格
20022707,79,32,87,71,34,303,合格
20022708,21,87,51,68,3,230,不合格
20022709,79,82,14,36,13,224,不合格
20022710,94,77,66,61,45,343,合格
20022711,33,2,6,32,20,93,不合格
20022712,7,92,77,42,54,272,不合格
20022713,65,93,37,0,65,260,不合格
20022714,11,82,69,28,41,231,不合格
20022715,20,11,88,41,64,224,不合格
20022716,60,41,8,84,15,208,不合格
20022717,5,95,70,52,26,248,不合格
20022718,98,68,80,78,14,338,合格
20022719,65,6,39,82,3,195,不合格
20022720,5,94,30,38,49,216,不合格
20022721,72,44,60,84,6,266,不合格
20022722,51,48,38,4,80,221,不合格
20022723,34,16,40,57,5,152,不合格
20022724,0,89,34,65,84,272,不合格
20022725,73,39,45,34,20,211,不合格
20022726,43,59,50,35,20,207,不合格
20022727,69,58,18,3,89,237,不合格
20022728,44,43,97,85,55,324,合格
20022729,58,49,57,30,67,261,不合格
20022730,50,39,49,53,65,256,不合格
20022731,41,11,93,31,97,273,不合格
20022732,20,6,74,94,5,199,不合格
20022733,86,95,46,35,16,278,不合格
20022734,76,0,89,18,86,269,不合格
20022735,24,35,49,75,15,198,不合格
20022736,71,86,36,54,71,318,合格
20022737,59,40,61,93,62,315,合格
20022738,36,61,38,93,13,241,不合格
20022739,91,30,76,63,25,285,不合格
20022740,64,84,55,10,72,285,不合格
20022741,72,90,62,18,3,245,不合格
20022742,61,34,18,67,91,271,不合格
20022743,25,72,46,36,44,223,不合格
20022744,50,26,11,62,50,199,不合格
20022745,17,74,56,30,34,211,不合格
20022746,40,60,78,92,49,319,合格
20022747,63,77,75,25,15,255,不合格
20022748,64,90,63,15,66,298,不合格
20022749,4,49,25,41,30,149,不合格
20022750,77,70,10,1,21,179,不合格
20022751,65,68,2,39,70,244,不合格
20022752,2,25,0,81,30,138,不合格
20022753,41,13,10,91,43,198,不合格
20022754,63,85,59,21,36,264,不合格
20022755,31,9,85,6,78,209,不合格
20022756,90,35,85,66,87,363,合格
20022757,86,81,27,93,69,356,合格
20022758,25,5,75,16,53,174,不合格
20022759,74,86,68,90,67,385,合格
20022760,35,9,77,79,50,250,不合格
20022761,56,63,62,57,49,287,不合格
20022762,88,16,19,91,30,244,不合格
20022763,35,67,57,32,47,238,不合格
20022764,85,73,62,71,38,329,合格
20022765,97,11,21,2,38,169,不合格
20022766,54,80,82,9,16,241,不合格
20022767,87,46,19,27,18,197,不合格
20022768,52,64,65,74,58,313,合格
20022769,62,55,39,97,12,265,不合格
20022770,98,23,96,41,53,311,合格
20022771,40,80,55,23,73,271,不合格
20022772,99,86,17,72,24,298,不合格
20022773,27,52,44,9,57,189,不合格
20022774,35,21,39,15,86,196,不合格
20022775,12,90,89,37,55,283,不合格
20022776,23,25,66,40,54,208,不合格
20022777,4,10,83,89,14,200,不合格
20022778,43,2,8,27,83,163,不合格
20022779,50,97,54,98,53,352,合格
20022780,61,42,8,47,86,244,不合格
20022781,62,7,86,90,69,314,合格
20022782,12,50,68,34,75,239,不合格
20022783,16,90,95,1,37,239,不合格
20022784,63,93,28,76,99,359,合格
20022785,70,57,33,38,11,209,不合格
20022786,42,76,50,33,38,239,不合格
20022787,71,65,36,73,44,289,不合格
20022788,44,49,76,60,38,267,不合格
20022789,97,78,5,16,83,279,不合格
20022790,23,20,90,93,99,325,合格
20022791,19,13,84,95,16,227,不合格
20022792,65,94,79,47,9,294,不合格
20022793,46,63,32,97,81,319,合格
20022794,99,9,83,55,85,331,合格
20022795,23,36,48,92,49,248,不合格
20022796,9,71,89,81,72,322,合格
20022797,27,28,87,95,29,266,不合格
20022798,7,64,85,46,27,229,不合格
20022799,83,54,7,26,30,200,不合格
20022800,84,18,70,81,32,285,不合格
20022801,44,32,24,78,62,240,不合格
20022802,96,35,54,20,91,296,不合格
20022803,53,36,70,99,82,340,合格
20022804,34,0,15,6,10,65,不合格
20022805,11,3,80,95,21,210,不合格
20022806,51,71,56,85,20,283,不合格
20022807,21,12,97,67,34,231,不合格
20022808,82,69,98,81,75,405,合格
20022809,37,71,91,24,18,241,不合格
20022810,70,4,64,17,42,197,不合格
20022811,55,55,98,26,61,295,不合格
20022812,45,7,36,30,2,120,不合格
20022813,92,53,79,33,80,337,合格
20022814,77,82,71,35,21,286,不合格
20022815,81,26,18,81,8,214,不合格
20022816,17,80,94,21,18,230,不合格
20022817,76,29,37,92,94,328,合格
20022818,83,53,35,24,91,286,不合格
20022819,28,94,83,85,27,317,合格
20022820,20,83,6,27,97,233,不合格
20022821,28,78,51,63,24,244,不合格
20022822,1,11,25,45,5,87,不合格
20022823,92,74,83,77,19,345,合格
20022824,90,3,95,67,76,331,合格
20022825,2,69,35,27,41,174,不合格
20022826,42,60,95,53,91,341,合格
20022827,36,6,99,55,95,291,不合格
20022828,16,18,59,9,1,103,不合格
20022829,63,68,55,44,77,307,合格
20022830,84,61,44,5,67,261,不合格
20022831,83,20,59,43,81,286,不合格
20022832,31,76,79,71,83,340,合格
20022833,42,84,14,98,24,262,不合格
20022834,93,64,99,95,54,405,合格
20022835,15,26,50,2,77,170,不合格
20022836,32,97,95,68,41,333,合格
20022837,55,71,22,30,93,271,不合格
20022838,13,70,58,22,44,207,不合格
20022839,38,90,12,62,10,212,不合格
20022840,40,17,70,7,65,199,不合格
20022841,88,33,96,40,79,336,合格
20022842,6,64,36,88,17,211,不合格
20022843,76,21,19,46,98,260,不合格
20022844,21,43,17,86,99,266,不合格
20022845,50,48,70,29,20,217,不合格
20022846,23,33,42,13,89,200,不合格
20022847,72,76,84,11,74,317,合格
20022848,18,63,43,28,55,207,不合格
20022849,77,11,41,18,47,194,不合格
20022850,79,42,79,13,64,277,不合格
20022851,39,99,58,17,40,253,不合格
20022852,95,6,37,79,59,276,不合格
20022853,54,31,7,0,32,124,不合格
20022854,19,65,64,3,64,215,不合格
20022855,39,62,63,64,74,302,合格
20022856,48,6,69,5,88,216,不合格
20022857,1,28,42,86,73,230,不合格
20022858,85,7,29,7,9,137,不合格
20022859,97,56,88,54,55,350,合格
20022860,31,44,66,24,94,259,不合格
20022861,56,65,41,62,57,281,不合格
20022862,27,48,65,84,48,272,不合格
20022863,87,28,29,31,95,270,不合格
20022864,11,27,54,50,80,222,不合格
20022865,22,30,84,89,31,256,不合格
20022866,97,48,54,83,85,367,合格
20022867,98,88,23,98,56,363,合格
20022868,76,19,81,92,53,321,合格
20022869,25,26,85,75,85,296,不合格
20022870,15,49,78,32,42,216,不合格
20022871,52,40,55,10,23,180,不合格
20022872,48,58,0,78,43,227,不合格
20022873,62,70,94,70,32,328,合格
20022874,52,11,30,76,88,257,不合格
20022875,41,35,53,70,23,222,不合格
20022876,18,52,4,67,7,148,不合格
20022877,26,60,98,82,80,346,合格
20022878,76,1,35,83,69,264,不合格
20022879,24,87,72,84,27,294,不合格
20022880,22,20,24,67,38,171,不合格
20022881,11,9,49,97,85,251,不合格
20022882,60,42,81,84,17,284,不合格
20022883,89,11,57,17,5,179,不合格
20022884,69,8,22,25,28,152,不合格
20022885,6,65,34,92,24,221,不合格
20022886,85,9,92,18,56,260,不合格
20022887,85,64,79,48,48,324,合格
20022888,66,3,41,74,5,189,不合格
20022889,30,34,87,24,63,238,不合格
20022890,5,0,40,18,18,81,不合格
20022891,71,32,43,46,84,276,不合格
20022892,19,93,55,55,37,259,不合格
20022893,8,73,81,69,46,277,不合格
20022894,68,52,8,8,38,174,不合格
20022895,95,98,58,84,89,424,合格
20022896,55,31,21,38,19,164,不合格
20022897,61,95,30,41,60,287,不合格
20022898,5,45,76,0,29,155,不合格
20022899,40,40,53,59,3,195,不合格
20022900,65,88,54,93,94,394,合格
20022901,64,33,14,72,41,224,不合格
20022902,54,33,5,7,63,162,不合格
20022903,63,41,29,70,52,255,不合格
20022904,15,39,0,36,70,160,不合格
20022905,89,12,8,0,31,140,不合格
20022906,63,90,37,93,10,293,不合格
20022907,86,71,29,23,75,284,不合格
20022908,25,36,49,38,82,230,不合格
20022909,27,25,62,92,24,230,不合格
20022910,70,24,20,41,66,221,不合格
20022911,66,95,95,16,12,284,不合格
20022912,78,74,8,81,11,252,不合格
20022913,65,62,82,33,24,266,不合格
20022914,5,11,1,26,90,133,不合格
20022915,76,83,92,44,25,320,合格
20022916,74,91,80,83,11,339,合格
20022917,87,59,5,50,11,212,不合格
20022918,48,2,20,25,81,176,不合格
20022919,33,88,58,3,93,275,不合格
20022920,12,99,32,34,0,177,不合格
20022921,5,22,17,46,57,147,不合格
20022922,22,27,16,64,6,135,不合格
20022923,53,36,2,78,63,232,不合格
20022924,34,99,91,78,81,383,合格
20022925,51,27,29,27,67,201,不合格
20022926,36,57,58,17,53,221,不合格
20022927,57,92,89,92,31,361,合格
20022928,26,72,27,88,48,261,不合格
20022929,42,82,43,40,23,230,不合格
20022930,12,34,3,18,98,165,不合格
20022931,36,47,0,30,13,126,不合格
20022932,94,73,30,1,91,289,不合格
20022933,43,71,67,59,49,289,不合格
20022934,50,59,54,91,80,334,合格
20022935,20,80,51,82,67,300,合格
20022936,1,35,25,86,59,206,不合格
20022937,47,17,49,56,32,201,不合格
20022938,49,2,68,35,24,178,不合格
20022939,43,75,3,24,18,163,不合格
20022940,90,12,60,92,61,315,合格
20022941,43,77,90,95,92,397,合格
20022942,93,41,81,11,98,324,合格
20022943,19,7,60,45,88,219,不合格
20022944,5,96,82,73,75,331,合格
20022945,1,41,56,24,21,143,不合格
20022946,67,86,76,49,50,328,合格
20022947,75,48,1,49,67,240,不合格
20022948,47,73,21,58,92,291,不合格
20022949,81,67,80,13,93,334,合格
20022950,43,34,38,7,62,184,不合格
20022951,68,12,85,25,50,240,不合格
20022952,98,2,27,31,66,224,不合格
20022953,31,6,86,50,51,224,不合格
20022954,56,34,66,1,55,212,不合格
20022955,95,0,50,26,61,232,不合格
20022956,25,77,55,78,48,283,不合格
20022957,30,81,7,98,31,247,不合格
20022958,3,57,28,1,12,101,不合格
20022959,83,60,15,49,6,213,不合格
20022960,36,17,77,1,35,166,不合格
20022961,40,22,32,82,1,177,不合格
20022962,23,19,0,2,21,65,不合格
20022963,93,83,3,42,61,282,不合格
20022964,26,88,1,64,80,259,不合格
20022965,59,62,75,64,18,278,不合格
20022966,14,92,67,8,93,274,不合格
20022967,16,15,63,77,4,175,不合格
20022968,70,45,18,58,90,281,不合格
20022969,79,59,83,92,94,407,合格
20022970,76,71,2,42,55,246,不合格
20022971,11,63,48,93,29,244,不合格
20022972,86,30,8,27,19,170,不合格
20022973,10,74,96,27,39,246,不合格
20022974,10,95,28,43,7,183,不合格
20022975,89,66,38,28,75,296,不合格
20022976,70,50,99,91,0,310,合格
20022977,22,27,88,59,39,235,不合格
20022978,37,1,50,55,86,229,不合格
20022979,7,25,66,52,2,152,不合格
20022980,23,15,72,93,1,204,不合格
20022981,25,0,66,3,0,94,不合格
20022982,48,37,75,6,84,250,不合格
20022983,4,88,91,47,94,324,合格
20022984,26,68,99,62,41,296,不合格
20022985,31,85,66,5,16,203,不合格
20022986,71,64,79,11,86,311,合格
20022987,33,67,51,55,58,264,不合格
20022988,14,68,92,3,29,206,不合格
20022989,29,83,90,48,97,347,合格
20022990,35,25,96,51,19,226,不合格
20022991,4,69,62,12,75,222,不合格
20022992,46,98,61,20,80,305,合格
20022993,84,25,68,3,2,182,不合格
20022994,38,71,59,89,16,273,不合格
20022995,12,52,47,89,85,285,不合格
20022996,88,50,28,91,95,352,合格
20022997,27,29,11,31,70,168,不合格
20022998,85,55,53,86,13,292,不合格
20022999,92,18,98,29,63,300,合格
20023000,3,66,59,8,18,154,不合格
20023001,69,22,96,61,65,313,合格
20023002,43,2,36,50,39,170,不合格
20023003,52,95,87,60,40,334,合格
20023004,39,85,35,5,96,260,不合格
20023005,3,52,50,87,11,203,不合格
20023006,55,27,87,89,55,313,合格
20023007,93,37,61,72,50,313,合格
20023008,39,77,71,38,12,237,不合格
20023009,15,8,55,12,14,104,不合格
20023010,76,25,6,50,42,199,不合格
20023011,96,57,82,66,17,318,合格
20023012,94,5,66,80,34,279,不合格
20023013,87,67,68,74,38,334,合格
20023014,95,53,41,11,39,239,不合格
20023015,77,25,71,41,11,225,不合格
20023016,83,38,86,65,37,309,合格
20023017,20,45,49,33,39,186,不合格
20023018,29,25,57,50,61,222,不合格
20023019,68,20,89,73,95,345,合格
20023020,31,65,40,21,71,228,不合格
20023021,59,78,14,19,19,189,不合格
20023022,61,72,35,72,95,335,合格
20023023,40,65,20,17,15,157,不合格
20023024,94,78,10,7,9,198,不合格
20023025,50,73,50,28,68,269,不合格
20023026,24,93,26,68,37,248,不合格
20023027,64,45,11,69,79,268,不合格
20023028,14,74,45,45,80,258,不合格
20023029,3,31,34,13,29,110,不合格
20023030,19,5,86,91,4,205,不合格
20023031,13,74,7,51,59,204,不合格
20023032,91,9,51,53,50,254,不合格
20023033,95,62,27,49,80,313,合格
20023034,32,70,8,5,96,211,不合格
20023035,73,34,34,3,11,155,不合格
20023036,87,59,22,93,15,276,不合格
20023037,21,69,84,41,3,218,不合格
20023038,33,77,89,46,45,290,不合格
20023039,74,47,2,41,58,222,不合格
20023040,97,41,17,47,5,207,不合格
20023041,13,35,30,46,49,173,不合格
20023042,4,16,89,32,20,161,不合格
20023043,74,49,49,64,52,288,不合格
20023044,23,68,98,91,89,369,合格
20023045,50,43,6,44,47,190,不合格
20023046,96,31,81,35,83,326,合格
20023047,26,22,52,21,45,166,不合格
20023048,20,23,94,17,40,194,不合格
20023049,92,50,39,77,78,336,合格
20023050,79,43,43,39,42,246,不合格
20023051,3,10,50,57,46,166,不合格
20023052,41,28,43,92,45,249,不合格
20023053,53,88,20,79,42,282,不合格
20023054,68,59,28,37,23,215,不合格
20023055,91,34,76,25,87,313,合格
20023056,82,47,83,44,34,290,不合格
20023057,16,31,28,69,38,182,不合格
20023058,79,35,50,61,90,315,合格
20023059,14,13,53,69,93,242,不合格
20023060,0,77,92,2,72,243,不合格
20023061,41,24,81,3,32,181,不合格
20023062,84,26,28,94,97,329,合格
20023063,83,35,40,69,85,312,合格
20023064,17,10,6,63,54,150,不合格
20023065,29,51,57,89,37,263,不合格
20023066,66,4,76,10,53,209,不合格
20023067,83,33,94,63,86,359,合格
20023068,43,74,18,44,22,201,不合格
20023069,84,10,38,79,4,215,不合格
20023070,69,44,10,79,26,228,不合格
20023071,27,49,85,95,5,261,不合格
20023072,32,73,3,92,87,287,不合格
20023073,74,34,40,36,74,258,不合格
20023074,33,50,57,93,99,332,合格
20023075,42,65,12,53,29,201,不合格
20023076,60,20,8,4,17,109,不合格
20023077,36,53,88,83,42,302,合格
20023078,54,93,55,1,39,242,不合格
20023079,9,0,47,97,33,186,不合格
20023080,47,60,13,25,66,211,不合格
20023081,70,8,23,4,37,142,不合格
20023082,50,20,34,98,86,288,不合格
20023083,3,22,65,81,87,258,不合格
20023084,95,31,72,99,82,379,合格
20023085,54,20,26,67,98,265,不合格
20023086,29,10,31,44,4,118,不合格
20023087,17,58,48,97,78,298,不合格
20023088,61,62,67,15,50,255,不合格
20023089,47,18,65,29,64,223,不合格
20023090,21,31,85,57,66,260,不合格
20023091,37,62,75,75,1,250,不合格
20023092,97,30,80,0,22,229,不合格
20023093,2,42,94,38,28,204,不合格
20023094,32,49,85,60,41,267,不合格
20023095,3,65,23,11,0,102,不合格
20023096,1,28,58,55,59,201,不合格
20023097,29,45,96,99,23,292,不合格
20023098,25,92,97,32,17,263,不合格
20023099,27,0,77,22,3,129,不合格
20023100,29,53,85,81,86,334,合格
20023101,43,22,13,45,99,222,不合格
20023102,69,12,11,33,3,128,不合格
20023103,9,66,2,97,44,218,不合格
20023104,48,48,64,93,31,284,不合格
20023105,47,90,48,36,99,320,合格
20023106,45,51,25,93,7,221,不合格
20023107,57,2,85,56,45,245,不合格
20023108,88,3,77,83,82,333,合格
20023109,86,78,93,7,70,334,合格
20023110,2,33,81,36,36,188,不合格
20023111,92,84,83,4,40,303,合格
20023112,18,13,9,56,77,173,不合格
20023113,87,65,46,14,67,279,不合格
20023114,70,4,23,50,24,171,不合格
20023115,23,5,65,55,12,160,不合格
20023116,1,15,67,91,63,237,不合格
20023117,94,51,69,79,76,369,合格
20023118,50,41,26,98,93,308,合格
20023119,22,2,95,43,59,221,不合格
20023120,33,65,99,75,65,337,合格
20023121,12,4,36,70,1,123,不合格
20023122,46,90,8,69,56,269,不合格
20023123,50,83,56,26,57,272,不合格
20023124,9,54,21,70,11,165,不合格
20023125,54,63,14,10,67,208,不合格
20023126,30,11,5,6,14,66,不合格
20023127,96,88,51,82,54,371,合格
20023128,68,70,15,86,86,325,合格
20023129,83,55,87,26,93,344,合格
20023130,57,24,24,5,10,120,不合格
20023131,55,28,82,28,95,288,不合格
20023132,52,95,43,45,68,303,合格
20023133,5,17,83,4,82,191,不合格
20023134,77,1,74,98,97,347,合格
20023135,48,39,75,77,99,338,合格
20023136,49,32,83,32,57,253,不合格
20023137,98,42,35,54,76,305,合格
20023138,95,8,63,48,87,301,合格
20023139,67,14,30,39,63,213,不合格
20023140,65,94,7,25,22,213,不合格
20023141,33,91,14,41,59,238,不合格
20023142,84,69,39,86,35,313,合格
20023143,91,53,50,69,46,309,合格
20023144,96,93,63,80,95,427,合格
20023145,84,33,50,55,94,316,合格
20023146,26,17,86,92,90,311,合格
20023147,24,56,36,30,56,202,不合格
20023148,39,82,72,51,16,260,不合格
20023149,14,57,72,7,87,237,不合格
20023150,41,92,38,94,86,351,合格
20023151,54,64,2,66,96,282,不合格
20023152,47,80,75,83,68,353,合格
20023153,79,86,2,31,7,205,不合格
20023154,52,19,50,22,86,229,不合格
20023155,35,46,67,45,27,220,不合格
20023156,66,55,28,42,40,231,不合格
20023157,2,59,98,47,24,230,不合格
20023158,17,15,69,75,0,176,不合格
20023159,27,63,95,29,83,297,不合格
20023160,29,15,11,61,45,161,不合格
20023161,82,22,84,0,43,231,不合格
20023162,7,69,22,2,52,152,不合格
20023163,63,9,85,53,57,267,不合格
20023164,38,10,55,57,43,203,不合格
20023165,10,80,67,54,16,227,不合格
20023166,4,44,27,87,64,226,不合格
20023167,99,77,98,59,83,416,合格
20023168,90,88,74,59,63,374,合格
20023169,24,40,35,74,62,235,不合格
20023170,74,6,6,87,68,241,不合格
20023171,24,17,6,8,91,146,不合格
20023172,15,81,39,43,28,206,不合格
20023173,84,30,40,42,30,226,不合格
20023174,78,81,70,7,95,331,合格
20023175,69,28,61,85,91,334,合格
20023176,67,71,17,10,34,199,不合格
20023177,22,33,68,49,75,247,不合格
20023178,18,39,10,90,8,165,不合格
20023179,39,48,42,21,89,239,不合格
20023180,80,84,29,12,93,298,不合格
20023181,49,55,62,94,70,330,合格
20023182,11,31,97,24,19,182,不合格
20023183,85,32,67,70,47,301,合格
20023184,6,30,41,49,69,195,不合格
20023185,62,77,61,41,89,330,合格
20023186,47,21,49,95,84,296,不合格
20023187,68,12,72,35,43,230,不合格
20023188,3,1,12,90,46,152,不合格
20023189,93,27,69,15,8,212,不合格
20023190,30,63,27,27,24,171,不合格
20023191,75,4,75,94,62,310,合格
20023192,31,50,64,52,17,214,不合格
20023193,66,92,27,27,22,234,不合格
20023194,10,85,90,80,6,271,不合格
20023195,8,65,66,8,13,160,不合格
20023196,62,8,6,97,47,220,不合格
20023197,85,86,50,68,64,353,合格
20023198,94,71,45,82,83,375,合格
20023199,23,68,65,0,42,198,不合格
20023200,50,8,56,54,42,210,不合格
20023201,73,51,87,60,36,307,合格
20023202,37,87,4,58,16,202,不合格
20023203,43,18,62,38,91,252,不合格
20023204,63,15,79,63,98,318,合格
20023205,11,95,68,13,87,274,不合格
20023206,94,30,2,21,1,148,不合格
20023207,60,48,95,91,69,363,合格
20023208,81,20,76,28,37,242,不合格
20023209,18,15,6,97,3,139,不合格
20023210,82,13,3,39,82,219,不合格
20023211,75,19,42,20,21,177,不合格
20023212,31,16,79,70,58,254,不合格
20023213,76,30,48,36,30,220,不合格
20023214,2,59,25,74,73,233,不合格
20023215,81,85,27,30,90,313,合格
20023216,16,13,39,24,53,145,不合格
20023217,97,44,76,43,24,284,不合格
20023218,42,46,43,16,74,221,不合格
20023219,44,90,15,72,41,262,不合格
20023220,1,13,19,5,7,45,不合格
20023221,49,33,29,29,16,156,不合格
20023222,71,55,28,32,40,226,不合格
20023223,46,93,7,59,26,231,不合格
20023224,4,2,83,19,32,140,不合格
20023225,62,67,28,33,1,191,不合格
20023226,37,27,74,82,5,225,不合格
20023227,80,21,37,27,20,185,不合格
20023228,93,34,39,53,82,301,合格
20023229,65,32,32,37,60,226,不合格
20023230,34,96,54,62,97,343,合格
20023231,37,4,11,44,87,183,不合格
20023232,15,71,70,37,4,197,不合格
20023233,4,61,30,18,71,184,不合格
20023234,46,64,75,37,61,283,不合格
20023235,28,71,0,37,20,156,不合格
20023236,36,16,29,64,61,206,不合格
20023237,2,42,18,24,9,95,不合格
20023238,94,17,87,82,88,368,合格
20023239,14,70,32,95,68,279,不合格
20023240,56,63,80,93,12,304,合格
20023241,58,59,79,12,24,232,不合格
20023242,42,24,32,51,40,189,不合格
20023243,24,22,66,65,47,224,不合格
20023244,12,80,86,80,3,261,不合格
20023245,0,6,60,88,86,240,不合格
20023246,57,89,26,90,33,295,不合格
20023247,64,76,44,30,39,253,不合格
20023248,92,7,17,30,14,160,不合格
20023249,0,96,60,11,22,189,不合格
20023250,38,98,27,61,50,274,不合格
20023251,29,12,31,8,90,170,不合格
20023252,22,67,21,88,2,200,不合格
20023253,59,63,37,59,68,286,不合格
20023254,33,73,9,43,70,228,不合格
20023255,35,35,78,0,55,203,不合格
20023256,57,61,98,96,50,362,合格
20023257,57,75,88,20,83,323,合格
20023258,55,97,91,88,14,345,合格
20023259,33,10,60,7,67,177,不合格
20023260,33,6,33,35,59,166,不合格
20023261,69,66,8,93,57,293,不合格
20023262,48,59,39,40,43,229,不合格
20023263,73,71,24,31,9,208,不合格
20023264,45,94,27,86,89,341,合格
20023265,21,75,91,90,98,375,合格
20023266,53,43,6,39,48,189,不合格
20023267,2,61,46,14,36,159,不合格
20023268,61,31,21,10,13,136,不合格
20023269,71,62,77,91,81,382,合格
20023270,79,54,81,54,14,282,不合格
20023271,63,8,96,33,74,274,不合格
20023272,90,54,81,0,15,240,不合格
20023273,57,86,15,17,41,216,不合格
20023274,40,50,70,95,14,269,不合格
20023275,66,96,40,5,91,298,不合格
20023276,22,34,61,28,13,158,不合格
20023277,26,78,62,91,55,312,合格
20023278,37,59,78,72,12,258,不合格
20023279,23,30,60,92,27,232,不合格
20023280,67,68,54,75,10,274,不合格
20023281,7,88,44,64,10,213,不合格
20023282,6,51,3,99,40,199,不合格
20023283,74,76,14,55,93,312,合格
20023284,13,9,89,72,80,263,不合格
20023285,32,16,72,41,14,175,不合格
20023286,48,22,93,88,70,321,合格
20023287,25,94,44,97,91,351,合格
20023288,21,37,92,71,97,318,合格
20023289,73,63,80,21,40,277,不合格
20023290,29,76,43,39,45,232,不合格
20023291,1,88,23,92,18,222,不合格
20023292,85,7,87,19,91,289,不合格
20023293,80,54,3,40,33,210,不合格
20023294,45,41,42,63,35,226,不合格
20023295,80,79,63,23,17,262,不合格
20023296,60,37,21,63,78,259,不合格
20023297,76,24,47,7,87,241,不合格
20023298,50,17,40,67,79,253,不合格
20023299,60,76,3,76,58,273,不合格
20023300,55,39,29,96,16,235,不合格
20023301,10,97,86,55,11,259,不合格
20023302,66,63,38,52,29,248,不合格
20023303,71,3,39,23,97,233,不合格
20023304,20,17,7,99,48,191,不合格
20023305,24,45,68,23,41,201,不合格
20023306,81,81,2,58,9,231,不合格
20023307,68,37,4,46,35,190,不合格
20023308,6,70,26,78,69,249,不合格
20023309,43,78,41,67,8,237,不合格
20023310,79,70,77,41,17,284,不合格
20023311,3,99,80,36,63,281,不合格
20023312,62,19,64,80,12,237,不合格
20023313,51,36,93,72,68,320,合格
20023314,13,84,72,42,76,287,不合格
20023315,75,71,96,47,65,354,合格
20023316,27,22,74,85,85,293,不合格
20023317,55,32,10,51,73,221,不合格
20023318,11,83,81,25,62,262,不合格
20023319,43,2,62,19,30,156,不合格
20023320,50,93,31,26,84,284,不合格
20023321,14,38,19,64,38,173,不合格
20023322,20,65,63,3,57,208,不合格
20023323,54,73,61,87,40,315,合格
20023324,24,86,12,73,64,259,不合格
20023325,16,95,72,93,7,283,不合格
20023326,13,66,35,41,20,175,不合格
20023327,38,56,46,43,67,250,不合格
20023328,64,74,73,97,97,405,合格
20023329,51,75,28,38,63,255,不合格
20023330,34,52,2,45,59,192,不合格
20023331,48,27,91,33,34,233,不合格
20023332,18,25,24,57,60,184,不合格
20023333,17,11,27,56,94,205,不合格
20023334,74,29,1,23,70,197,不合格
20023335,99,98,42,24,8,271,不合格
20023336,18,27,80,7,70,202,不合格
20023337,10,79,63,60,82,294,不合格
20023338,81,0,57,40,8,186,不合格
20023339,87,80,67,34,10,278,不合格
20023340,18,27,51,43,73,212,不合格
20023341,48,14,59,50,15,186,不合格
20023342,13,42,77,41,75,248,不合格
20023343,78,61,85,78,60,362,合格
20023344,82,0,33,36,11,162,不合格
20023345,4,95,82,7,56,244,不合格
20023346,72,41,30,53,6,202,不合格
20023347,31,23,92,41,17,204,不合格
20023348,69,81,29,60,24,263,不合格
20023349,18,6,47,92,28,191,不合格
20023350,94,25,89,2,95,305,合格
20023351,42,13,18,55,99,227,不合格
20023352,13,48,19,48,79,207,不合格
20023353,13,35,25,98,28,199,不合格
20023354,57,93,23,21,37,231,不合格
20023355,19,59,1,29,50,158,不合格
20023356,39,94,33,77,51,294,不合格
20023357,15,62,28,10,12,127,不合格
20023358,76,94,57,60,66,353,合格
20023359,81,69,79,50,98,377,合格
20023360,74,80,43,94,77,368,合格
20023361,8,77,67,16,68,236,不合格
20023362,43,81,94,10,66,294,不合格
20023363,36,76,45,50,90,297,不合格
20023364,55,97,99,96,20,367,合格
20023365,36,82,20,27,70,235,不合格
20023366,31,81,56,6,32,206,不合格
20023367,70,81,52,29,6,238,不合格
20023368,3,16,30,61,11,121,不合格
20023369,61,17,64,67,81,290,不合格
20023370,36,35,14,74,24,183,不合格
20023371,95,72,50,3,88,308,合格
20023372,73,4,61,19,43,200,不合格
20023373,55,14,29,25,83,206,不合格
20023374,25,41,73,25,69,233,不合格
20023375,25,86,96,6,31,244,不合格
20023376,41,85,6,73,10,215,不合格
20023377,13,2,48,48,22,133,不合格
20023378,31,99,75,23,25,253,不合格
20023379,74,49,65,36,15,239,不合格
20023380,71,54,55,22,93,295,不合格
20023381,94,10,17,43,84,248,不合格
20023382,10,93,60,42,16,221,不合格
20023383,45,0,21,95,56,217,不合格
20023384,88,94,4,11,72,269,不合格
20023385,2,7,29,95,79,212,不合格
20023386,98,76,74,71,9,328,合格
20023387,26,11,15,9,87,148,不合格
20023388,98,78,19,36,66,297,不合格
20023389,32,41,63,37,16,189,不合格
20023390,81,86,8,23,97,295,不合格
20023391,64,81,95,73,81,394,合格
20023392,92,12,15,36,0,155,不合格
20023393,53,98,67,60,40,318,合格
20023394,49,91,8,33,28,209,不合格
20023395,79,37,3,55,92,266,不合格
20023396,15,69,81,71,49,285,不合格
20023397,87,89,63,40,75,354,合格
20023398,75,73,86,88,27,349,合格
20023399,69,82,12,24,79,266,不合格
20023400,62,79,34,28,48,251,不合格
20023401,56,68,87,81,26,318,合格
20023402,55,49,63,19,33,219,不合格
20023403,3,89,0,49,19,160,不合格
20023404,78,16,78,30,47,249,不合格
20023405,96,21,91,45,21,274,不合格
20023406,79,47,61,19,38,244,不合格
20023407,60,32,44,93,52,281,不合格
20023408,19,71,47,66,53,256,不合格
20023409,42,77,83,35,60,297,不合格
20023410,38,56,45,90,30,259,不合格
20023411,66,42,76,6,0,190,不合格
20023412,95,75,17,48,20,255,不合格
20023413,30,68,54,60,23,235,不合格
20023414,5,35,90,15,5,150,不合格
20023415,65,64,76,42,77,324,合格
20023416,72,17,18,95,80,282,不合格
20023417,90,67,9,93,64,323,合格
20023418,11,94,4,52,21,182,不合格
20023419,41,50,97,33,89,310,合格
20023420,80,45,34,51,85,295,不合格
20023421,6,22,19,54,54,155,不合格
20023422,32,3,61,30,91,217,不合格
20023423,24,48,71,32,24,199,不合格
20023424,43,63,27,40,31,204,不合格
20023425,94,38,92,65,54,343,合格
20023426,83,43,91,90,19,326,合格
20023427,25,4,69,27,57,182,不合格
20023428,27,38,31,88,32,216,不合格
20023429,94,85,57,36,84,356,合格
20023430,90,78,7,71,2,248,不合格
20023431,14,73,7,52,3,149,不合格
20023432,78,22,30,13,24,167,不合格
20023433,47,85,53,13,14,212,不合格
20023434,41,74,37,72,98,322,合格
20023435,81,79,91,84,17,352,合格
20023436,77,57,94,70,62,360,合格
20023437,46,30,8,13,81,178,不合格
20023438,45,70,69,28,95,307,合格
20023439,33,2,22,67,49,173,不合格
20023440,1,32,47,70,6,156,不合格
20023441,90,91,86,79,7,353,合格
20023442,23,94,9,59,32,217,不合格
20023443,94,61,58,48,13,274,不合格
20023444,5,38,51,82,21,197,不合格
20023445,9,21,90,74,43,237,不合格
20023446,78,45,76,42,87,328,合格
20023447,75,90,81,19,66,331,合格
20023448,56,21,7,41,78,203,不合格
20023449,32,9,11,22,80,154,不合格
20023450,79,55,50,47,12,243,不合格
20023451,68,59,20,55,29,231,不合格
20023452,30,30,44,66,14,184,不合格
20023453,97,50,0,68,36,251,不合格
20023454,3,89,44,40,11,187,不合格
20023455,52,28,41,1,39,161,不合格
20023456,1,14,92,19,89,215,不合格
20023457,88,38,52,86,28,292,不合格
20023458,49,80,0,32,25,186,不合格
20023459,28,18,0,19,25,90,不合格
20023460,33,33,78,24,28,196,不合格
20023461,41,47,35,53,14,190,不合格
20023462,41,83,62,16,87,289,不合格
20023463,66,44,51,17,81,259,不合格
20023464,54,1,43,22,89,209,不合格
20023465,75,96,99,5,75,350,合格
20023466,69,33,15,22,36,175,不合格
20023467,1,74,45,40,54,214,不合格
20023468,40,33,16,41,47,177,不合格
20023469,41,62,71,69,56,299,不合格
20023470,64,18,77,77,60,296,不合格
20023471,66,70,11,62,19,228,不合格
20023472,48,67,11,83,97,306,合格
20023473,98,97,19,84,64,362,合格
20023474,84,75,54,40,83,336,合格
20023475,79,16,33,17,61,206,不合格
20023476,53,91,56,33,45,278,不合格
20023477,28,93,4,7,19,151,不合格
20023478,38,33,94,42,78,285,不合格
20023479,90,7,84,87,25,293,不合格
20023480,15,97,58,13,70,253,不合格
20023481,2,63,93,40,76,274,不合格
20023482,48,42,83,14,19,206,不合格
20023483,64,76,76,25,97,338,合格
20023484,23,69,30,84,47,253,不合格
20023485,3,36,35,18,19,111,不合格
20023486,29,20,46,18,72,185,不合格
20023487,44,47,1,48,36,176,不合格
20023488,92,69,70,73,35,339,合格
20023489,7,14,59,52,64,196,不合格
20023490,12,24,90,86,26,238,不合格
20023491,8,60,31,6,37,142,不合格
20023492,2,0,80,22,85,189,不合格
20023493,95,41,4,11,61,212,不合格
20023494,5,62,59,22,29,177,不合格
20023495,22,75,66,6,10,179,不合格
20023496,83,32,36,98,23,272,不合格
20023497,83,78,38,76,6,281,不合格
20023498,61,9,57,64,43,234,不合格
20023499,45,20,45,78,94,282,不合格
20023500,85,95,73,85,33,371,合格
20023501,19,19,4,3,91,136,不合格
20023502,39,62,21,40,99,261,不合格
20023503,31,22,4,74,32,163,不合格
20023504,14,4,1,81,14,114,不合格
20023505,85,92,6,7,54,244,不合格
20023506,60,48,81,29,90,308,合格
20023507,33,49,24,60,50,216,不合格
20023508,66,61,97,35,50,309,合格
20023509,47,45,79,34,82,287,不合格
20023510,82,15,38,42,37,214,不合格
20023511,65,2,35,73,54,229,不合格
20023512,66,71,28,33,24,222,不合格
20023513,31,67,72,48,11,229,不合格
20023514,96,46,88,23,14,267,不合格
20023515,92,26,88,81,93,380,合格
20023516,38,81,83,51,33,286,不合格
20023517,19,19,9,96,33,176,不合格
20023518,18,79,17,22,80,216,不合格
20023519,99,39,11,17,41,207,不合格
20023520,52,52,20,98,96,318,合格
20023521,3,99,5,15,21,143,不合格
20023522,44,73,34,39,80,270,不合格
20023523,32,76,98,25,33,264,不合格
20023524,16,32,18,7,45,118,不合格
20023525,22,10,9,67,68,176,不合格
20023526,11,94,51,99,12,267,不合格
20023527,87,21,5,9,39,161,不合格
20023528,0,65,4,57,20,146,不合格
20023529,63,15,28,85,21,212,不合格
20023530,99,35,59,38,93,324,合格
20023531,37,54,84,17,55,247,不合格
20023532,90,90,70,88,91,429,合格
20023533,8,30,61,72,52,223,不合格
20023534,78,60,11,95,20,264,不合格
20023535,9,43,25,72,72,221,不合格
20023536,19,90,74,53,3,239,不合格
20023537,85,15,30,60,24,214,不合格
20023538,48,77,63,16,72,276,不合格
20023539,87,51,47,12,91,288,不合格
20023540,0,35,4,32,31,102,不合格
20023541,34,22,79,37,24,196,不合格
20023542,86,56,59,58,49,308,合格
20023543,19,84,91,52,34,280,不合格
20023544,95,31,61,52,34,273,不合格
20023545,48,39,84,71,98,340,合格
20023546,96,14,74,48,87,319,合格
20023547,69,3,2,32,90,196,不合格
20023548,11,38,71,20,30,170,不合格
20023549,13,81,77,78,44,293,不合格
20023550,5,82,88,41,36,252,不合格
20023551,78,39,3,49,20,189,不合格
20023552,97,14,98,22,43,274,不合格
20023553,22,36,89,9,20,176,不合格
20023554,84,41,55,50,96,326,合格
20023555,80,71,83,19,93,346,合格
20023556,91,22,41,93,86,333,合格
20023557,79,35,14,95,31,254,不合格
20023558,58,8,61,79,14,220,不合格
20023559,3,50,82,17,76,228,不合格
20023560,78,96,5,65,94,338,合格
20023561,54,72,22,16,3,167,不合格
20023562,93,94,23,90,60,360,合格
20023563,93,91,36,65,9,294,不合格
20023564,48,1,72,15,86,222,不合格
20023565,15,80,71,33,93,292,不合格
20023566,20,87,13,97,96,313,合格
20023567,72,45,94,90,51,352,合格
20023568,67,88,41,33,44,273,不合格
20023569,80,72,38,44,36,270,不合格
20023570,74,64,83,93,39,353,合格
20023571,30,96,93,17,18,254,不合格
20023572,23,32,45,59,12,171,不合格
20023573,27,32,89,11,40,199,不合格
20023574,38,69,92,60,67,326,合格
20023575,68,72,6,68,49,263,不合格
20023576,40,28,68,70,51,257,不合格
20023577,94,62,5,38,18,217,不合格
20023578,84,95,65,3,3,250,不合格
20023579,8,12,36,73,17,146,不合格
20023580,56,51,87,0,22,216,不合格
20023581,45,99,35,13,11,203,不合格
20023582,32,73,14,61,56,236,不合格
20023583,87,10,80,99,39,315,合格
20023584,51,14,24,32,43,164,不合格
20023585,40,40,15,12,81,188,不合格
20023586,46,0,55,22,53,176,不合格
20023587,43,70,24,87,51,275,不合格
20023588,79,44,39,66,7,235,不合格
20023589,85,53,35,1,32,206,不合格
20023590,41,74,68,50,67,300,合格
20023591,54,35,19,71,22,201,不合格
20023592,76,12,85,57,39,269,不合格
20023593,65,78,77,63,15,298,不合格
20023594,93,96,16,60,17,282,不合格
20023595,3,70,10,81,72,236,不合格
20023596,4,70,88,77,36,275,不合格
20023597,87,85,42,71,3,288,不合格
20023598,85,71,68,47,8,279,不合格
20023599,49,40,6,91,51,237,不合格
20023600,62,18,63,92,71,306,合格
20023601,97,61,86,43,60,347,合格
20023602,27,7,39,36,74,183,不合格
20023603,59,78,38,49,68,292,不合格
20023604,49,73,11,42,35,210,不合格
20023605,16,79,6,31,19,151,不合格
20023606,25,66,44,53,94,282,不合格
20023607,53,89,91,28,53,314,合格
20023608,18,56,3,90,20,187,不合格
20023609,96,82,35,85,54,352,合格
20023610,89,28,70,21,95,303,合格
20023611,53,45,62,49,71,280,不合格
20023612,58,25,29,2,69,183,不合格
20023613,13,80,7,61,65,226,不合格
20023614,51,91,86,90,68,386,合格
20023615,65,11,48,28,32,184,不合格
20023616,77,38,28,24,33,200,不合格
20023617,97,56,42,52,28,275,不合格
20023618,99,97,52,57,5,310,合格
20023619,0,63,71,50,84,268,不合格
20023620,80,17,63,13,30,203,不合格
20023621,57,32,48,30,24,191,不合格
20023622,41,51,57,0,24,173,不合格
20023623,15,68,83,40,7,213,不合格
20023624,32,93,49,40,51,265,不合格
20023625,54,2,31,70,12,169,不合格
20023626,14,31,57,51,84,237,不合格
20023627,52,54,18,56,14,194,不合格
20023628,48,76,67,6,57,254,不合格
20023629,59,44,97,76,75,351,合格
20023630,11,78,66,6,86,247,不合格
20023631,0,26,81,9,43,159,不合格
20023632,76,25,67,14,22,204,不合格
20023633,25,5,24,27,75,156,不合格
20023634,27,96,13,80,36,252,不合格
20023635,47,18,73,39,29,206,不合格
20023636,93,74,29,48,18,262,不合格
20023637,71,23,82,7,3,186,不合格
20023638,92,90,84,96,19,381,合格
20023639,6,68,81,36,26,217,不合格
20023640,73,76,77,67,81,374,合格
20023641,48,4,32,38,7,129,不合格
20023642,7,13,41,84,0,145,不合格
20023643,82,34,26,23,58,223,不合格
20023644,78,52,74,97,40,341,合格
20023645,64,66,12,78,28,248,不合格
20023646,36,85,93,70,53,337,合格
20023647,4,76,95,67,57,299,不合格
20023648,25,76,79,74,68,322,合格
20023649,11,43,38,89,23,204,不合格
20023650,28,68,19,24,93,232,不合格
20023651,55,87,89,77,80,388,合格
20023652,58,41,47,10,67,223,不合格
20023653,58,18,45,39,40,200,不合格
20023654,39,64,43,51,31,228,不合格
20023655,4,52,88,1,5,150,不合格
20023656,52,74,35,17,86,264,不合格
20023657,58,4,26,17,50,155,不合格
20023658,80,92,44,52,82,350,合格
20023659,82,23,97,48,55,305,合格
20023660,70,47,83,14,36,250,不合格
20023661,93,56,93,23,41,306,合格
20023662,2,49,70,39,56,216,不合格
20023663,11,24,78,25,2,140,不合格
20023664,9,69,46,42,17,183,不合格
20023665,75,50,84,52,77,338,合格
20023666,56,64,84,65,73,342,合格
20023667,25,16,63,9,82,195,不合格
20023668,95,57,36,28,96,312,合格
20023669,71,27,64,83,73,318,合格
20023670,73,98,23,55,74,323,合格
20023671,29,61,17,82,61,250,不合格
20023672,10,50,72,30,51,213,不合格
20023673,70,63,96,97,54,380,合格
20023674,92,24,69,50,70,305,合格
20023675,63,79,4,40,52,238,不合格
20023676,71,76,8,43,94,292,不合格
20023677,29,16,14,66,75,200,不合格
20023678,23,14,5,21,97,160,不合格
20023679,71,41,49,33,26,220,不合格
20023680,23,60,38,49,8,178,不合格
20023681,1,79,81,97,89,347,合格
20023682,93,80,41,70,3,287,不合格
20023683,53,21,97,84,5,260,不合格
20023684,71,89,78,99,23,360,合格
20023685,82,74,84,26,64,330,合格
20023686,80,85,64,80,43,352,合格
20023687,88,92,88,3,12,283,不合格
20023688,80,22,85,86,7,280,不合格
20023689,53,71,47,52,20,243,不合格
20023690,23,64,31,58,33,209,不合格
20023691,18,18,54,28,18,136,不合格
20023692,3,49,68,43,49,212,不合格
20023693,33,32,71,34,18,188,不合格
20023694,66,91,72,37,14,280,不合格
20023695,79,20,3,8,55,165,不合格
20023696,79,88,91,62,32,352,合格
20023697,78,29,90,75,25,297,不合格
20023698,37,21,91,65,0,214,不合格
20023699,14,53,46,4,64,181,不合格
20023700,84,35,8,92,27,246,不合格
20023701,77,86,74,50,18,305,合格
20023702,0,68,44,36,16,164,不合格
20023703,80,55,95,33,32,295,不合格
20023704,77,44,50,34,9,214,不合格
20023705,73,13,24,82,96,288,不合格
20023706,72,20,5,59,55,211,不合格
20023707,93,17,32,22,83,247,不合格
20023708,62,44,53,45,40,244,不合格
20023709,70,8,46,78,58,260,不合格
20023710,65,92,96,13,3,269,不合格
20023711,81,43,91,21,22,258,不合格
20023712,41,59,26,66,40,232,不合格
20023713,75,39,57,90,23,284,不合格
20023714,74,79,67,88,0,308,合格
20023715,69,33,8,17,64,191,不合格
20023716,88,22,95,55,24,284,不合格
20023717,75,11,66,30,66,248,不合格
20023718,42,36,34,4,5,121,不合格
20023719,52,87,38,47,3,227,不合格
20023720,84,75,56,58,31,304,合格
20023721,98,7,61,49,94,309,合格
20023722,24,55,24,27,89,219,不合格
20023723,1,28,72,33,36,170,不合格
20023724,20,89,65,90,61,325,合格
20023725,18,85,68,19,49,239,不合格
20023726,25,98,6,15,88,232,不合格
20023727,86,21,13,87,90,297,不合格
20023728,75,73,31,98,67,344,合格
20023729,57,38,98,26,62,281,不合格
20023730,50,69,31,48,45,243,不合格
20023731,13,95,69,76,23,276,不合格
20023732,75,50,69,93,99,386,合格
20023733,92,33,18,52,15,210,不合格
20023734,39,38,19,15,60,171,不合格
20023735,51,59,76,13,38,237,不合格
20023736,38,35,90,52,64,279,不合格
20023737,68,26,8,42,39,183,不合格
20023738,90,29,3,63,78,263,不合格
20023739,79,24,66,11,40,220,不合格
20023740,39,77,55,16,97,284,不合格
20023741,87,29,56,38,14,224,不合格
20023742,83,41,65,37,35,261,不合格
20023743,88,62,47,81,67,345,合格
20023744,90,79,98,55,69,391,合格
20023745,70,75,48,8,15,216,不合格
20023746,90,6,36,54,97,283,不合格
20023747,57,74,43,40,2,216,不合格
20023748,3,9,60,86,65,223,不合格
20023749,24,36,10,57,99,226,不合格
20023750,59,26,66,93,47,291,不合格
20023751,89,87,49,9,17,251,不合格
20023752,85,85,99,24,39,332,合格
20023753,82,60,73,19,46,280,不合格
20023754,18,52,36,6,90,202,不合格
20023755,75,86,93,1,54,309,合格
20023756,82,96,87,87,69,421,合格
20023757,21,57,45,55,42,220,不合格
20023758,65,13,14,94,96,282,不合格
20023759,8,41,73,75,41,238,不合格
20023760,89,42,76,68,45,320,合格
20023761,16,80,31,7,69,203,不合格
20023762,40,0,40,69,47,196,不合格
20023763,45,81,39,45,47,257,不合格
20023764,86,55,90,17,97,345,合格
20023765,80,52,13,17,88,250,不合格
20023766,64,26,72,49,88,299,不合格
20023767,35,97,59,37,39,267,不合格
20023768,32,73,21,60,54,240,不合格
20023769,18,12,97,15,50,192,不合格
20023770,61,98,57,65,8,289,不合格
20023771,51,63,8,55,50,227,不合格
20023772,52,25,78,61,99,315,合格
20023773,90,85,62,40,68,345,合格
20023774,63,31,33,67,78,272,不合格
20023775,60,60,55,54,76,305,合格
20023776,52,3,38,55,22,170,不合格
20023777,33,14,84,41,93,265,不合格
20023778,36,89,1,46,56,228,不合格
20023779,53,17,24,47,59,200,不合格
20023780,16,91,70,79,94,350,合格
20023781,23,79,33,92,3,230,不合格
20023782,58,55,13,91,60,277,不合格
20023783,40,25,16,40,11,132,不合格
20023784,47,87,21,47,58,260,不合格
20023785,53,23,95,79,52,302,合格
20023786,44,83,20,54,34,235,不合格
20023787,95,76,9,50,7,237,不合格
20023788,4,58,90,64,5,221,不合格
20023789,20,89,64,5,47,225,不合格
20023790,90,55,84,67,66,362,合格
20023791,15,8,39,91,68,221,不合格
20023792,61,73,47,86,1,268,不合格
20023793,16,99,65,31,74,285,不合格
20023794,83,96,56,57,88,380,合格
20023795,5,73,19,66,23,186,不合格
20023796,56,52,23,26,21,178,不合格
20023797,60,25,25,83,56,249,不合格
20023798,60,78,3,24,36,201,不合格
20023799,30,88,47,48,30,243,不合格
20023800,43,89,19,51,87,289,不合格
20023801,26,77,92,20,21,236,不合格
20023802,70,81,84,81,36,352,合格
20023803,71,81,38,4,21,215,不合格
20023804,27,19,72,2,55,175,不合格
20023805,50,14,82,66,40,252,不合格
20023806,46,13,72,8,98,237,不合格
20023807,29,9,59,32,8,137,不合格
20023808,33,26,95,62,0,216,不合格
20023809,39,12,9,15,74,149,不合格
20023810,14,19,6,47,23,109,不合格
20023811,51,42,49,81,56,279,不合格
20023812,35,94,35,49,79,292,不合格
20023813,81,64,11,79,31,266,不合格
20023814,48,15,91,60,99,313,合格
20023815,68,7,11,91,1,178,不合格
20023816,53,48,91,74,37,303,合格
20023817,82,84,31,81,90,368,合格
20023818,23,20,8,89,3,143,不合格
20023819,63,79,78,7,68,295,不合格
20023820,40,70,26,45,18,199,不合格
20023821,80,74,66,46,69,335,合格
20023822,43,40,25,78,98,284,不合格
20023823,99,68,3,30,4,204,不合格
20023824,67,31,37,39,26,200,不合格
20023825,47,11,61,49,58,226,不合格
20023826,59,98,62,1,82,302,合格
20023827,52,2,27,20,29,130,不合格
20023828,37,83,41,47,31,239,不合格
20023829,91,3,15,75,85,269,不合格
20023830,54,36,63,84,62,299,不合格
20023831,38,2,51,90,47,228,不合格
20023832,47,95,60,81,73,356,合格
20023833,9,9,48,0,15,81,不合格
20023834,47,1,17,51,18,134,不合格
20023835,13,40,77,95,87,312,合格
20023836,4,35,31,22,40,132,不合格
20023837,61,34,67,98,95,355,合格
20023838,52,98,28,65,10,253,不合格
20023839,39,49,29,14,29,160,不合格
20023840,34,1,58,90,61,244,不合格
20023841,35,42,9,43,0,129,不合格
20023842,61,13,10,27,70,181,不合格
20023843,44,29,29,63,16,181,不合格
20023844,63,21,59,95,10,248,不合格
20023845,93,40,83,64,57,337,合格
20023846,21,83,28,32,98,262,不合格
20023847,8,46,53,89,53,249,不合格
20023848,82,4,91,66,9,252,不合格
20023849,44,88,35,31,41,239,不合格
20023850,81,45,88,52,99,365,合格
20023851,11,70,89,32,87,289,不合格
20023852,99,69,83,94,45,390,合格
20023853,56,12,8,48,88,212,不合格
20023854,50,28,77,4,73,232,不合格
20023855,36,86,44,17,76,259,不合格
20023856,41,89,43,69,90,332,合格
20023857,67,68,18,35,10,198,不合格
20023858,94,29,75,5,41,244,不合格
20023859,85,19,28,91,52,275,不合格
20023860,98,2,6,79,1,186,不合格
20023861,67,46,63,49,59,284,不合格
20023862,13,61,17,97,48,236,不合格
20023863,73,19,20,56,21,189,不合格
20023864,7,97,73,40,63,280,不合格
20023865,83,75,61,49,89,357,合格
20023866,65,58,73,64,47,307,合格
20023867,78,23,30,28,49,208,不合格
20023868,49,4,45,59,61,218,不合格
20023869,76,16,42,26,57,217,不合格
20023870,96,32,35,55,67,285,不合格
20023871,31,6,93,67,52,249,不合格
20023872,29,93,1,13,26,162,不合格
20023873,94,47,0,6,64,211,不合格
20023874,23,12,61,81,17,194,不合格
20023875,33,20,71,20,15,159,不合格
20023876,35,98,24,36,20,213,不合格
20023877,51,47,90,30,25,243,不合格
20023878,11,4,60,3,51,129,不合格
20023879,74,60,24,29,17,204,不合格
20023880,48,10,88,83,67,296,不合格
20023881,14,82,98,35,6,235,不合格
20023882,3,16,43,97,18,177,不合格
20023883,46,29,91,66,65,297,不合格
20023884,20,97,59,65,58,299,不合格
20023885,55,39,47,12,92,245,不合格
20023886,8,11,28,11,39,97,不合格
20023887,12,13,72,47,63,207,不合格
20023888,65,96,39,27,55,282,不合格
20023889,62,43,32,23,83,243,不合格
20023890,10,15,76,53,0,154,不合格
20023891,59,21,11,29,88,208,不合格
20023892,45,61,21,69,41,237,不合格
20023893,61,11,56,18,76,222,不合格
20023894,88,72,94,20,17,291,不合格
20023895,4,73,85,51,83,296,不合格
20023896,96,50,17,35,23,221,不合格
20023897,40,76,89,55,38,298,不合格
20023898,53,77,75,69,81,355,合格
20023899,6,65,11,78,95,255,不合格
20023900,76,6,42,87,72,283,不合格
20023901,33,75,83,80,55,326,合格
20023902,38,58,40,35,72,243,不合格
20023903,84,69,12,35,88,288,不合格
20023904,79,9,67,11,81,247,不合格
20023905,93,71,17,64,52,297,不合格
20023906,97,28,47,0,33,205,不合格
20023907,39,62,77,51,32,261,不合格
20023908,74,43,48,76,35,276,不合格
20023909,49,57,29,87,55,277,不合格
20023910,47,3,32,92,95,269,不合格
20023911,5,88,89,42,11,235,不合格
20023912,95,26,59,34,15,229,不合格
20023913,47,29,22,47,18,163,不合格
20023914,66,90,35,84,60,335,合格
20023915,30,69,76,54,76,305,合格
20023916,96,33,71,11,21,232,不合格
20023917,11,40,83,50,36,220,不合格
20023918,67,13,85,77,66,308,合格
20023919,7,30,46,48,17,148,不合格
20023920,57,97,63,21,0,238,不合格
20023921,25,20,65,45,82,237,不合格
20023922,67,17,25,73,78,260,不合格
20023923,99,78,86,89,51,403,合格
20023924,75,33,67,99,39,313,合格
20023925,52,43,81,57,66,299,不合格
20023926,59,74,41,21,19,214,不合格
20023927,90,40,54,62,13,259,不合格
20023928,70,66,6,19,28,189,不合格
20023929,10,21,76,78,35,220,不合格
20023930,76,55,70,5,36,242,不合格
20023931,80,65,46,51,9,251,不合格
20023932,95,5,95,55,54,304,合格
20023933,57,39,11,69,59,235,不合格
20023934,15,9,30,15,19,88,不合格
20023935,61,84,89,73,44,351,合格
20023936,34,69,64,38,91,296,不合格
20023937,67,56,88,22,6,239,不合格
20023938,67,60,78,70,59,334,合格
20023939,20,78,99,29,59,285,不合格
20023940,6,86,49,20,51,212,不合格
20023941,98,0,16,13,79,206,不合格
20023942,28,11,48,89,90,266,不合格
20023943,70,11,91,77,38,287,不合格
20023944,52,96,36,27,10,221,不合格
20023945,85,77,81,52,37,332,合格
20023946,21,50,63,46,93,273,不合格
20023947,30,21,60,66,54,231,不合格
20023948,36,38,43,67,30,214,不合格
20023949,20,60,15,57,51,203,不合格
20023950,42,73,84,10,93,302,合格
20023951,28,11,68,56,71,234,不合格
20023952,10,59,82,76,52,279,不合格
20023953,33,54,87,30,63,267,不合格
20023954,77,50,23,92,1,243,不合格
20023955,68,66,11,43,71,259,不合格
20023956,68,47,79,18,27,239,不合格
20023957,65,62,94,1,26,248,不合格
20023958,20,52,61,35,65,233,不合格
20023959,14,61,64,19,59,217,不合格
20023960,31,5,30,21,27,114,不合格
20023961,9,38,5,64,37,153,不合格
20023962,91,99,37,28,26,281,不合格
20023963,3,18,97,41,36,195,不合格
20023964,29,39,95,28,14,205,不合格
20023965,3,1,53,44,44,145,不合格
20023966,24,3,45,4,39,115,不合格
20023967,67,71,11,56,68,273,不合格
20023968,33,81,76,10,74,274,不合格
20023969,30,23,26,85,37,201,不合格
20023970,8,34,41,2,65,150,不合格
20023971,70,70,1,68,59,268,不合格
20023972,50,93,4,45,11,203,不合格
20023973,69,56,16,42,53,236,不合格
20023974,11,34,25,23,72,165,不合格
20023975,41,33,78,52,55,259,不合格
20023976,1,38,73,82,38,232,不合格
20023977,13,78,6,84,91,272,不合格
20023978,76,2,70,72,36,256,不合格
20023979,42,33,34,88,48,245,不合格
20023980,75,56,60,59,18,268,不合格
20023981,37,0,69,11,31,148,不合格
20023982,50,38,97,36,46,267,不合格
20023983,61,61,1,13,28,164,不合格
20023984,97,4,28,72,12,213,不合格
20023985,47,87,64,34,99,331,合格
20023986,65,22,7,78,73,245,不合格
20023987,34,46,64,45,95,284,不合格
20023988,10,52,96,21,19,198,不合格
20023989,47,56,51,57,83,294,不合格
20023990,99,19,0,3,31,152,不合格
20023991,83,80,96,84,66,409,合格
20023992,65,14,22,92,6,199,不合格
20023993,97,74,8,25,78,282,不合格
20023994,47,70,90,16,96,319,合格
20023995,66,10,50,28,74,228,不合格
20023996,2,16,25,45,67,155,不合格
20023997,24,98,89,4,19,234,不合格
20023998,38,61,24,1,98,222,不合格
20023999,26,32,30,81,85,254,不合格
20024000,40,29,78,2,54,203,不合格
20024001,58,30,98,53,72,311,合格
20024002,74,80,57,9,35,255,不合格
20024003,6,39,21,74,69,209,不合格
20024004,58,17,74,56,73,278,不合格
20024005,51,1,4,65,25,146,不合格
20024006,7,45,26,43,32,153,不合格
20024007,70,49,23,73,43,258,不合格
20024008,17,15,29,75,42,178,不合格
20024009,50,5,21,97,89,262,不合格
20024010,17,43,92,13,63,228,不合格
20024011,85,7,66,83,99,340,合格
20024012,30,40,34,79,49,232,不合格
20024013,60,83,21,59,71,294,不合格
20024014,69,77,73,39,43,301,合格
20024015,64,13,15,1,78,171,不合格
20024016,37,72,65,86,8,268,不合格
20024017,73,29,67,43,88,300,合格
20024018,86,70,50,35,95,336,合格
20024019,20,45,25,12,11,113,不合格
20024020,56,99,87,38,0,280,不合格
20024021,63,77,6,58,12,216,不合格
20024022,0,87,13,93,9,202,不合格
20024023,21,9,45,3,80,158,不合格
20024024,79,5,5,78,16,183,不合格
20024025,42,2,90,32,15,181,不合格
20024026,54,68,42,3,76,243,不合格
20024027,89,15,99,99,16,318,合格
20024028,80,56,92,83,23,334,合格
20024029,59,24,50,20,67,220,不合格
20024030,26,56,71,99,13,265,不合格
20024031,43,20,18,76,26,183,不合格
20024032,45,29,12,76,71,233,不合格
20024033,67,89,43,4,52,255,不合格
20024034,97,6,94,30,91,318,合格
20024035,88,72,37,9,40,246,不合格
20024036,85,7,40,45,17,194,不合格
20024037,97,19,76,61,78,331,合格
20024038,8,28,43,96,64,239,不合格
20024039,1,62,78,37,27,205,不合格
20024040,19,62,93,22,85,281,不合格
20024041,8,76,85,24,73,266,不合格
20024042,60,1,7,86,13,167,不合格
20024043,24,50,10,20,32,136,不合格
20024044,6,14,92,5,54,171,不合格
20024045,57,77,88,9,32,263,不合格
20024046,54,70,75,30,92,321,合格
20024047,39,16,17,84,10,166,不合格
20024048,95,60,3,53,18,229,不合格
20024049,48,91,80,10,11,240,不合格
20024050,58,48,94,72,58,330,合格
20024051,50,20,43,45,14,172,不合格
20024052,55,54,71,80,52,312,合格
20024053,47,95,46,62,35,285,不合格
20024054,78,6,44,36,1,165,不合格
20024055,74,52,35,3,4,168,不合格
20024056,81,0,32,18,56,187,不合格
20024057,88,47,22,99,55,311,合格
20024058,97,53,80,42,98,370,合格
20024059,79,93,7,64,36,279,不合格
20024060,5,49,19,31,46,150,不合格
20024061,16,72,88,4,77,257,不合格
20024062,9,36,2,22,88,157,不合格
20024063,5,70,67,83,9,234,不合格
20024064,2,4,44,38,24,112,不合格
20024065,16,38,94,4,58,210,不合格
20024066,81,24,71,84,15,275,不合格
20024067,78,90,46,91,35,340,合格
20024068,33,14,33,93,90,263,不合格
20024069,99,97,80,90,46,412,合格
20024070,83,76,59,4,99,321,合格
20024071,48,9,34,28,65,184,不合格
20024072,94,98,42,63,72,369,合格
20024073,16,25,43,82,12,178,不合格
20024074,31,97,34,36,54,252,不合格
20024075,22,80,21,8,94,225,不合格
20024076,85,79,35,76,44,319,合格
20024077,20,29,28,13,10,100,不合格
20024078,37,59,22,86,22,226,不合格
20024079,63,18,96,23,76,276,不合格
20024080,30,76,88,75,59,328,合格
20024081,91,85,66,45,29,316,合格
20024082,4,17,57,46,60,184,不合格
20024083,18,99,10,4,46,177,不合格
20024084,81,5,46,51,6,189,不合格
20024085,46,39,42,26,11,164,不合格
20024086,45,81,1,63,41,231,不合格
20024087,22,97,48,65,1,233,不合格
20024088,51,23,85,52,62,273,不合格
20024089,62,62,18,93,47,282,不合格
20024090,1,9,32,66,52,160,不合格
20024091,70,70,76,37,33,286,不合格
20024092,43,52,6,82,31,214,不合格
20024093,35,87,18,22,61,223,不合格
20024094,70,61,34,30,46,241,不合格
20024095,82,92,7,61,2,244,不合格
20024096,47,71,32,67,59,276,不合格
20024097,85,19,18,49,87,258,不合格
20024098,9,34,35,9,33,120,不合格
20024099,96,55,19,37,82,289,不合格
20024100,79,21,67,46,49,262,不合格
20024101,7,70,89,10,81,257,不合格
20024102,94,0,24,85,16,219,不合格
20024103,71,5,52,61,30,219,不合格
20024104,16,25,1,9,86,137,不合格
20024105,12,66,78,84,68,308,合格
20024106,84,61,38,17,78,278,不合格
20024107,25,97,55,19,87,283,不合格
20024108,38,19,39,78,66,240,不合格
20024109,30,9,95,94,95,323,合格
20024110,70,77,89,21,64,321,合格
20024111,70,93,54,53,88,358,合格
20024112,11,67,64,9,30,181,不合格
20024113,2,64,48,49,8,171,不合格
20024114,39,17,58,12,65,191,不合格
20024115,82,88,72,16,25,283,不合格
20024116,82,1,81,54,12,230,不合格
20024117,35,94,85,3,65,282,不合格
20024118,88,79,60,23,56,306,合格
20024119,44,33,30,86,27,220,不合格
20024120,95,36,81,16,38,266,不合格
20024121,51,94,6,25,34,210,不合格
20024122,18,17,56,93,55,239,不合格
20024123,11,96,93,26,4,230,不合格
20024124,4,63,73,22,0,162,不合格
20024125,75,48,8,11,51,193,不合格
20024126,53,53,44,96,73,319,合格
20024127,12,75,4,44,3,138,不合格
20024128,37,38,59,35,33,202,不合格
20024129,56,77,3,36,43,215,不合格
20024130,24,8,79,82,66,259,不合格
20024131,5,92,5,40,40,182,不合格
20024132,71,96,73,23,23,286,不合格
20024133,67,71,6,78,80,302,合格
20024134,2,31,9,1,62,105,不合格
20024135,53,54,60,32,64,263,不合格
20024136,1,59,45,39,68,212,不合格
20024137,26,9,65,39,82,221,不合格
20024138,50,26,86,91,35,288,不合格
20024139,43,47,69,2,52,213,不合格
20024140,26,6,3,67,36,138,不合格
20024141,93,0,28,26,60,207,不合格
20024142,37,85,77,55,92,346,合格
20024143,71,74,57,58,60,320,合格
20024144,29,21,84,25,21,180,不合格
20024145,48,83,73,41,13,258,不合格
20024146,80,44,11,3,11,149,不合格
20024147,55,67,7,95,38,262,不合格
20024148,91,11,84,47,47,280,不合格
20024149,13,64,86,9,77,249,不合格
20024150,64,69,11,37,83,264,不合格
20024151,62,31,29,37,45,204,不合格
20024152,41,12,22,43,28,146,不合格
20024153,56,25,3,27,51,162,不合格
20024154,10,30,2,76,58,176,不合格
20024155,29,3,84,79,96,291,不合格
20024156,4,62,60,48,84,258,不合格
20024157,72,18,31,77,7,205,不合格
20024158,66,47,48,24,29,214,不合格
20024159,0,39,14,30,24,107,不合格
20024160,11,42,50,15,32,150,不合格
20024161,9,42,79,52,39,221,不合格
20024162,38,12,6,99,3,158,不合格
20024163,68,62,54,1,30,215,不合格
20024164,94,23,59,72,14,262,不合格
20024165,51,21,49,53,97,271,不合格
20024166,96,11,56,0,83,246,不合格
20024167,21,34,0,34,41,130,不合格
20024168,37,17,72,94,21,241,不合格
20024169,60,87,31,83,67,328,合格
20024170,26,6,93,91,70,286,不合格
20024171,23,45,88,62,4,222,不合格
20024172,66,35,89,79,16,285,不合格
20024173,19,44,65,43,82,253,不合格
20024174,48,81,17,88,19,253,不合格
20024175,45,33,54,91,91,314,合格
20024176,70,10,92,44,34,250,不合格
20024177,23,8,29,55,26,141,不合格
20024178,89,79,97,11,34,310,合格
20024179,82,65,24,90,47,308,合格
20024180,10,0,98,51,10,169,不合格
20024181,81,68,68,40,79,336,合格
20024182,44,51,43,38,53,229,不合格
20024183,73,19,5,45,29,171,不合格
20024184,47,70,7,40,60,224,不合格
20024185,35,37,93,26,46,237,不合格
20024186,52,28,1,31,4,116,不合格
20024187,30,61,52,44,41,228,不合格
20024188,70,74,33,85,26,288,不合格
20024189,10,53,85,46,1,195,不合格
20024190,79,81,52,59,42,313,合格
20024191,55,68,68,40,60,291,不合格
20024192,71,40,94,28,1,234,不合格
20024193,39,25,7,37,55,163,不合格
20024194,84,29,48,73,82,316,合格
20024195,95,10,49,41,12,207,不合格
20024196,20,98,38,80,37,273,不合格
20024197,74,4,54,37,24,193,不合格
20024198,67,4,73,66,11,221,不合格
20024199,42,44,28,62,29,205,不合格
20024200,40,75,3,89,81,288,不合格
20024201,11,54,73,26,84,248,不合格
20024202,16,75,42,75,60,268,不合格
20024203,72,37,0,13,83,205,不合格
20024204,47,46,38,56,44,231,不合格
20024205,53,0,12,71,78,214,不合格
20024206,34,32,87,8,26,187,不合格
20024207,17,81,12,20,33,163,不合格
20024208,18,74,73,62,69,296,不合格
20024209,35,26,49,29,61,200,不合格
20024210,45,31,0,74,10,160,不合格
20024211,93,66,41,53,64,317,合格
20024212,73,93,80,46,31,323,合格
20024213,31,60,10,3,3,107,不合格
20024214,26,66,48,40,38,218,不合格
20024215,6,22,96,23,9,156,不合格
20024216,31,58,24,96,83,292,不合格
20024217,8,67,73,61,79,288,不合格
20024218,46,53,59,55,10,223,不合格
20024219,82,99,10,8,44,243,不合格
20024220,85,66,71,81,88,391,合格
20024221,82,83,80,24,31,300,合格
20024222,25,10,91,82,67,275,不合格
20024223,96,91,58,31,3,279,不合格
20024224,95,93,42,97,88,415,合格
20024225,87,42,74,1,27,231,不合格
20024226,32,7,92,31,3,165,不合格
20024227,95,60,90,6,17,268,不合格
20024228,57,57,46,32,67,259,不合格
20024229,72,3,57,23,48,203,不合格
20024230,22,38,12,16,54,142,不合格
20024231,1,57,21,63,3,145,不合格
20024232,52,1,75,88,41,257,不合格
20024233,26,53,54,63,13,209,不合格
20024234,11,41,76,62,13,203,不合格
20024235,5,68,18,13,45,149,不合格
20024236,78,13,29,50,76,246,不合格
20024237,51,56,78,86,34,305,合格
20024238,39,34,19,63,84,239,不合格
20024239,70,81,46,97,20,314,合格
20024240,56,38,32,6,58,190,不合格
20024241,75,99,70,58,16,318,合格
20024242,66,79,70,99,1,315,合格
20024243,0,76,72,51,6,205,不合格
20024244,66,14,27,96,17,220,不合格
20024245,89,13,43,3,1,149,不合格
20024246,99,45,31,93,72,340,合格
20024247,25,52,24,31,43,175,不合格
20024248,72,68,10,36,53,239,不合格
20024249,41,69,64,59,52,285,不合格
20024250,88,57,39,86,67,337,合格
20024251,68,10,53,72,74,277,不合格
20024252,84,28,4,5,27,148,不合格
20024253,97,63,40,7,45,252,不合格
20024254,93,14,65,46,58,276,不合格
20024255,27,78,36,76,46,263,不合格
20024256,84,33,4,89,51,261,不合格
20024257,72,76,86,51,46,331,合格
20024258,60,40,66,99,95,360,合格
20024259,67,37,13,10,8,135,不合格
20024260,23,68,44,92,11,238,不合格
20024261,74,31,11,57,70,243,不合格
20024262,71,68,31,78,38,286,不合格
20024263,39,40,15,48,69,211,不合格
20024264,10,71,31,53,36,201,不合格
20024265,59,99,98,9,58,323,合格
20024266,56,11,17,28,56,168,不合格
20024267,30,95,76,75,45,321,合格
20024268,47,26,73,61,96,303,合格
20024269,75,84,50,55,55,319,合格
20024270,43,10,99,66,67,285,不合格
20024271,87,30,5,33,75,230,不合格
20024272,22,89,90,26,11,238,不合格
20024273,14,60,89,33,16,212,不合格
20024274,88,27,78,95,88,376,合格
20024275,76,41,54,71,47,289,不合格
20024276,96,69,23,46,18,252,不合格
20024277,31,23,77,73,89,293,不合格
20024278,61,7,79,1,45,193,不合格
20024279,51,14,72,16,52,205,不合格
20024280,14,49,57,44,25,189,不合格
20024281,71,58,64,49,42,284,不合格
20024282,33,93,56,0,44,226,不合格
20024283,7,84,24,84,23,222,不合格
20024284,65,98,16,92,52,323,合格
20024285,13,29,16,4,83,145,不合格
20024286,38,32,73,31,22,196,不合格
20024287,36,54,73,0,71,234,不合格
20024288,62,97,40,77,0,276,不合格
20024289,0,45,81,19,4,149,不合格
20024290,14,61,32,9,96,212,不合格
20024291,61,32,53,48,17,211,不合格
20024292,90,84,89,51,11,325,合格
20024293,34,54,91,42,17,238,不合格
20024294,78,67,26,49,44,264,不合格
20024295,33,58,58,39,86,274,不合格
20024296,18,15,25,27,49,134,不合格
20024297,88,49,88,70,89,384,合格
20024298,93,4,37,84,37,255,不合格
20024299,38,50,11,83,53,235,不合格
20024300,19,65,3,7,5,99,不合格
20024301,1,14,66,91,95,267,不合格
20024302,64,29,81,32,87,293,不合格
20024303,1,89,96,19,61,266,不合格
20024304,79,37,69,62,23,270,不合格
20024305,8,39,59,12,34,152,不合格
20024306,23,69,49,46,82,269,不合格
20024307,72,33,85,75,63,328,合格
20024308,86,44,38,73,30,271,不合格
20024309,17,55,19,57,33,181,不合格
20024310,24,64,16,74,8,186,不合格
20024311,66,80,65,65,35,311,合格
20024312,52,23,47,21,21,164,不合格
20024313,88,25,87,60,14,274,不合格
20024314,60,20,95,38,19,232,不合格
20024315,96,91,66,12,30,295,不合格
20024316,12,62,16,74,40,204,不合格
20024317,34,41,10,6,25,116,不合格
20024318,37,45,74,14,80,250,不合格
20024319,84,89,68,99,76,416,合格
20024320,87,65,9,46,11,218,不合格
20024321,78,35,1,44,61,219,不合格
20024322,60,80,82,75,61,358,合格
20024323,59,97,5,97,51,309,合格
20024324,89,83,51,23,23,269,不合格
20024325,45,72,9,24,66,216,不合格
20024326,31,0,88,69,52,240,不合格
20024327,32,57,99,96,69,353,合格
20024328,69,68,72,60,57,326,合格
20024329,86,92,68,37,88,371,合格
20024330,34,21,0,22,97,174,不合格
20024331,63,31,33,57,79,263,不合格
20024332,58,1,85,83,35,262,不合格
20024333,84,52,42,25,42,245,不合格
20024334,17,83,63,18,29,210,不合格
20024335,81,32,33,14,16,176,不合格
20024336,56,39,62,97,33,287,不合格
20024337,76,8,82,91,40,297,不合格
20024338,15,65,68,60,25,233,不合格
20024339,48,68,98,69,81,364,合格
20024340,25,14,48,15,53,155,不合格
20024341,91,89,70,99,61,410,合格
20024342,45,53,11,23,61,193,不合格
20024343,55,11,79,90,6,241,不合格
20024344,85,72,39,16,15,227,不合格
20024345,62,7,16,6,37,128,不合格
20024346,89,10,16,71,59,245,不合格
20024347,84,59,11,3,57,214,不合格
20024348,44,37,94,35,68,278,不合格
20024349,65,64,81,51,9,270,不合格
20024350,23,75,79,83,28,288,不合格
20024351,88,39,70,70,21,288,不合格
20024352,16,78,83,86,12,275,不合格
20024353,5,89,38,17,72,221,不合格
20024354,26,96,46,98,14,280,不合格
20024355,31,78,55,54,38,256,不合格
20024356,69,1,61,37,70,238,不合格
20024357,60,28,93,23,83,287,不合格
20024358,98,71,33,20,48,270,不合格
20024359,18,63,15,19,87,202,不合格
20024360,62,40,35,28,14,179,不合格
20024361,17,61,28,42,83,231,不合格
20024362,59,71,47,37,95,309,合格
20024363,68,47,55,18,97,285,不合格
20024364,0,96,59,84,19,258,不合格
20024365,42,55,51,2,83,233,不合格
20024366,56,26,68,0,36,186,不合格
20024367,48,52,41,14,47,202,不合格
20024368,62,16,7,94,33,212,不合格
20024369,96,11,28,13,81,229,不合格
20024370,72,45,7,20,69,213,不合格
20024371,54,9,33,42,65,203,不合格
20024372,40,49,42,53,47,231,不合格
20024373,4,9,23,36,5,77,不合格
20024374,26,45,87,8,74,240,不合格
20024375,70,8,78,3,60,219,不合格
20024376,77,75,75,31,61,319,合格
20024377,8,71,2,89,2,172,不合格
20024378,4,54,99,97,51,305,合格
20024379,61,40,78,98,15,292,不合格
20024380,79,44,35,96,87,341,合格
20024381,15,7,78,26,46,172,不合格
20024382,78,75,73,68,50,344,合格
20024383,33,66,76,67,0,242,不合格
20024384,86,72,30,44,61,293,不合格
20024385,74,15,15,58,68,230,不合格
20024386,6,94,91,30,34,255,不合格
20024387,96,98,16,92,59,361,合格
20024388,40,3,56,68,28,195,不合格
20024389,49,19,14,16,20,118,不合格
20024390,36,99,9,16,67,227,不合格
20024391,90,68,54,2,47,261,不合格
20024392,27,94,70,99,36,326,合格
20024393,78,41,2,80,39,240,不合格
20024394,90,98,61,83,7,339,合格
20024395,1,88,77,4,86,256,不合格
20024396,99,61,86,22,48,316,合格
20024397,8,67,56,77,66,274,不合格
20024398,62,3,47,48,18,178,不合格
20024399,3,43,30,40,91,207,不合格
20024400,68,17,23,57,71,236,不合格
20024401,31,20,6,2,79,138,不合格
20024402,15,99,68,47,83,312,合格
20024403,80,37,46,66,98,327,合格
20024404,55,42,44,11,59,211,不合格
20024405,90,42,30,76,71,309,合格
20024406,9,95,2,42,10,158,不合格
20024407,88,35,16,62,85,286,不合格
20024408,91,41,96,60,63,351,合格
20024409,89,17,6,30,3,145,不合格
20024410,26,64,92,90,98,370,合格
20024411,53,37,80,19,73,262,不合格
20024412,46,77,23,40,23,209,不合格
20024413,20,15,48,30,83,196,不合格
20024414,74,88,79,52,33,326,合格
20024415,39,12,4,11,83,149,不合格
20024416,76,6,76,29,2,189,不合格
20024417,10,64,77,74,29,254,不合格
20024418,33,55,49,31,22,190,不合格
20024419,18,30,18,88,36,190,不合格
20024420,66,59,63,5,75,268,不合格
20024421,37,63,42,18,42,202,不合格
20024422,21,90,22,72,11,216,不合格
20024423,58,24,7,29,91,209,不合格
20024424,56,53,74,95,28,306,合格
20024425,59,93,93,26,23,294,不合格
20024426,94,96,58,13,80,341,合格
20024427,46,80,53,96,95,370,合格
20024428,45,54,75,3,87,264,不合格
20024429,9,48,44,30,77,208,不合格
20024430,62,52,12,12,0,138,不合格
20024431,72,80,82,24,14,272,不合格
20024432,97,5,77,56,79,314,合格
20024433,85,92,23,24,83,307,合格
20024434,84,66,69,96,53,368,合格
20024435,28,78,42,41,70,259,不合格
20024436,93,58,72,95,67,385,合格
20024437,83,48,46,46,68,291,不合格
20024438,39,83,1,38,82,243,不合格
20024439,52,80,75,65,98,370,合格
20024440,37,26,83,7,18,171,不合格
20024441,97,33,73,20,78,301,合格
20024442,22,50,76,25,82,255,不合格
20024443,40,10,26,27,41,144,不合格
20024444,32,75,8,22,46,183,不合格
20024445,71,72,52,98,34,327,合格
20024446,25,64,95,56,46,286,不合格
20024447,67,70,66,52,11,266,不合格
20024448,47,94,88,42,71,342,合格
20024449,55,71,0,50,90,266,不合格
20024450,89,37,43,63,18,250,不合格
20024451,97,34,76,54,10,271,不合格
20024452,65,59,30,14,57,225,不合格
20024453,57,29,96,12,71,265,不合格
20024454,54,46,67,52,7,226,不合格
20024455,20,1,49,44,34,148,不合格
20024456,72,3,71,43,24,213,不合格
20024457,85,47,63,99,95,389,合格
20024458,84,14,91,25,28,242,不合格
20024459,24,61,67,42,97,291,不合格
20024460,91,15,51,22,1,180,不合格
20024461,59,4,5,31,93,192,不合格
20024462,45,26,21,56,90,238,不合格
20024463,80,37,20,69,45,251,不合格
20024464,78,66,3,54,69,270,不合格
20024465,79,59,40,73,80,331,合格
20024466,77,75,73,4,63,292,不合格
20024467,68,22,72,21,58,241,不合格
20024468,67,94,72,48,10,291,不合格
20024469,0,36,2,98,23,159,不合格
20024470,28,66,36,14,93,237,不合格
20024471,68,37,86,35,2,228,不合格
20024472,10,60,86,16,27,199,不合格
20024473,64,13,25,45,3,150,不合格
20024474,70,15,51,88,1,225,不合格
20024475,80,40,58,30,39,247,不合格
20024476,13,5,60,29,46,153,不合格
20024477,28,97,75,81,87,368,合格
20024478,97,14,82,60,29,282,不合格
20024479,6,87,20,17,98,228,不合格
20024480,30,27,2,95,73,227,不合格
20024481,23,6,75,77,86,267,不合格
20024482,59,46,24,18,1,148,不合格
20024483,40,6,14,64,32,156,不合格
20024484,9,52,5,88,92,246,不合格
20024485,19,60,57,41,30,207,不合格
20024486,10,94,75,90,18,287,不合格
20024487,66,47,34,39,39,225,不合格
20024488,66,64,19,3,68,220,不合格
20024489,33,49,63,90,38,273,不合格
20024490,43,9,34,55,85,226,不合格
20024491,18,71,95,34,87,305,合格
20024492,41,21,21,86,92,261,不合格
20024493,28,19,89,15,12,163,不合格
20024494,16,59,12,40,90,217,不合格
20024495,48,81,93,33,40,295,不合格
20024496,36,63,39,34,45,217,不合格
20024497,58,26,27,97,73,281,不合格
20024498,90,90,66,71,99,416,合格
20024499,70,6,51,90,95,312,合格
20024500,84,9,8,98,60,259,不合格
20024501,47,46,5,74,57,229,不合格
20024502,82,57,34,14,55,242,不合格
20024503,8,64,84,28,29,213,不合格
20024504,30,27,12,48,29,146,不合格
20024505,57,15,61,77,80,290,不合格
20024506,69,15,92,22,82,280,不合格
20024507,66,42,78,89,58,333,合格
20024508,80,16,93,48,60,297,不合格
20024509,63,36,34,37,9,179,不合格
20024510,23,94,45,30,90,282,不合格
20024511,15,0,54,1,17,87,不合格
20024512,51,59,63,58,81,312,合格
20024513,93,0,19,70,86,268,不合格
20024514,56,92,87,98,87,420,合格
20024515,77,27,16,50,11,181,不合格
20024516,84,35,92,86,4,301,合格
20024517,2,68,41,91,82,284,不合格
20024518,39,35,52,41,29,196,不合格
20024519,86,70,18,94,31,299,不合格
20024520,15,85,64,68,95,327,合格
20024521,49,33,99,44,19,244,不合格
20024522,76,65,21,32,89,283,不合格
20024523,31,30,11,93,5,170,不合格
20024524,18,23,59,11,49,160,不合格
20024525,60,58,9,23,97,247,不合格
20024526,99,28,42,93,23,285,不合格
20024527,1,36,40,64,7,148,不合格
20024528,80,1,18,92,25,216,不合格
20024529,14,75,53,12,4,158,不合格
20024530,52,96,16,88,49,301,合格
20024531,89,76,35,1,63,264,不合格
20024532,31,80,25,85,76,297,不合格
20024533,97,16,97,2,71,283,不合格
20024534,87,60,80,54,25,306,合格
20024535,12,16,88,43,22,181,不合格
20024536,32,89,71,76,30,298,不合格
20024537,13,53,73,40,24,203,不合格
20024538,28,8,7,62,27,132,不合格
20024539,23,34,69,98,63,287,不合格
20024540,56,8,73,27,32,196,不合格
20024541,20,12,49,4,74,159,不合格
20024542,92,23,45,7,5,172,不合格
20024543,44,19,31,56,35,185,不合格
20024544,49,89,68,7,89,302,合格
20024545,39,26,41,91,24,221,不合格
20024546,82,72,74,42,88,358,合格
20024547,56,13,98,42,25,234,不合格
20024548,95,19,20,56,66,256,不合格
20024549,42,86,48,28,16,220,不合格
20024550,0,11,91,21,51,174,不合格
20024551,21,88,61,36,10,216,不合格
20024552,79,50,0,78,24,231,不合格
20024553,0,60,2,51,54,167,不合格
20024554,2,26,70,61,48,207,不合格
20024555,72,18,67,62,54,273,不合格
20024556,21,12,26,94,22,175,不合格
20024557,10,71,96,63,95,335,合格
20024558,40,17,87,67,34,245,不合格
20024559,84,35,90,28,4,241,不合格
20024560,2,5,6,28,90,131,不合格
20024561,57,16,10,0,77,160,不合格
20024562,17,9,99,36,11,172,不合格
20024563,44,61,16,51,37,209,不合格
20024564,98,42,83,88,64,375,合格
20024565,36,68,22,16,28,170,不合格
20024566,85,76,10,31,60,262,不合格
20024567,68,33,53,27,77,258,不合格
20024568,35,27,90,29,30,211,不合格
20024569,38,82,67,66,26,279,不合格
20024570,45,97,12,57,36,247,不合格
20024571,93,29,56,84,12,274,不合格
20024572,13,16,11,46,70,156,不合格
20024573,33,24,37,75,72,241,不合格
20024574,75,25,42,56,3,201,不合格
20024575,11,11,55,1,12,90,不合格
20024576,55,10,14,81,43,203,不合格
20024577,38,23,82,37,98,278,不合格
20024578,98,3,55,82,55,293,不合格
20024579,75,59,50,55,35,274,不合格
20024580,27,98,46,57,93,321,合格
20024581,37,7,26,37,70,177,不合格
20024582,97,3,75,88,58,321,合格
20024583,54,44,39,88,97,322,合格
20024584,27,2,6,20,83,138,不合格
20024585,22,88,64,46,69,289,不合格
20024586,68,60,20,4,32,184,不合格
20024587,52,96,92,92,87,419,合格
20024588,72,65,31,47,88,303,合格
20024589,60,17,38,80,74,269,不合格
20024590,71,64,83,37,44,299,不合格
20024591,41,66,37,82,15,241,不合格
20024592,43,68,64,91,90,356,合格
20024593,40,42,2,41,31,156,不合格
20024594,15,66,0,83,88,252,不合格
20024595,99,8,67,67,52,293,不合格
20024596,69,0,82,16,28,195,不合格
20024597,75,67,35,42,82,301,合格
20024598,32,91,35,63,27,248,不合格
20024599,0,6,43,86,52,187,不合格
20024600,35,63,9,76,87,270,不合格
20024601,76,15,0,72,46,209,不合格
20024602,15,56,53,11,6,141,不合格
20024603,84,97,80,24,80,365,合格
20024604,47,25,57,95,0,224,不合格
20024605,92,79,1,99,11,282,不合格
20024606,14,79,62,3,78,236,不合格
20024607,50,47,27,42,19,185,不合格
20024608,52,47,1,59,56,215,不合格
20024609,5,84,7,98,29,223,不合格
20024610,34,6,52,61,35,188,不合格
20024611,72,82,91,23,75,343,合格
20024612,67,7,52,83,89,298,不合格
20024613,80,44,6,28,27,185,不合格
20024614,3,6,64,1,2,76,不合格
20024615,2,24,62,34,5,127,不合格
20024616,97,23,52,68,43,283,不合格
20024617,70,83,55,28,96,332,合格
20024618,37,12,80,48,42,219,不合格
20024619,46,55,15,84,7,207,不合格
20024620,86,47,70,4,36,243,不合格
20024621,4,90,41,5,29,169,不合格
20024622,11,31,16,16,51,125,不合格
20024623,74,40,90,58,14,276,不合格
20024624,90,73,9,82,35,289,不合格
20024625,95,97,49,60,37,338,合格
20024626,37,49,3,63,64,216,不合格
20024627,52,23,21,73,85,254,不合格
20024628,81,82,13,98,95,369,合格
20024629,79,11,92,9,65,256,不合格
20024630,44,69,72,74,25,284,不合格
20024631,72,16,40,53,28,209,不合格
20024632,16,5,79,49,81,230,不合格
20024633,88,65,92,26,69,340,合格
20024634,7,36,38,90,5,176,不合格
20024635,15,43,48,11,27,144,不合格
20024636,53,23,18,9,51,154,不合格
20024637,62,35,57,65,83,302,合格
20024638,61,12,18,52,47,190,不合格
20024639,88,89,64,71,64,376,合格
20024640,7,65,61,77,25,235,不合格
20024641,88,21,80,22,7,218,不合格
20024642,18,3,27,64,33,145,不合格
20024643,35,14,67,63,67,246,不合格
20024644,11,46,45,83,95,280,不合格
20024645,69,87,46,80,29,311,合格
20024646,56,74,62,0,25,217,不合格
20024647,29,87,45,97,3,261,不合格
20024648,44,23,46,87,24,224,不合格
20024649,82,31,43,36,36,228,不合格
20024650,90,98,46,94,58,386,合格
20024651,28,63,30,56,4,181,不合格
20024652,62,36,47,38,32,215,不合格
20024653,38,83,41,39,67,268,不合格
20024654,80,55,4,29,35,203,不合格
20024655,94,99,3,16,69,281,不合格
20024656,42,18,40,96,20,216,不合格
20024657,68,92,20,68,16,264,不合格
20024658,88,93,84,33,34,332,合格
20024659,17,99,72,90,62,340,合格
20024660,64,74,88,86,17,329,合格
20024661,84,29,2,56,3,174,不合格
20024662,17,38,95,79,7,236,不合格
20024663,29,2,43,41,70,185,不合格
20024664,75,28,48,14,66,231,不合格
20024665,14,49,66,34,4,167,不合格
20024666,2,59,23,25,19,128,不合格
20024667,48,39,30,75,97,289,不合格
20024668,9,28,96,31,40,204,不合格
20024669,85,28,13,93,7,226,不合格
20024670,5,92,74,79,8,258,不合格
20024671,26,85,98,2,86,297,不合格
20024672,75,2,93,7,72,249,不合格
20024673,75,13,98,72,70,328,合格
20024674,90,1,5,80,76,252,不合格
20024675,31,11,60,94,24,220,不合格
20024676,79,96,90,5,77,347,合格
20024677,67,35,24,91,91,308,合格
20024678,17,10,2,63,40,132,不合格
20024679,5,47,41,7,53,153,不合格
20024680,68,61,83,86,32,330,合格
20024681,29,92,89,96,95,401,合格
20024682,79,19,5,66,21,190,不合格
20024683,12,52,4,73,39,180,不合格
20024684,64,76,50,92,72,354,合格
20024685,68,43,17,88,66,282,不合格
20024686,15,69,89,51,6,230,不合格
20024687,28,2,42,13,67,152,不合格
20024688,95,24,53,62,47,281,不合格
20024689,81,88,2,83,9,263,不合格
20024690,67,71,6,72,71,287,不合格
20024691,73,83,38,81,24,299,不合格
20024692,64,73,4,21,31,193,不合格
20024693,2,15,13,54,77,161,不合格
20024694,66,93,6,56,98,319,合格
20024695,22,46,15,83,43,209,不合格
20024696,8,11,78,69,2,168,不合格
20024697,79,93,3,15,91,281,不合格
20024698,36,43,56,31,58,224,不合格
20024699,24,13,95,90,37,259,不合格
20024700,95,85,75,51,17,323,合格
20024701,81,38,46,51,65,281,不合格
20024702,6,95,80,31,86,298,不合格
20024703,4,80,75,24,27,210,不合格
20024704,3,71,17,6,37,134,不合格
20024705,61,7,89,74,60,291,不合格
20024706,0,18,94,13,87,212,不合格
20024707,9,44,2,27,19,101,不合格
20024708,9,11,74,22,80,196,不合格
20024709,47,25,71,91,3,237,不合格
20024710,79,49,92,69,76,365,合格
20024711,25,28,65,74,31,223,不合格
20024712,41,59,53,39,99,291,不合格
20024713,60,80,99,43,23,305,合格
20024714,80,40,82,69,26,297,不合格
20024715,34,15,46,71,24,190,不合格
20024716,23,31,73,19,38,184,不合格
20024717,64,28,89,90,65,336,合格
20024718,3,47,50,73,2,175,不合格
20024719,69,12,65,40,29,215,不合格
20024720,6,51,40,38,47,182,不合格
20024721,41,46,86,50,30,253,不合格
20024722,59,4,34,8,58,163,不合格
20024723,25,74,98,94,5,296,不合格
20024724,28,72,19,69,16,204,不合格
20024725,72,48,36,98,23,277,不合格
20024726,48,59,41,71,6,225,不合格
20024727,98,60,68,37,84,347,合格
20024728,58,99,36,10,78,281,不合格
20024729,49,48,35,58,31,221,不合格
20024730,15,40,59,10,80,204,不合格
20024731,29,2,26,57,30,144,不合格
20024732,3,35,1,25,81,145,不合格
20024733,34,78,32,91,40,275,不合格
20024734,5,82,36,57,31,211,不合格
20024735,56,40,16,55,99,266,不合格
20024736,4,38,90,77,77,286,不合格
20024737,55,40,65,30,2,192,不合格
20024738,29,34,94,47,76,280,不合格
20024739,24,72,89,22,94,301,合格
20024740,7,48,75,27,53,210,不合格
20024741,33,15,32,30,84,194,不合格
20024742,27,7,80,4,16,134,不合格
20024743,17,83,33,70,13,216,不合格
20024744,91,80,92,72,14,349,合格
20024745,67,11,84,97,67,326,合格
20024746,61,88,92,69,30,340,合格
20024747,77,61,25,46,87,296,不合格
20024748,93,17,47,6,87,250,不合格
20024749,93,97,97,49,16,352,合格
20024750,31,93,91,75,89,379,合格
20024751,96,29,88,83,15,311,合格
20024752,86,84,62,8,11,251,不合格
20024753,53,12,29,18,91,203,不合格
20024754,62,74,22,94,29,281,不合格
20024755,50,59,38,64,70,281,不合格
20024756,69,76,4,36,30,215,不合格
20024757,99,33,78,29,81,320,合格
20024758,52,89,53,92,94,380,合格
20024759,50,42,7,18,44,161,不合格
20024760,71,13,16,72,28,200,不合格
20024761,88,65,44,56,53,306,合格
20024762,90,99,39,34,19,281,不合格
20024763,43,69,80,4,10,206,不合格
20024764,37,25,18,68,85,233,不合格
20024765,73,36,2,50,68,229,不合格
20024766,5,8,73,45,83,214,不合格
20024767,75,53,73,87,91,379,合格
20024768,8,27,3,63,50,151,不合格
20024769,74,9,80,55,0,218,不合格
20024770,63,45,15,31,39,193,不合格
20024771,29,95,82,63,79,348,合格
20024772,35,70,87,3,51,246,不合格
20024773,58,84,40,98,14,294,不合格
20024774,85,76,57,74,81,373,合格
20024775,37,66,15,78,66,262,不合格
20024776,43,53,46,1,28,171,不合格
20024777,77,26,28,22,22,175,不合格
20024778,87,95,96,39,20,337,合格
20024779,90,24,1,79,93,287,不合格
20024780,69,25,89,78,66,327,合格
20024781,61,89,32,16,85,283,不合格
20024782,0,21,97,92,29,239,不合格
20024783,70,24,83,79,9,265,不合格
20024784,93,90,79,98,71,431,合格
20024785,1,8,65,78,13,165,不合格
20024786,36,46,78,10,92,262,不合格
20024787,5,35,5,26,84,155,不合格
20024788,87,82,16,47,45,277,不合格
20024789,57,41,55,30,32,215,不合格
20024790,99,34,56,83,86,358,合格
20024791,94,49,78,39,16,276,不合格
20024792,55,57,82,92,80,366,合格
20024793,49,87,28,21,10,195,不合格
20024794,86,15,8,78,28,215,不合格
20024795,46,46,42,57,63,254,不合格
20024796,59,24,28,28,68,207,不合格
20024797,92,88,62,76,65,383,合格
20024798,91,4,42,47,88,272,不合格
20024799,1,33,63,45,1,143,不合格
20024800,10,1,2,49,18,80,不合格
20024801,10,62,28,93,23,216,不合格
20024802,8,58,99,13,90,268,不合格
20024803,65,32,88,76,70,331,合格
20024804,78,80,5,69,3,235,不合格
20024805,49,65,85,51,22,272,不合格
20024806,81,51,6,58,81,277,不合格
20024807,32,92,89,21,20,254,不合格
20024808,52,20,90,36,49,247,不合格
20024809,64,77,52,55,40,288,不合格
20024810,65,18,96,59,66,304,合格
20024811,99,88,28,63,52,330,合格
20024812,21,95,99,99,77,391,合格
20024813,57,91,0,9,11,168,不合格
20024814,97,62,56,70,40,325,合格
20024815,76,85,77,89,26,353,合格
20024816,82,89,75,85,89,420,合格
20024817,45,81,29,28,33,216,不合格
20024818,12,30,30,94,20,186,不合格
20024819,25,44,52,50,17,188,不合格
20024820,94,30,52,15,27,218,不合格
20024821,48,57,30,68,48,251,不合格
20024822,87,26,49,96,5,263,不合格
20024823,63,64,60,41,11,239,不合格
20024824,69,41,8,1,55,174,不合格
20024825,10,88,55,59,43,255,不合格
20024826,30,6,35,38,20,129,不合格
20024827,27,53,66,38,2,186,不合格
20024828,42,81,41,55,77,296,不合格
20024829,52,49,83,89,92,365,合格
20024830,78,72,58,79,33,320,合格
20024831,40,82,11,28,15,176,不合格
20024832,28,68,32,14,34,176,不合格
20024833,33,86,48,46,16,229,不合格
20024834,10,58,36,55,33,192,不合格
20024835,30,99,76,80,66,351,合格
20024836,70,44,75,25,26,240,不合格
20024837,45,50,37,21,17,170,不合格
20024838,25,42,52,54,57,230,不合格
20024839,31,41,80,81,11,244,不合格
20024840,49,41,55,42,32,219,不合格
20024841,68,29,75,97,36,305,合格
20024842,9,59,37,84,4,193,不合格
20024843,25,0,51,9,44,129,不合格
20024844,42,85,76,26,13,242,不合格
20024845,62,33,53,8,25,181,不合格
20024846,60,88,48,74,49,319,合格
20024847,74,40,65,87,91,357,合格
20024848,73,47,55,94,45,314,合格
20024849,21,78,87,69,11,266,不合格
20024850,53,19,42,1,96,211,不合格
20024851,61,70,96,31,49,307,合格
20024852,68,22,68,36,17,211,不合格
20024853,35,26,80,43,35,219,不合格
20024854,52,16,46,4,46,164,不合格
20024855,53,27,42,46,84,252,不合格
20024856,20,73,49,38,51,231,不合格
20024857,68,11,8,65,78,230,不合格
20024858,38,55,0,3,86,182,不合格
20024859,52,82,61,74,89,358,合格
20024860,68,76,3,14,45,206,不合格
20024861,76,7,71,34,54,242,不合格
20024862,10,37,73,59,39,218,不合格
20024863,6,67,28,37,27,165,不合格
20024864,77,96,37,67,15,292,不合格
20024865,2,1,2,76,35,116,不合格
20024866,54,13,27,58,35,187,不合格
20024867,27,38,27,50,96,238,不合格
20024868,87,72,1,15,31,206,不合格
20024869,88,51,49,61,57,306,合格
20024870,24,14,0,45,75,158,不合格
20024871,56,75,53,47,12,243,不合格
20024872,75,71,0,17,48,211,不合格
20024873,33,31,4,72,39,179,不合格
20024874,88,24,27,25,15,179,不合格
20024875,44,41,89,19,21,214,不合格
20024876,77,34,4,8,69,192,不合格
20024877,42,28,67,21,37,195,不合格
20024878,35,20,80,94,90,319,合格
20024879,69,90,84,78,85,406,合格
20024880,90,8,14,22,86,220,不合格
20024881,54,63,65,98,62,342,合格
20024882,7,93,17,36,63,216,不合格
20024883,34,17,2,85,77,215,不合格
20024884,93,49,97,70,78,387,合格
20024885,46,61,18,95,59,279,不合格
20024886,0,97,87,43,39,266,不合格
20024887,93,6,95,14,49,257,不合格
20024888,68,79,85,61,46,339,合格
20024889,7,17,89,35,31,179,不合格
20024890,34,79,1,45,61,220,不合格
20024891,1,14,38,77,13,143,不合格
20024892,68,35,14,52,80,249,不合格
20024893,55,90,21,89,5,260,不合格
20024894,53,17,20,95,97,282,不合格
20024895,65,13,23,7,87,195,不合格
20024896,23,73,99,47,79,321,合格
20024897,57,2,8,41,30,138,不合格
20024898,34,2,41,7,74,158,不合格
20024899,26,87,66,84,29,292,不合格
20024900,34,52,37,29,71,223,不合格
20024901,32,18,68,12,70,200,不合格
20024902,95,62,56,82,70,365,合格
20024903,63,53,89,20,28,253,不合格
20024904,60,37,62,55,48,262,不合格
20024905,98,45,67,77,20,307,合格
20024906,52,50,9,10,94,215,不合格
20024907,0,12,47,5,87,151,不合格
20024908,92,77,59,61,73,362,合格
20024909,41,56,81,12,12,202,不合格
20024910,34,58,46,61,79,278,不合格
20024911,1,92,26,83,23,225,不合格
20024912,40,14,93,55,61,263,不合格
20024913,33,8,52,3,7,103,不合格
20024914,77,0,33,24,77,211,不合格
20024915,62,64,87,93,92,398,合格
20024916,70,5,18,45,53,191,不合格
20024917,9,73,76,33,84,275,不合格
20024918,66,72,79,85,83,385,合格
20024919,36,73,61,46,60,276,不合格
20024920,47,16,36,73,97,269,不合格
20024921,86,58,28,90,99,361,合格
20024922,64,82,64,18,95,323,合格
20024923,3,70,23,6,52,154,不合格
20024924,37,91,4,0,6,138,不合格
20024925,67,68,94,94,61,384,合格
20024926,25,69,25,2,74,195,不合格
20024927,68,32,35,97,11,243,不合格
20024928,82,79,70,49,54,334,合格
20024929,10,62,88,10,9,179,不合格
20024930,29,56,19,0,26,130,不合格
20024931,96,35,65,37,20,253,不合格
20024932,83,77,12,8,59,239,不合格
20024933,96,38,88,56,58,336,合格
20024934,7,9,56,97,96,265,不合格
20024935,17,13,47,59,19,155,不合格
20024936,64,44,79,85,78,350,合格
20024937,91,47,20,48,63,269,不合格
20024938,98,20,89,5,1,213,不合格
20024939,11,71,95,83,96,356,合格
20024940,66,74,27,47,63,277,不合格
20024941,20,49,58,49,53,229,不合格
20024942,14,56,22,36,65,193,不合格
20024943,29,44,67,22,60,222,不合格
20024944,83,12,99,55,2,251,不合格
20024945,23,92,76,33,78,302,合格
20024946,70,86,78,65,37,336,合格
20024947,54,37,15,92,12,210,不合格
20024948,23,93,72,5,50,243,不合格
20024949,20,96,32,35,88,271,不合格
20024950,79,57,27,80,14,257,不合格
20024951,99,32,14,91,84,320,合格
20024952,40,24,90,0,79,233,不合格
20024953,26,17,80,91,33,247,不合格
20024954,49,39,24,7,42,161,不合格
20024955,16,89,55,60,68,288,不合格
20024956,84,0,86,98,73,341,合格
20024957,17,36,3,53,14,123,不合格
20024958,26,96,72,55,16,265,不合格
20024959,30,5,88,87,22,232,不合格
20024960,10,96,64,57,88,315,合格
20024961,38,10,94,23,22,187,不合格
20024962,45,96,75,88,52,356,合格
20024963,24,79,6,83,34,226,不合格
20024964,31,30,87,66,64,278,不合格
20024965,21,74,40,91,26,252,不合格
20024966,36,85,85,31,49,286,不合格
20024967,56,81,84,6,55,282,不合格
20024968,1,5,58,51,24,139,不合格
20024969,54,59,7,26,69,215,不合格
20024970,86,79,38,77,84,364,合格
20024971,31,18,10,50,8,117,不合格
20024972,5,19,51,55,57,187,不合格
20024973,54,2,87,97,59,299,不合格
20024974,86,21,94,30,85,316,合格
20024975,82,95,6,67,81,331,合格
20024976,67,5,33,22,23,150,不合格
20024977,43,84,55,82,3,267,不合格
20024978,21,78,8,95,58,260,不合格
20024979,3,95,60,33,44,235,不合格
20024980,70,95,85,31,41,322,合格
20024981,84,59,98,7,26,274,不合格
20024982,82,91,9,26,9,217,不合格
20024983,1,13,5,54,26,99,不合格
20024984,23,54,34,9,0,120,不合格
20024985,90,49,82,11,8,240,不合格
20024986,26,44,92,74,64,300,合格
20024987,12,37,48,89,4,190,不合格
20024988,31,67,13,48,17,176,不合格
20024989,8,16,25,82,85,216,不合格
20024990,97,22,49,87,52,307,合格
20024991,56,32,60,66,34,248,不合格
20024992,25,55,94,37,95,306,合格
20024993,79,29,57,17,47,229,不合格
20024994,7,67,7,19,71,171,不合格
20024995,6,26,24,97,82,235,不合格
20024996,88,36,17,13,79,233,不合格
20024997,98,21,79,32,61,291,不合格
20024998,36,91,34,69,4,234,不合格
20024999,80,8,8,8,83,187,不合格
20025000,34,71,18,0,2,125,不合格
20025001,92,61,54,53,57,317,合格
20025002,1,25,93,17,86,222,不合格
20025003,94,41,89,35,23,282,不合格
20025004,81,26,41,86,86,320,合格
20025005,89,46,82,54,54,325,合格
20025006,92,93,10,43,31,269,不合格
20025007,42,25,75,64,3,209,不合格
20025008,96,69,86,80,86,417,合格
20025009,44,18,5,68,1,136,不合格
20025010,87,12,78,63,71,311,合格
20025011,39,89,69,57,19,273,不合格
20025012,29,84,81,15,79,288,不合格
20025013,31,3,47,44,27,152,不合格
20025014,44,77,50,29,29,229,不合格
20025015,16,13,63,55,9,156,不合格
20025016,57,25,0,74,73,229,不合格
20025017,91,60,50,42,3,246,不合格
20025018,83,99,32,14,7,235,不合格
20025019,90,89,85,91,4,359,合格
20025020,5,74,42,97,91,309,合格
20025021,98,23,0,23,51,195,不合格
20025022,78,11,29,6,82,206,不合格
20025023,13,17,90,65,7,192,不合格
20025024,87,16,55,71,6,235,不合格
20025025,30,81,15,87,50,263,不合格
20025026,11,11,42,24,57,145,不合格
20025027,78,16,60,78,32,264,不合格
20025028,96,88,9,81,5,279,不合格
20025029,46,57,5,43,0,151,不合格
20025030,41,94,23,99,79,336,合格
20025031,16,9,64,35,46,170,不合格
20025032,26,35,32,56,50,199,不合格
20025033,8,57,46,10,49,170,不合格
20025034,39,57,12,4,87,199,不合格
20025035,39,78,19,58,65,259,不合格
20025036,50,13,76,42,88,269,不合格
20025037,82,35,90,61,11,279,不合格
20025038,23,19,12,59,65,178,不合格
20025039,56,68,87,86,83,380,合格
20025040,2,15,76,70,69,232,不合格
20025041,39,60,2,0,67,168,不合格
20025042,23,25,88,20,76,232,不合格
20025043,18,3,96,22,34,173,不合格
20025044,66,48,76,98,93,381,合格
20025045,47,50,86,97,80,360,合格
20025046,73,64,91,43,0,271,不合格
20025047,62,21,2,36,52,173,不合格
20025048,82,46,89,45,62,324,合格
20025049,57,61,86,81,31,316,合格
20025050,89,3,11,15,15,133,不合格
20025051,81,27,79,73,78,338,合格
20025052,73,64,80,33,74,324,合格
20025053,21,97,77,11,1,207,不合格
20025054,76,38,57,51,66,288,不合格
20025055,47,3,31,62,13,156,不合格
20025056,35,18,88,36,29,206,不合格
20025057,98,74,51,5,71,299,不合格
20025058,59,40,60,97,44,300,合格
20025059,9,3,36,84,31,163,不合格
20025060,35,94,66,13,14,222,不合格
20025061,49,47,90,60,59,305,合格
20025062,70,72,47,30,99,318,合格
20025063,47,6,83,81,53,270,不合格
20025064,40,20,67,4,56,187,不合格
20025065,10,27,44,92,29,202,不合格
20025066,18,31,43,34,90,216,不合格
20025067,55,30,10,57,47,199,不合格
20025068,14,44,43,69,48,218,不合格
20025069,94,51,81,39,34,299,不合格
20025070,37,7,39,26,76,185,不合格
20025071,39,57,36,1,24,157,不合格
20025072,82,46,8,88,73,297,不合格
20025073,29,5,33,97,57,221,不合格
20025074,35,37,0,61,73,206,不合格
20025075,27,27,58,63,18,193,不合格
20025076,48,55,76,64,91,334,合格
20025077,80,76,33,81,76,346,合格
20025078,42,65,46,12,67,232,不合格
20025079,40,13,31,68,89,241,不合格
20025080,85,24,27,43,33,212,不合格
20025081,18,39,54,99,20,230,不合格
20025082,21,86,79,22,36,244,不合格
20025083,16,61,7,34,24,142,不合格
20025084,49,78,97,34,43,301,合格
20025085,75,1,34,31,36,177,不合格
20025086,30,88,15,60,37,230,不合格
20025087,94,71,57,14,53,289,不合格
20025088,95,85,34,69,62,345,合格
20025089,33,48,58,44,27,210,不合格
20025090,72,72,20,29,75,268,不合格
20025091,93,24,74,47,72,310,合格
20025092,14,28,27,97,32,198,不合格
20025093,59,54,81,84,72,350,合格
20025094,29,51,73,60,64,277,不合格
20025095,5,58,71,23,69,226,不合格
20025096,97,17,47,38,88,287,不合格
20025097,42,49,46,31,19,187,不合格
20025098,3,17,90,19,94,223,不合格
20025099,32,85,94,4,99,314,合格
20025100,35,93,59,54,71,312,合格
20025101,11,16,42,12,90,171,不合格
20025102,52,62,43,28,34,219,不合格
20025103,20,61,48,26,5,160,不合格
20025104,22,18,81,64,88,273,不合格
20025105,38,5,3,74,22,142,不合格
20025106,41,14,48,90,41,234,不合格
20025107,76,76,38,13,39,242,不合格
20025108,62,96,12,42,72,284,不合格
20025109,49,36,40,34,73,232,不合格
20025110,5,80,28,87,22,222,不合格
20025111,25,98,39,61,42,265,不合格
20025112,13,7,66,83,59,228,不合格
20025113,10,66,72,50,94,292,不合格
20025114,55,15,8,47,27,152,不合格
20025115,85,85,34,54,3,261,不合格
20025116,90,15,84,31,20,240,不合格
20025117,77,68,84,25,51,305,合格
20025118,3,53,88,72,53,269,不合格
20025119,88,96,12,48,39,283,不合格
20025120,14,74,24,58,35,205,不合格
20025121,20,97,11,78,37,243,不合格
20025122,16,71,5,63,71,226,不合格
20025123,16,45,35,78,23,197,不合格
20025124,6,43,75,20,64,208,不合格
20025125,92,54,18,35,26,225,不合格
20025126,55,19,93,96,64,327,合格
20025127,42,64,3,48,45,202,不合格
20025128,86,10,7,75,29,207,不合格
20025129,90,66,24,42,63,285,不合格
20025130,55,79,92,64,51,341,合格
20025131,0,45,9,59,13,126,不合格
20025132,34,78,21,16,32,181,不合格
20025133,40,40,99,25,78,282,不合格
20025134,83,66,46,93,67,355,合格
20025135,84,8,90,45,43,270,不合格
20025136,26,26,65,50,96,263,不合格
20025137,97,88,15,84,70,354,合格
20025138,43,57,66,38,73,277,不合格
20025139,36,49,40,52,6,183,不合格
20025140,36,66,81,79,22,284,不合格
20025141,6,57,32,69,58,222,不合格
20025142,28,26,21,36,18,129,不合格
20025143,75,0,75,31,40,221,不合格
20025144,77,71,15,11,51,225,不合格
20025145,89,69,72,64,12,306,合格
20025146,7,38,14,75,60,194,不合格
20025147,73,68,61,21,52,275,不合格
20025148,41,92,0,15,37,185,不合格
20025149,48,42,10,27,42,169,不合格
20025150,19,13,67,69,5,173,不合格
20025151,21,42,62,1,69,195,不合格
20025152,25,37,8,76,23,169,不合格
20025153,41,48,82,70,97,338,合格
20025154,2,8,67,73,50,200,不合格
20025155,49,96,74,64,11,294,不合格
20025156,65,79,46,22,29,241,不合格
20025157,81,32,25,60,96,294,不合格
20025158,32,38,44,49,7,170,不合格
20025159,10,61,53,15,12,151,不合格
20025160,10,14,22,69,73,188,不合格
20025161,17,64,49,37,68,235,不合格
20025162,59,43,27,27,89,245,不合格
20025163,45,6,30,24,39,144,不合格
20025164,88,86,23,12,44,253,不合格
20025165,29,13,33,43,14,132,不合格
20025166,36,54,15,45,43,193,不合格
20025167,13,32,55,25,88,213,不合格
20025168,45,55,60,77,0,237,不合格
20025169,77,88,86,18,19,288,不合格
20025170,80,49,63,18,11,221,不合格
20025171,50,98,20,29,70,267,不合格
20025172,18,29,31,22,76,176,不合格
20025173,53,15,46,94,29,237,不合格
20025174,65,41,58,79,76,319,合格
20025175,70,49,55,83,93,350,合格
20025176,66,8,35,88,4,201,不合格
20025177,54,14,48,19,68,203,不合格
20025178,23,74,63,69,42,271,不合格
20025179,71,85,34,57,79,326,合格
20025180,99,87,72,36,14,308,合格
20025181,80,17,9,57,82,245,不合格
20025182,35,68,12,21,67,203,不合格
20025183,37,65,56,99,49,306,合格
20025184,69,59,48,17,68,261,不合格
20025185,56,3,98,40,90,287,不合格
20025186,37,44,9,68,69,227,不合格
20025187,77,79,61,93,97,407,合格
20025188,22,39,72,50,11,194,不合格
20025189,37,53,51,61,34,236,不合格
20025190,16,5,26,39,26,112,不合格
20025191,40,19,65,71,36,231,不合格
20025192,53,85,19,15,1,173,不合格
20025193,53,28,40,96,7,224,不合格
20025194,83,8,32,38,70,231,不合格
20025195,76,71,10,45,95,297,不合格
20025196,36,61,22,26,33,178,不合格
20025197,89,88,34,23,76,310,合格
20025198,71,79,96,39,22,307,合格
20025199,28,54,14,53,80,229,不合格
20025200,21,7,88,45,42,203,不合格
20025201,55,19,22,88,98,282,不合格
20025202,58,88,62,38,38,284,不合格
20025203,78,67,38,87,33,303,合格
20025204,46,55,25,19,66,211,不合格
20025205,59,28,65,6,34,192,不合格
20025206,66,97,28,21,50,262,不合格
20025207,42,59,75,15,27,218,不合格
20025208,90,29,51,27,78,275,不合格
20025209,9,20,40,17,17,103,不合格
20025210,49,2,6,3,34,94,不合格
20025211,17,69,5,52,22,165,不合格
20025212,97,74,18,88,53,330,合格
20025213,92,87,67,6,48,300,合格
20025214,98,19,85,61,28,291,不合格
20025215,35,10,97,94,67,303,合格
20025216,57,37,86,49,87,316,合格
20025217,24,31,75,64,54,248,不合格
20025218,29,74,82,65,92,342,合格
20025219,60,41,28,41,83,253,不合格
20025220,31,37,46,18,96,228,不合格
20025221,7,81,44,64,43,239,不合格
20025222,97,28,26,52,92,295,不合格
20025223,38,76,71,66,5,256,不合格
20025224,88,73,75,86,74,396,合格
20025225,73,22,86,35,46,262,不合格
20025226,30,28,65,92,48,263,不合格
20025227,24,88,31,19,29,191,不合格
20025228,98,40,91,39,60,328,合格
20025229,11,55,3,86,87,242,不合格
20025230,79,89,64,48,1,281,不合格
20025231,58,8,14,18,70,168,不合格
20025232,65,36,28,86,77,292,不合格
20025233,80,0,91,28,12,211,不合格
20025234,13,61,51,70,54,249,不合格
20025235,93,30,16,96,80,315,合格
20025236,90,42,9,70,11,222,不合格
20025237,64,72,23,80,74,313,合格
20025238,14,56,0,17,80,167,不合格
20025239,4,3,80,55,3,145,不合格
20025240,83,72,3,1,40,199,不合格
20025241,0,67,3,45,33,148,不合格
20025242,41,87,62,24,46,260,不合格
20025243,88,13,20,3,1,125,不合格
20025244,42,68,98,81,90,379,合格
20025245,91,43,74,56,55,319,合格
20025246,85,26,13,99,78,301,合格
20025247,8,43,36,37,50,174,不合格
20025248,38,7,54,82,65,246,不合格
20025249,85,23,34,50,78,270,不合格
20025250,73,53,43,16,44,229,不合格
20025251,95,82,19,49,83,328,合格
20025252,47,0,28,22,26,123,不合格
20025253,74,79,23,62,92,330,合格
20025254,30,34,49,77,96,286,不合格
20025255,30,38,84,64,24,240,不合格
20025256,97,61,34,2,52,246,不合格
20025257,93,12,74,86,15,280,不合格
20025258,92,36,48,53,35,264,不合格
20025259,31,61,12,36,59,199,不合格
20025260,65,58,79,40,53,295,不合格
20025261,87,20,2,77,51,237,不合格
20025262,10,2,98,49,73,232,不合格
20025263,75,49,12,56,90,282,不合格
20025264,90,93,94,33,53,363,合格
20025265,68,17,60,21,41,207,不合格
20025266,40,91,22,10,19,182,不合格
20025267,67,81,1,19,4,172,不合格
20025268,25,64,83,79,12,263,不合格
20025269,76,72,50,69,94,361,合格
20025270,12,88,91,69,0,260,不合格
20025271,23,98,75,4,0,200,不合格
20025272,74,42,89,29,7,241,不合格
20025273,83,70,54,52,63,322,合格
20025274,25,63,60,12,62,222,不合格
20025275,82,94,23,65,47,311,合格
20025276,34,96,1,73,77,281,不合格
20025277,67,88,51,33,52,291,不合格
20025278,76,70,79,33,56,314,合格
20025279,13,51,68,58,7,197,不合格
20025280,15,22,76,11,43,167,不合格
20025281,8,1,57,29,14,109,不合格
20025282,31,63,34,71,3,202,不合格
20025283,87,81,51,93,37,349,合格
20025284,95,52,53,25,90,315,合格
20025285,65,6,96,14,43,224,不合格
20025286,96,94,59,98,78,425,合格
20025287,81,9,27,43,94,254,不合格
20025288,57,14,56,83,34,244,不合格
20025289,42,1,33,0,39,115,不合格
20025290,96,91,48,79,53,367,合格
20025291,10,11,6,5,60,92,不合格
20025292,29,39,64,74,30,236,不合格
20025293,90,73,55,39,42,299,不合格
20025294,70,45,9,11,26,161,不合格
20025295,1,58,87,61,30,237,不合格
20025296,83,44,31,63,23,244,不合格
20025297,36,5,6,74,41,162,不合格
20025298,40,77,45,67,96,325,合格
20025299,82,66,43,22,67,280,不合格
20025300,70,57,98,20,16,261,不合格
20025301,51,6,2,92,13,164,不合格
20025302,98,32,79,80,38,327,合格
20025303,59,7,58,88,24,236,不合格
20025304,44,51,10,52,7,164,不合格
20025305,87,45,64,94,14,304,合格
20025306,74,92,39,38,24,267,不合格
20025307,75,46,0,81,5,207,不合格
20025308,69,20,78,1,37,205,不合格
20025309,10,42,7,16,67,142,不合格
20025310,9,36,96,6,35,182,不合格
20025311,69,7,34,4,89,203,不合格
20025312,79,69,39,67,54,308,合格
20025313,33,77,93,27,87,317,合格
20025314,75,93,20,87,87,362,合格
20025315,16,60,44,54,87,261,不合格
20025316,51,52,60,40,73,276,不合格
20025317,87,37,98,94,16,332,合格
20025318,15,34,97,55,71,272,不合格
20025319,46,20,92,78,57,293,不合格
20025320,32,84,21,31,94,262,不合格
20025321,93,47,19,43,86,288,不合格
20025322,10,15,80,32,57,194,不合格
20025323,25,22,34,21,14,116,不合格
20025324,82,72,69,55,90,368,合格
20025325,78,11,74,68,82,313,合格
20025326,61,54,30,34,74,253,不合格
20025327,71,3,9,52,40,175,不合格
20025328,64,78,16,97,1,256,不合格
20025329,92,46,28,47,86,299,不合格
20025330,25,29,96,67,73,290,不合格
20025331,58,46,49,60,86,299,不合格
20025332,51,1,18,33,15,118,不合格
20025333,55,40,18,96,36,245,不合格
20025334,59,4,48,41,60,212,不合格
20025335,75,47,66,62,1,251,不合格
20025336,23,12,28,10,18,91,不合格
20025337,20,4,63,27,82,196,不合格
20025338,79,25,90,51,55,300,合格
20025339,65,39,63,90,96,353,合格
20025340,67,24,90,43,48,272,不合格
20025341,30,31,14,72,88,235,不合格
20025342,71,98,83,68,70,390,合格
20025343,36,30,15,85,31,197,不合格
20025344,80,12,25,22,22,161,不合格
20025345,43,10,7,43,46,149,不合格
20025346,12,23,68,51,41,195,不合格
20025347,76,88,54,46,55,319,合格
20025348,94,39,68,36,54,291,不合格
20025349,54,20,26,59,66,225,不合格
20025350,34,35,9,8,37,123,不合格
20025351,45,86,52,81,66,330,合格
20025352,7,84,72,83,64,310,合格
20025353,17,73,50,53,59,252,不合格
20025354,93,94,89,89,27,392,合格
20025355,7,96,13,81,7,204,不合格
20025356,51,29,50,27,40,197,不合格
20025357,5,7,47,53,8,120,不合格
20025358,99,33,4,7,28,171,不合格
20025359,78,99,39,26,96,338,合格
20025360,75,16,23,79,51,244,不合格
20025361,43,81,22,60,83,289,不合格
20025362,11,83,86,21,54,255,不合格
20025363,38,90,51,18,91,288,不合格
20025364,32,93,10,5,81,221,不合格
20025365,39,89,98,81,97,404,合格
20025366,61,1,31,84,73,250,不合格
20025367,49,71,11,37,33,201,不合格
20025368,76,62,19,34,11,202,不合格
20025369,5,61,16,1,55,138,不合格
20025370,68,30,99,41,8,246,不合格
20025371,29,54,84,11,87,265,不合格
20025372,98,74,7,22,55,256,不合格
20025373,23,93,31,54,99,300,合格
20025374,72,73,88,15,69,317,合格
20025375,18,66,66,76,36,262,不合格
20025376,6,71,25,8,83,193,不合格
20025377,70,74,8,92,77,321,合格
20025378,14,63,80,72,86,315,合格
20025379,91,2,58,72,86,309,合格
20025380,78,1,34,55,4,172,不合格
20025381,92,39,87,18,39,275,不合格
20025382,79,93,48,75,44,339,合格
20025383,29,20,63,98,93,303,合格
20025384,1,91,43,4,43,182,不合格
20025385,68,83,74,28,32,285,不合格
20025386,62,36,29,57,22,206,不合格
20025387,37,44,33,84,32,230,不合格
20025388,62,44,50,76,67,299,不合格
20025389,56,61,23,63,36,239,不合格
20025390,83,81,76,74,25,339,合格
20025391,84,98,60,32,2,276,不合格
20025392,70,51,87,78,78,364,合格
20025393,21,30,81,71,82,285,不合格
20025394,75,90,81,13,99,358,合格
20025395,55,89,58,95,58,355,合格
20025396,14,6,27,9,67,123,不合格
20025397,53,44,53,8,70,228,不合格
20025398,69,7,12,33,17,138,不合格
20025399,91,52,86,57,97,383,合格
20025400,89,68,51,1,19,228,不合格
20025401,62,35,57,77,35,266,不合格
20025402,0,3,11,48,79,141,不合格
20025403,49,55,79,62,42,287,不合格
20025404,3,86,71,44,21,225,不合格
20025405,18,89,61,68,39,275,不合格
20025406,56,12,62,55,6,191,不合格
20025407,44,69,18,77,97,305,合格
20025408,65,66,77,1,11,220,不合格
20025409,40,76,12,65,46,239,不合格
20025410,41,85,96,54,8,284,不合格
20025411,42,42,67,95,94,340,合格
20025412,30,23,63,92,62,270,不合格
20025413,28,42,58,66,53,247,不合格
20025414,7,44,91,30,48,220,不合格
20025415,92,76,57,14,71,310,合格
20025416,66,10,89,51,13,229,不合格
20025417,71,12,35,23,70,211,不合格
20025418,31,64,27,32,85,239,不合格
20025419,12,40,77,39,55,223,不合格
20025420,34,42,43,7,47,173,不合格
20025421,34,96,32,43,72,277,不合格
20025422,13,54,78,46,59,250,不合格
20025423,16,47,31,96,68,258,不合格
20025424,54,47,17,24,30,172,不合格
20025425,97,61,87,21,36,302,合格
20025426,57,85,92,66,71,371,合格
20025427,36,20,46,74,34,210,不合格
20025428,51,16,29,0,41,137,不合格
20025429,87,30,33,23,83,256,不合格
20025430,40,24,62,36,45,207,不合格
20025431,71,31,30,52,69,253,不合格
20025432,14,15,44,88,18,179,不合格
20025433,5,80,25,63,66,239,不合格
20025434,58,13,89,68,7,235,不合格
20025435,33,92,41,80,56,302,合格
20025436,33,3,11,18,38,103,不合格
20025437,99,59,75,91,84,408,合格
20025438,85,92,66,90,70,403,合格
20025439,31,18,71,59,66,245,不合格
20025440,76,20,81,77,39,293,不合格
20025441,51,20,19,3,6,99,不合格
20025442,63,11,1,55,0,130,不合格
20025443,11,4,33,32,48,128,不合格
20025444,7,31,12,12,72,134,不合格
20025445,77,12,41,22,50,202,不合格
20025446,18,80,71,61,73,303,合格
20025447,14,40,78,97,65,294,不合格
20025448,1,54,28,19,53,155,不合格
20025449,17,89,52,70,69,297,不合格
20025450,54,88,90,32,15,279,不合格
20025451,42,63,22,0,51,178,不合格
20025452,90,83,42,78,90,383,合格
20025453,30,82,42,75,46,275,不合格
20025454,76,56,39,36,15,222,不合格
20025455,72,29,85,51,17,254,不合格
20025456,23,68,93,26,90,300,合格
20025457,53,8,5,53,69,188,不合格
20025458,38,22,35,39,41,175,不合格
20025459,55,56,47,39,70,267,不合格
20025460,83,10,48,67,62,270,不合格
20025461,65,52,43,55,34,249,不合格
20025462,16,50,19,70,89,244,不合格
20025463,99,54,21,20,34,228,不合格
20025464,83,24,75,64,78,324,合格
20025465,18,28,46,4,91,187,不合格
20025466,63,74,40,90,59,326,合格
20025467,60,21,47,43,50,221,不合格
20025468,30,7,70,80,30,217,不合格
20025469,76,35,61,29,64,265,不合格
20025470,4,67,30,34,63,198,不合格
20025471,43,62,1,35,44,185,不合格
20025472,98,32,67,97,25,319,合格
20025473,81,84,27,92,71,355,合格
20025474,39,16,89,53,84,281,不合格
20025475,64,5,37,12,79,197,不合格
20025476,44,58,57,37,30,226,不合格
20025477,14,94,50,44,53,255,不合格
20025478,75,89,65,75,13,317,合格
20025479,66,58,52,18,69,263,不合格
20025480,12,93,30,46,21,202,不合格
20025481,68,0,70,40,7,185,不合格
20025482,93,28,28,86,22,257,不合格
20025483,80,32,66,74,45,297,不合格
20025484,90,54,9,47,15,215,不合格
20025485,13,60,5,33,11,122,不合格
20025486,50,39,46,31,86,252,不合格
20025487,3,98,44,55,93,293,不合格
20025488,85,26,27,23,24,185,不合格
20025489,78,39,19,97,28,261,不合格
20025490,96,26,29,27,85,263,不合格
20025491,42,79,22,75,58,276,不合格
20025492,80,84,42,3,38,247,不合格
20025493,55,54,81,72,40,302,合格
20025494,44,84,1,66,59,254,不合格
20025495,9,74,48,25,46,202,不合格
20025496,35,1,79,53,81,249,不合格
20025497,26,69,6,65,72,238,不合格
20025498,90,57,81,12,42,282,不合格
20025499,35,30,31,24,39,159,不合格
20025500,78,26,39,32,48,223,不合格
