ID,国語,数学,英語,理科,社会,合計,判定
20040001,63,1,14,52,81,211,不合格
20040002,79,24,68,34,92,297,不合格
20040003,83,32,0,10,83,208,不合格
20040004,10,18,43,77,11,159,不合格
20040005,86,92,83,61,45,367,合格
20040006,74,67,77,4,13,235,不合格
20040007,58,50,74,79,25,286,不合格
20040008,59,44,92,43,49,287,不合格
20040009,81,22,96,63,77,339,合格
20040010,40,25,85,59,61,270,不合格
20040011,17,60,9,71,55,212,不合格
20040012,80,44,95,67,25,311,合格
20040013,54,7,41,18,16,136,不合格
20040014,31,26,89,77,35,258,不合格
20040015,99,24,60,76,42,301,合格
20040016,55,16,6,44,49,170,不合格
20040017,24,8,0,48,7,87,不合格
20040018,53,72,11,87,26,249,不合格
20040019,33,0,37,69,71,210,不合格
20040020,19,71,60,62,73,285,不合格
20040021,61,29,54,60,10,214,不合格
20040022,5,29,42,15,30,121,不合格
20040023,94,71,3,79,92,339,合格
20040024,39,74,95,42,91,341,合格
20040025,58,33,74,25,95,285,不合格
20040026,29,69,75,91,88,352,合格
20040027,87,94,19,82,14,296,不合格
20040028,26,17,18,89,32,182,不合格
20040029,48,56,25,80,63,272,不合格
20040030,60,97,91,71,82,401,合格
20040031,82,43,71,22,1,219,不合格
20040032,46,30,70,99,96,341,合格
20040033,14,24,36,89,70,233,不合格
20040034,34,87,45,18,55,239,不合格
20040035,6,66,91,51,28,242,不合格
20040036,48,17,49,56,11,181,不合格
20040037,57,82,0,27,27,193,不合格
20040038,76,67,56,7,38,244,不合格
20040039,38,83,51,3,26,201,不合格
20040040,33,54,34,47,39,207,不合格
20040041,13,24,42,54,29,162,不合格
20040042,38,93,66,6,68,271,不合格
20040043,38,44,74,57,6,219,不合格
20040044,36,84,89,55,95,359,合格
20040045,79,16,26,84,39,244,不合格
20040046,0,54,81,20,77,232,不合格
20040047,91,89,71,77,43,371,合格
20040048,93,60,71,36,49,309,合格
20040049,29,87,50,60,6,232,不合格
20040050,40,94,76,63,76,349,合格
20040051,15,87,48,88,70,308,合格
20040052,4,84,49,62,1,200,不合格
20040053,57,33,54,82,87,313,合格
20040054,33,77,43,14,82,249,不合格
20040055,72,76,50,63,50,311,合格
20040056,98,11,39,7,82,237,不合格
20040057,65,17,50,11,91,234,不合格
20040058,90,29,32,70,46,267,不合格
20040059,46,76,49,7,18,196,不合格
20040060,27,85,34,53,11,210,不合格
20040061,28,40,49,4,39,160,不合格
20040062,65,12,56,37,66,236,不合格
20040063,98,91,38,44,84,355,合格
20040064,12,31,22,11,21,97,不合格
20040065,41,21,90,22,34,208,不合格
20040066,73,82,58,56,85,354,合格
20040067,41,53,64,22,18,198,不合格
20040068,84,20,56,78,85,323,合格
20040069,46,7,28,34,34,149,不合格
20040070,85,56,6,86,44,277,不合格
20040071,95,51,13,32,64,255,不合格
20040072,80,12,25,71,26,214,不合格
20040073,66,46,24,19,87,242,不合格
20040074,44,33,7,56,82,222,不合格
20040075,70,88,70,31,8,267,不合格
20040076,92,55,45,22,45,259,不合格
20040077,76,76,63,84,43,342,合格
20040078,33,81,78,47,2,241,不合格
20040079,0,10,81,32,71,194,不合格
20040080,71,87,8,79,17,262,不合格
20040081,54,21,54,44,40,213,不合格
20040082,16,66,53,42,49,226,不合格
20040083,33,37,16,64,53,203,不合格
20040084,19,20,89,85,25,238,不合格
20040085,70,89,62,39,17,277,不合格
20040086,4,47,82,40,19,192,不合格
20040087,28,38,81,58,83,288,不合格
20040088,67,67,62,45,24,265,不合格
20040089,26,89,3,5,44,167,不合格
20040090,77,38,1,33,52,201,不合格
20040091,43,15,85,6,72,221,不合格
20040092,1,55,1,52,73,182,不合格
20040093,73,49,23,99,8,252,不合格
20040094,86,58,72,30,59,305,合格
20040095,59,26,54,60,90,289,不合格
20040096,56,50,64,58,36,264,不合格
20040097,22,28,60,33,81,224,不合格
20040098,8,39,4,29,78,158,不合格
20040099,94,20,45,22,32,213,不合格
20040100,81,24,32,19,69,225,不合格
20040101,36,94,79,63,62,334,合格
20040102,10,36,26,27,89,188,不合格
20040103,20,66,83,21,48,238,不合格
20040104,13,50,84,58,52,257,不合格
20040105,5,95,58,27,29,214,不合格
20040106,28,20,32,22,61,163,不合格
20040107,56,31,64,59,86,296,不合格
20040108,52,58,55,44,44,253,不合格
20040109,15,54,52,55,73,249,不合格
20040110,13,44,81,66,49,253,不合格
20040111,86,12,68,12,46,224,不合格
20040112,99,16,41,51,69,276,不合格
20040113,76,66,64,65,84,355,合格
20040114,90,19,59,59,84,311,合格
20040115,55,7,73,95,16,246,不合格
20040116,98,99,69,99,78,443,合格
20040117,89,52,49,81,36,307,合格
20040118,55,1,53,30,41,180,不合格
20040119,28,75,17,35,21,176,不合格
20040120,40,9,36,42,80,207,不合格
20040121,64,92,16,58,4,234,不合格
20040122,1,82,15,51,45,194,不合格
20040123,71,95,10,89,37,302,合格
20040124,60,66,66,52,50,294,不合格
20040125,24,45,39,26,5,139,不合格
20040126,13,14,56,84,0,167,不合格
20040127,89,94,51,56,48,338,合格
20040128,72,16,36,89,39,252,不合格
20040129,81,20,13,33,84,231,不合格
20040130,68,12,9,12,62,163,不合格
20040131,85,28,89,32,88,322,合格
20040132,78,71,4,71,90,314,合格
20040133,60,35,9,25,57,186,不合格
20040134,70,78,25,49,11,233,不合格
20040135,7,91,25,50,11,184,不合格
20040136,78,88,14,61,94,335,合格
20040137,51,8,46,63,0,168,不合格
20040138,12,92,97,84,27,312,合格
20040139,30,20,99,97,86,332,合格
20040140,22,59,32,65,27,205,不合格
20040141,12,57,50,68,90,277,不合格
20040142,94,68,26,40,63,291,不合格
20040143,89,61,41,14,21,226,不合格
20040144,53,49,9,32,27,170,不合格
20040145,75,2,4,8,68,157,不合格
20040146,80,44,3,33,42,202,不合格
20040147,98,91,77,93,57,416,合格
20040148,25,74,92,98,74,363,合格
20040149,60,97,67,42,93,359,合格
20040150,56,21,75,83,64,299,不合格
20040151,60,92,93,96,70,411,合格
20040152,64,87,51,99,48,349,合格
20040153,74,31,40,87,9,241,不合格
20040154,78,2,4,62,95,241,不合格
20040155,44,68,67,67,2,248,不合格
20040156,79,90,18,60,54,301,合格
20040157,93,51,35,35,16,230,不合格
20040158,43,95,21,41,33,233,不合格
20040159,92,73,88,62,30,345,合格
20040160,9,67,33,53,94,256,不合格
20040161,50,87,82,35,0,254,不合格
20040162,51,53,20,81,19,224,不合格
20040163,34,24,27,8,98,191,不合格
20040164,64,53,31,1,82,231,不合格
20040165,68,13,6,9,90,186,不合格
20040166,65,69,61,56,75,326,合格
20040167,66,21,76,96,70,329,合格
20040168,63,95,38,6,59,261,不合格
20040169,36,74,80,84,66,340,合格
20040170,48,67,47,62,67,291,不合格
20040171,77,57,6,12,99,251,不合格
20040172,30,56,43,88,11,228,不合格
20040173,55,75,35,19,17,201,不合格
20040174,17,81,10,43,53,204,不合格
20040175,45,49,34,8,59,195,不合格
20040176,18,3,2,95,93,211,不合格
20040177,40,30,36,15,99,220,不合格
20040178,33,40,21,20,88,202,不合格
20040179,91,27,45,85,50,298,不合格
20040180,28,29,57,86,21,221,不合格
20040181,18,25,56,86,66,251,不合格
20040182,94,38,92,29,48,301,合格
20040183,44,42,76,75,24,261,不合格
20040184,69,76,41,30,52,268,不合格
20040185,45,79,52,97,15,288,不合格
20040186,50,52,82,62,48,294,不合格
20040187,56,9,86,92,48,291,不合格
20040188,8,43,69,66,99,285,不合格
20040189,48,77,13,98,40,276,不合格
20040190,39,84,7,28,60,218,不合格
20040191,43,13,47,74,29,206,不合格
20040192,2,42,28,73,33,178,不合格
20040193,20,13,57,58,18,166,不合格
20040194,11,16,40,92,42,201,不合格
20040195,3,95,96,8,5,207,不合格
20040196,7,37,58,10,15,127,不合格
20040197,9,41,42,88,84,264,不合格
20040198,40,27,68,41,13,189,不合格
20040199,9,63,87,54,99,312,合格
20040200,3,85,37,68,17,210,不合格
20040201,83,89,30,47,20,269,不合格
20040202,92,3,33,54,12,194,不合格
20040203,98,42,60,6,12,218,不合格
20040204,3,16,97,12,52,180,不合格
20040205,18,75,23,33,11,160,不合格
20040206,49,3,94,41,15,202,不合格
20040207,86,70,53,28,43,280,不合格
20040208,47,2,27,75,72,223,不合格
20040209,71,76,1,68,80,296,不合格
20040210,20,70,27,88,97,302,合格
20040211,25,93,24,69,69,280,不合格
20040212,79,32,98,82,22,313,合格
20040213,22,27,66,0,73,188,不合格
20040214,96,52,49,92,37,326,合格
20040215,79,29,70,43,7,228,不合格
20040216,58,94,21,71,60,304,合格
20040217,62,66,42,46,20,236,不合格
20040218,44,24,25,80,63,236,不合格
20040219,66,73,32,1,76,248,不合格
20040220,92,81,61,50,41,325,合格
20040221,20,86,34,19,90,249,不合格
20040222,98,46,60,27,48,279,不合格
20040223,97,15,76,13,76,277,不合格
20040224,47,98,80,16,7,248,不合格
20040225,23,16,67,51,76,233,不合格
20040226,14,95,99,2,46,256,不合格
20040227,95,86,95,27,5,308,合格
20040228,78,6,23,42,14,163,不合格
20040229,47,70,19,96,35,267,不合格
20040230,1,53,96,31,30,211,不合格
20040231,41,80,65,75,20,281,不合格
20040232,31,42,46,18,70,207,不合格
20040233,34,23,57,36,75,225,不合格
20040234,44,48,19,31,48,190,不合格
20040235,5,96,66,16,20,203,不合格
20040236,17,41,37,7,98,200,不合格
20040237,77,39,75,42,65,298,不合格
20040238,98,53,87,78,93,409,合格
20040239,89,3,58,95,13,258,不合格
20040240,33,58,16,19,75,201,不合格
20040241,77,67,15,83,37,279,不合格
20040242,80,27,93,23,52,275,不合格
20040243,77,96,81,32,61,347,合格
20040244,20,15,46,75,94,250,不合格
20040245,17,27,93,47,93,277,不合格
20040246,94,95,24,68,5,286,不合格
20040247,55,34,36,65,46,236,不合格
20040248,83,95,33,83,58,352,合格
20040249,8,14,82,69,41,214,不合格
20040250,87,6,6,92,5,196,不合格
20040251,84,41,41,34,98,298,不合格
20040252,54,96,5,71,19,245,不合格
20040253,61,74,2,20,16,173,不合格
20040254,58,32,43,63,47,243,不合格
20040255,96,67,73,73,79,388,合格
20040256,86,66,15,33,47,247,不合格
20040257,84,97,38,61,8,288,不合格
20040258,15,66,95,97,9,282,不合格
20040259,47,4,91,21,3,166,不合格
20040260,74,14,37,45,12,182,不合格
20040261,5,6,2,98,38,149,不合格
20040262,74,82,78,18,57,309,合格
20040263,76,95,32,9,66,278,不合格
20040264,36,17,34,74,87,248,不合格
20040265,63,15,64,99,39,280,不合格
20040266,72,90,82,81,80,405,合格
20040267,16,76,13,62,80,247,不合格
20040268,46,10,84,57,54,251,不合格
20040269,21,38,39,58,58,214,不合格
20040270,32,33,94,74,2,235,不合格
20040271,87,9,75,78,22,271,不合格
20040272,33,25,22,94,67,241,不合格
20040273,76,8,72,79,73,308,合格
20040274,70,5,42,57,91,265,不合格
20040275,14,90,94,20,18,236,不合格
20040276,10,34,51,23,20,138,不合格
20040277,26,40,16,20,81,183,不合格
20040278,58,18,27,26,75,204,不合格
20040279,59,50,36,54,63,262,不合格
20040280,45,62,69,73,23,272,不合格
20040281,42,96,71,36,54,299,不合格
20040282,80,0,13,36,14,143,不合格
20040283,80,85,8,37,62,272,不合格
20040284,50,61,3,56,22,192,不合格
20040285,18,15,32,26,31,122,不合格
20040286,20,79,56,32,50,237,不合格
20040287,4,31,88,18,42,183,不合格
20040288,51,77,73,90,48,339,合格
20040289,72,35,85,26,83,301,合格
20040290,42,0,58,90,12,202,不合格
20040291,31,76,64,27,57,255,不合格
20040292,70,43,29,18,95,255,不合格
20040293,6,51,13,96,74,240,不合格
20040294,87,50,93,47,53,330,合格
20040295,73,88,18,56,12,247,不合格
20040296,97,35,66,59,60,317,合格
20040297,20,94,23,72,43,252,不合格
20040298,82,90,67,49,68,356,合格
20040299,48,67,6,96,8,225,不合格
20040300,58,41,2,44,55,200,不合格
20040301,95,62,49,85,79,370,合格
20040302,43,38,64,61,37,243,不合格
20040303,40,36,54,4,66,200,不合格
20040304,18,37,94,27,7,183,不合格
20040305,77,92,68,14,46,297,不合格
20040306,59,89,0,31,73,252,不合格
20040307,36,30,1,87,94,248,不合格
20040308,17,40,61,55,75,248,不合格
20040309,91,28,91,76,94,380,合格
20040310,50,25,90,51,17,233,不合格
20040311,99,74,81,4,11,269,不合格
20040312,86,15,99,68,40,308,合格
20040313,80,36,17,99,54,286,不合格
20040314,74,85,64,96,2,321,合格
20040315,11,31,92,68,85,287,不合格
20040316,65,73,76,38,26,278,不合格
20040317,77,69,90,10,79,325,合格
20040318,85,17,81,58,36,277,不合格
20040319,37,64,33,77,89,300,合格
20040320,61,88,57,83,75,364,合格
20040321,60,80,43,37,26,246,不合格
20040322,2,92,53,32,41,220,不合格
20040323,27,43,53,27,34,184,不合格
20040324,6,72,68,22,50,218,不合格
20040325,3,20,4,99,14,140,不合格
20040326,62,72,22,11,73,240,不合格
20040327,49,57,11,83,22,222,不合格
20040328,64,20,41,12,34,171,不合格
20040329,41,61,50,81,88,321,合格
20040330,27,14,83,58,92,274,不合格
20040331,2,94,13,71,64,244,不合格
20040332,72,61,30,29,36,228,不合格
20040333,85,5,54,65,29,238,不合格
20040334,15,77,52,58,70,272,不合格
20040335,72,53,33,13,82,253,不合格
20040336,52,35,9,82,88,266,不合格
20040337,52,60,9,39,9,169,不合格
20040338,49,20,59,53,48,229,不合格
20040339,74,37,26,17,27,181,不合格
20040340,89,20,74,57,87,327,合格
20040341,13,9,1,88,69,180,不合格
20040342,3,80,34,42,60,219,不合格
20040343,22,2,4,23,61,112,不合格
20040344,18,34,61,37,89,239,不合格
20040345,26,12,20,17,76,151,不合格
20040346,12,11,13,16,8,60,不合格
20040347,91,6,80,40,89,306,合格
20040348,86,13,81,9,26,215,不合格
20040349,29,60,31,25,12,157,不合格
20040350,3,82,39,87,44,255,不合格
20040351,44,91,64,53,75,327,合格
20040352,61,56,87,30,14,248,不合格
20040353,77,15,91,35,62,280,不合格
20040354,80,9,51,52,96,288,不合格
20040355,10,70,6,85,27,198,不合格
20040356,1,90,35,46,17,189,不合格
20040357,83,15,41,10,63,212,不合格
20040358,35,63,27,30,38,193,不合格
20040359,87,33,55,97,40,312,合格
20040360,31,25,79,96,51,282,不合格
20040361,24,41,25,37,35,162,不合格
20040362,84,86,28,98,26,322,合格
20040363,63,62,25,53,53,256,不合格
20040364,74,60,56,7,41,238,不合格
20040365,9,77,29,80,96,291,不合格
20040366,88,56,10,96,70,320,合格
20040367,60,10,5,48,15,138,不合格
20040368,57,11,87,68,6,229,不合格
20040369,72,93,93,54,46,358,合格
20040370,93,87,90,38,56,364,合格
20040371,2,23,71,33,73,202,不合格
20040372,31,20,89,74,21,235,不合格
20040373,12,98,43,97,41,291,不合格
20040374,20,52,21,46,56,195,不合格
20040375,53,29,15,99,44,240,不合格
20040376,79,7,18,84,22,210,不合格
20040377,47,89,80,17,51,284,不合格
20040378,86,83,24,90,78,361,合格
20040379,19,50,59,43,12,183,不合格
20040380,4,26,90,94,38,252,不合格
20040381,2,32,35,98,42,209,不合格
20040382,17,72,18,53,17,177,不合格
20040383,38,91,26,20,2,177,不合格
20040384,79,69,51,4,83,286,不合格
20040385,17,83,66,28,77,271,不合格
20040386,21,67,31,70,13,202,不合格
20040387,35,6,91,63,86,281,不合格
20040388,92,22,11,69,52,246,不合格
20040389,66,66,93,25,97,347,合格
20040390,80,32,24,72,11,219,不合格
20040391,99,55,56,1,18,229,不合格
20040392,74,93,86,60,37,350,合格
20040393,82,35,20,2,19,158,不合格
20040394,21,74,29,29,84,237,不合格
20040395,46,14,39,84,30,213,不合格
20040396,82,92,77,38,90,379,合格
20040397,83,94,50,86,50,363,合格
20040398,62,12,40,10,17,141,不合格
20040399,33,53,81,37,50,254,不合格
20040400,41,66,54,70,36,267,不合格
20040401,5,93,56,2,7,163,不合格
20040402,55,0,96,73,90,314,合格
20040403,8,51,12,85,16,172,不合格
20040404,42,52,3,53,8,158,不合格
20040405,96,82,90,91,53,412,合格
20040406,18,9,58,28,41,154,不合格
20040407,21,88,88,39,35,271,不合格
20040408,68,67,40,27,87,289,不合格
20040409,72,60,40,7,15,194,不合格
20040410,31,57,66,51,70,275,不合格
20040411,18,58,61,69,15,221,不合格
20040412,72,55,21,21,47,216,不合格
20040413,51,36,13,53,38,191,不合格
20040414,88,56,50,45,55,294,不合格
20040415,12,8,13,49,10,92,不合格
20040416,79,33,94,43,66,315,合格
20040417,23,34,99,81,61,298,不合格
20040418,57,4,87,99,61,308,合格
20040419,60,91,6,17,72,246,不合格
20040420,69,28,12,26,13,148,不合格
20040421,85,42,78,73,93,371,合格
20040422,85,31,58,6,76,256,不合格
20040423,98,88,14,57,9,266,不合格
20040424,90,65,81,17,61,314,合格
20040425,36,13,0,17,9,75,不合格
20040426,93,8,96,98,64,359,合格
20040427,96,13,40,25,36,210,不合格
20040428,52,18,15,89,0,174,不合格
20040429,69,91,62,13,18,253,不合格
20040430,90,82,95,42,14,323,合格
20040431,60,11,27,1,52,151,不合格
20040432,79,20,61,45,69,274,不合格
20040433,64,44,51,32,5,196,不合格
20040434,15,13,4,30,35,97,不合格
20040435,30,56,17,63,55,221,不合格
20040436,73,22,59,15,68,237,不合格
20040437,76,55,86,63,72,352,合格
20040438,31,77,2,48,38,196,不合格
20040439,48,79,19,59,63,268,不合格
20040440,69,47,87,61,9,273,不合格
20040441,62,22,80,94,76,334,合格
20040442,17,23,33,8,53,134,不合格
20040443,15,34,83,74,58,264,不合格
20040444,69,36,18,51,67,241,不合格
20040445,83,40,88,82,41,334,合格
20040446,44,79,85,13,34,255,不合格
20040447,50,92,56,21,87,306,合格
20040448,94,78,83,96,31,382,合格
20040449,1,81,44,17,67,210,不合格
20040450,66,24,80,58,62,290,不合格
20040451,12,90,6,8,11,127,不合格
20040452,3,28,78,2,44,155,不合格
20040453,2,77,30,35,60,204,不合格
20040454,95,75,50,5,43,268,不合格
20040455,70,35,43,9,77,234,不合格
20040456,82,57,72,31,30,272,不合格
20040457,59,89,68,38,44,298,不合格
20040458,49,23,94,93,87,346,合格
20040459,57,23,14,10,30,134,不合格
20040460,30,42,73,53,38,236,不合格
20040461,92,66,27,9,30,224,不合格
20040462,85,41,30,66,44,266,不合格
20040463,33,0,51,84,29,197,不合格
20040464,76,65,52,73,2,268,不合格
20040465,8,44,48,8,36,144,不合格
20040466,47,71,77,65,78,338,合格
20040467,87,39,26,95,31,278,不合格
20040468,75,32,67,51,23,248,不合格
20040469,51,62,65,59,79,316,合格
20040470,87,47,5,27,6,172,不合格
20040471,0,41,49,76,85,251,不合格
20040472,84,60,39,57,93,333,合格
20040473,61,40,47,97,91,336,合格
20040474,15,75,37,16,21,164,不合格
20040475,52,1,45,62,10,170,不合格
20040476,15,43,54,77,24,213,不合格
20040477,51,78,2,23,13,167,不合格
20040478,42,2,75,18,87,224,不合格
20040479,96,15,77,92,60,340,合格
20040480,68,42,0,57,21,188,不合格
20040481,13,9,77,95,0,194,不合格
20040482,61,23,64,68,38,254,不合格
20040483,31,33,36,28,82,210,不合格
20040484,10,68,66,27,81,252,不合格
20040485,45,96,93,69,98,401,合格
20040486,95,9,74,28,83,289,不合格
20040487,17,82,30,85,35,249,不合格
20040488,76,22,47,43,23,211,不合格
20040489,5,36,20,46,9,116,不合格
20040490,20,46,39,89,90,284,不合格
20040491,28,86,62,18,58,252,不合格
20040492,20,89,10,55,95,269,不合格
20040493,55,70,44,91,95,355,合格
20040494,84,94,2,54,64,298,不合格
20040495,83,77,33,87,20,300,合格
20040496,93,81,74,27,17,292,不合格
20040497,11,58,83,75,17,244,不合格
20040498,18,92,78,97,81,366,合格
20040499,56,96,37,8,76,273,不合格
20040500,33,98,3,23,33,190,不合格
20040501,49,48,32,45,60,234,不合格
20040502,95,48,86,57,62,348,合格
20040503,68,90,64,47,92,361,合格
20040504,12,57,89,45,42,245,不合格
20040505,90,1,76,25,68,260,不合格
20040506,29,53,52,57,50,241,不合格
20040507,81,65,50,10,37,243,不合格
20040508,59,35,61,77,84,316,合格
20040509,3,94,18,62,51,228,不合格
20040510,26,65,28,77,81,277,不合格
20040511,3,84,82,69,88,326,合格
20040512,49,8,89,76,75,297,不合格
20040513,13,69,19,75,7,183,不合格
20040514,37,49,30,90,86,292,不合格
20040515,80,87,93,49,31,340,合格
20040516,25,78,69,85,32,289,不合格
20040517,15,77,72,27,96,287,不合格
20040518,27,87,7,84,51,256,不合格
20040519,85,21,0,30,76,212,不合格
20040520,59,97,39,90,4,289,不合格
20040521,90,82,98,75,72,417,合格
20040522,67,75,30,39,22,233,不合格
20040523,12,30,4,17,59,122,不合格
20040524,28,12,14,6,20,80,不合格
20040525,93,63,12,54,52,274,不合格
20040526,97,28,26,56,32,239,不合格
20040527,95,63,42,79,52,331,合格
20040528,65,21,35,30,10,161,不合格
20040529,59,31,58,79,48,275,不合格
20040530,46,14,65,80,64,269,不合格
20040531,16,56,43,16,90,221,不合格
20040532,70,52,83,31,46,282,不合格
20040533,24,86,23,73,34,240,不合格
20040534,10,9,24,32,78,153,不合格
20040535,47,45,63,51,12,218,不合格
20040536,82,75,4,99,62,322,合格
20040537,37,11,23,4,56,131,不合格
20040538,31,90,23,77,38,259,不合格
20040539,17,35,68,85,65,270,不合格
20040540,62,57,19,94,46,278,不合格
20040541,92,32,61,86,54,325,合格
20040542,9,85,87,11,54,246,不合格
20040543,23,5,97,74,3,202,不合格
20040544,19,14,86,80,55,254,不合格
20040545,77,5,68,41,90,281,不合格
20040546,30,11,40,99,90,270,不合格
20040547,11,42,45,0,20,118,不合格
20040548,14,30,3,89,62,198,不合格
20040549,34,77,33,62,20,226,不合格
20040550,46,73,67,22,50,258,不合格
20040551,36,47,89,39,52,263,不合格
20040552,40,9,22,60,86,217,不合格
20040553,39,61,21,13,14,148,不合格
20040554,11,84,11,11,69,186,不合格
20040555,56,86,80,56,46,324,合格
20040556,49,53,87,40,19,248,不合格
20040557,54,11,90,97,99,351,合格
20040558,44,3,28,97,11,183,不合格
20040559,96,62,10,48,67,283,不合格
20040560,40,78,49,65,42,274,不合格
20040561,58,21,53,82,39,253,不合格
20040562,91,85,91,57,70,394,合格
20040563,23,78,99,50,13,263,不合格
20040564,20,69,85,29,77,280,不合格
20040565,54,42,3,73,98,270,不合格
20040566,25,53,8,27,44,157,不合格
20040567,56,8,76,48,46,234,不合格
20040568,16,72,26,51,27,192,不合格
20040569,86,23,58,27,90,284,不合格
20040570,56,68,0,27,78,229,不合格
20040571,10,25,89,10,22,156,不合格
20040572,98,87,57,97,74,413,合格
20040573,29,83,63,40,7,222,不合格
20040574,58,8,26,15,72,179,不合格
20040575,0,4,6,63,37,110,不合格
20040576,40,51,29,72,38,230,不合格
20040577,86,72,90,65,24,337,合格
20040578,93,5,6,95,86,285,不合格
20040579,58,32,22,70,23,205,不合格
20040580,52,23,28,64,2,169,不合格
20040581,11,48,62,78,95,294,不合格
20040582,31,41,52,37,71,232,不合格
20040583,71,39,11,4,59,184,不合格
20040584,22,75,86,32,96,311,合格
20040585,81,91,86,89,43,390,合格
20040586,76,88,29,31,1,225,不合格
20040587,41,73,65,37,4,220,不合格
20040588,79,63,39,0,10,191,不合格
20040589,52,27,43,43,58,223,不合格
20040590,4,6,90,45,68,213,不合格
20040591,54,25,71,70,38,258,不合格
20040592,57,91,57,34,94,333,合格
20040593,86,36,61,25,43,251,不合格
20040594,34,1,49,48,37,169,不合格
20040595,77,95,46,73,46,337,合格
20040596,90,35,65,99,50,339,合格
20040597,14,44,88,71,99,316,合格
20040598,52,20,5,84,40,201,不合格
20040599,42,0,25,41,3,111,不合格
20040600,76,36,94,52,7,265,不合格
20040601,97,41,36,60,63,297,不合格
20040602,43,77,62,50,19,251,不合格
20040603,25,34,91,91,20,261,不合格
20040604,42,67,17,82,89,297,不合格
20040605,42,3,18,22,68,153,不合格
20040606,43,72,8,4,45,172,不合格
20040607,86,91,81,56,17,331,合格
20040608,26,99,84,99,37,345,合格
20040609,94,89,21,1,68,273,不合格
20040610,38,47,47,21,96,249,不合格
20040611,75,57,41,34,21,228,不合格
20040612,85,47,49,27,68,276,不合格
20040613,85,74,24,49,94,326,合格
20040614,95,37,34,66,49,281,不合格
20040615,39,72,53,2,35,201,不合格
20040616,70,9,15,31,59,184,不合格
20040617,77,70,21,89,94,351,合格
20040618,8,32,41,44,81,206,不合格
20040619,95,0,82,88,33,298,不合格
20040620,95,42,12,56,24,229,不合格
20040621,32,51,73,95,76,327,合格
20040622,36,41,83,69,27,256,不合格
20040623,93,96,65,17,87,358,合格
20040624,22,38,41,93,29,223,不合格
20040625,14,2,42,3,72,133,不合格
20040626,58,28,82,9,5,182,不合格
20040627,33,95,85,50,63,326,合格
20040628,49,99,97,82,67,394,合格
20040629,62,66,12,71,24,235,不合格
20040630,64,73,7,66,13,223,不合格
20040631,15,55,81,63,72,286,不合格
20040632,0,8,90,31,87,216,不合格
20040633,22,54,44,46,94,260,不合格
20040634,79,50,25,67,20,241,不合格
20040635,5,21,30,52,21,129,不合格
20040636,89,26,5,19,32,171,不合格
20040637,22,3,49,47,46,167,不合格
20040638,7,97,93,29,28,254,不合格
20040639,9,89,95,83,90,366,合格
20040640,57,86,15,70,3,231,不合格
20040641,67,9,55,28,68,227,不合格
20040642,75,98,37,57,69,336,合格
20040643,8,93,77,50,57,285,不合格
20040644,84,97,96,3,28,308,合格
20040645,70,93,59,11,63,296,不合格
20040646,12,54,80,87,90,323,合格
20040647,66,68,54,84,20,292,不合格
20040648,82,85,7,88,19,281,不合格
20040649,19,94,18,34,23,188,不合格
20040650,25,79,48,30,26,208,不合格
20040651,81,77,67,82,59,366,合格
20040652,49,4,67,76,4,200,不合格
20040653,53,31,47,95,37,263,不合格
20040654,8,42,45,59,9,163,不合格
20040655,30,1,11,82,88,212,不合格
20040656,35,51,49,78,53,266,不合格
20040657,10,56,28,96,73,263,不合格
20040658,86,49,65,36,96,332,合格
20040659,85,57,55,28,14,239,不合格
20040660,0,4,65,92,31,192,不合格
20040661,78,24,87,59,38,286,不合格
20040662,5,10,20,82,59,176,不合格
20040663,95,84,64,28,56,327,合格
20040664,63,90,12,65,60,290,不合格
20040665,49,1,95,62,0,207,不合格
20040666,70,42,93,52,42,299,不合格
20040667,71,23,80,46,92,312,合格
20040668,27,28,21,44,93,213,不合格
20040669,3,39,98,84,17,241,不合格
20040670,45,9,23,81,57,215,不合格
20040671,58,41,77,57,27,260,不合格
20040672,7,8,99,39,68,221,不合格
20040673,42,61,1,62,37,203,不合格
20040674,86,37,56,89,25,293,不合格
20040675,86,64,40,88,67,345,合格
20040676,98,47,60,56,57,318,合格
20040677,73,28,99,60,86,346,合格
20040678,99,25,51,41,85,301,合格
20040679,7,41,48,63,81,240,不合格
20040680,23,84,33,48,13,201,不合格
20040681,9,99,8,46,53,215,不合格
20040682,68,13,60,36,39,216,不合格
20040683,42,14,64,97,41,258,不合格
20040684,47,14,37,26,23,147,不合格
20040685,1,43,82,59,7,192,不合格
20040686,28,12,21,14,30,105,不合格
20040687,17,55,32,11,88,203,不合格
20040688,59,75,26,72,98,330,合格
20040689,73,83,85,15,96,352,合格
20040690,88,85,9,78,91,351,合格
20040691,88,17,31,85,28,249,不合格
20040692,8,12,43,31,18,112,不合格
20040693,82,47,35,1,77,242,不合格
20040694,97,40,16,69,67,289,不合格
20040695,48,0,15,90,27,180,不合格
20040696,9,3,10,74,49,145,不合格
20040697,66,20,59,45,93,283,不合格
20040698,80,28,30,89,35,262,不合格
20040699,3,28,89,59,13,192,不合格
20040700,34,20,37,21,39,151,不合格
20040701,98,17,3,63,19,200,不合格
20040702,91,80,76,81,11,339,合格
20040703,19,94,57,88,74,332,合格
20040704,65,72,49,70,22,278,不合格
20040705,32,45,92,14,67,250,不合格
20040706,58,84,54,14,61,271,不合格
20040707,4,43,77,78,83,285,不合格
20040708,35,31,0,45,93,204,不合格
20040709,59,29,52,88,8,236,不合格
20040710,30,98,68,69,36,301,合格
20040711,86,83,95,60,29,353,合格
20040712,88,60,78,20,79,325,合格
20040713,47,42,92,9,32,222,不合格
20040714,69,92,26,89,92,368,合格
20040715,42,89,85,41,38,295,不合格
20040716,28,37,61,53,67,246,不合格
20040717,40,58,88,2,4,192,不合格
20040718,69,89,10,8,25,201,不合格
20040719,72,85,71,25,91,344,合格
20040720,7,81,98,40,89,315,合格
20040721,52,46,47,42,49,236,不合格
20040722,69,23,11,15,48,166,不合格
20040723,74,43,67,29,50,263,不合格
20040724,19,44,67,14,43,187,不合格
20040725,77,45,72,78,38,310,合格
20040726,27,17,91,16,86,237,不合格
20040727,17,63,70,14,57,221,不合格
20040728,67,30,82,63,94,336,合格
20040729,81,36,19,2,6,144,不合格
20040730,7,40,47,68,39,201,不合格
20040731,53,31,74,74,74,306,合格
20040732,28,6,20,30,38,122,不合格
20040733,93,77,32,92,29,323,合格
20040734,95,2,40,83,73,293,不合格
20040735,19,35,21,72,67,214,不合格
20040736,6,28,40,59,20,153,不合格
20040737,69,58,35,78,0,240,不合格
20040738,83,17,87,90,92,369,合格
20040739,0,50,24,58,31,163,不合格
20040740,16,78,96,23,17,230,不合格
20040741,87,47,70,99,60,363,合格
20040742,46,69,43,89,88,335,合格
20040743,95,6,89,90,43,323,合格
20040744,79,5,12,50,48,194,不合格
20040745,45,66,57,0,41,209,不合格
20040746,42,24,62,65,66,259,不合格
20040747,70,41,65,83,35,294,不合格
20040748,42,90,68,0,18,218,不合格
20040749,18,92,9,91,24,234,不合格
20040750,81,31,98,95,61,366,合格
20040751,78,79,95,83,7,342,合格
20040752,20,98,88,85,37,328,合格
20040753,21,52,59,64,36,232,不合格
20040754,46,40,87,7,50,230,不合格
20040755,46,11,68,21,55,201,不合格
20040756,37,28,10,23,14,112,不合格
20040757,83,70,61,51,5,270,不合格
20040758,83,16,30,68,75,272,不合格
20040759,71,35,12,63,85,266,不合格
20040760,84,89,40,27,0,240,不合格
20040761,40,28,14,29,35,146,不合格
20040762,71,33,27,0,43,174,不合格
20040763,30,23,51,50,55,209,不合格
20040764,32,91,64,87,44,318,合格
20040765,84,74,76,17,92,343,合格
20040766,25,29,74,27,88,243,不合格
20040767,33,39,93,68,89,322,合格
20040768,65,2,62,37,32,198,不合格
20040769,76,81,46,4,25,232,不合格
20040770,94,42,17,35,14,202,不合格
20040771,23,94,12,33,63,225,不合格
20040772,28,47,18,83,94,270,不合格
20040773,70,15,51,34,63,233,不合格
20040774,18,26,81,90,42,257,不合格
20040775,94,56,22,23,73,268,不合格
20040776,92,39,63,28,34,256,不合格
20040777,86,23,6,42,70,227,不合格
20040778,40,73,37,86,31,267,不合格
20040779,40,16,82,86,29,253,不合格
20040780,70,57,26,12,56,221,不合格
20040781,36,72,10,69,34,221,不合格
20040782,85,45,67,90,11,298,不合格
20040783,3,51,6,45,19,124,不合格
20040784,71,18,59,11,93,252,不合格
20040785,89,97,38,76,10,310,合格
20040786,24,37,26,0,19,106,不合格
20040787,42,39,3,52,16,152,不合格
20040788,81,76,86,67,88,398,合格
20040789,52,3,20,7,66,148,不合格
20040790,48,55,33,34,51,221,不合格
20040791,89,39,10,75,14,227,不合格
20040792,16,64,10,26,67,183,不合格
20040793,9,35,44,74,37,199,不合格
20040794,60,88,66,45,86,345,合格
20040795,3,50,74,94,59,280,不合格
20040796,26,89,71,7,44,237,不合格
20040797,9,72,48,99,60,288,不合格
20040798,60,87,1,4,28,180,不合格
20040799,39,2,13,90,15,159,不合格
20040800,13,23,38,4,96,174,不合格
20040801,28,97,93,91,46,355,合格
20040802,90,55,92,79,83,399,合格
20040803,80,73,49,66,26,294,不合格
20040804,19,27,51,95,33,225,不合格
20040805,17,66,51,45,73,252,不合格
20040806,57,97,37,8,50,249,不合格
20040807,87,38,52,77,50,304,合格
20040808,85,87,86,58,84,400,合格
20040809,62,28,2,44,74,210,不合格
20040810,12,54,83,96,37,282,不合格
20040811,54,46,25,66,5,196,不合格
20040812,5,94,48,2,37,186,不合格
20040813,57,0,45,77,29,208,不合格
20040814,78,24,52,16,97,267,不合格
20040815,99,44,98,28,66,335,合格
20040816,44,95,29,6,23,197,不合格
20040817,39,59,65,77,39,279,不合格
20040818,26,63,82,90,78,339,合格
20040819,46,36,46,6,3,137,不合格
20040820,12,16,73,76,57,234,不合格
20040821,79,23,39,73,22,236,不合格
20040822,28,77,94,30,8,237,不合格
20040823,30,56,85,18,70,259,不合格
20040824,73,44,94,94,75,380,合格
20040825,11,53,78,57,86,285,不合格
20040826,39,47,3,51,19,159,不合格
20040827,96,63,45,65,71,340,合格
20040828,42,83,23,67,43,258,不合格
20040829,26,66,93,47,14,246,不合格
20040830,61,86,48,46,83,324,合格
20040831,43,15,76,23,48,205,不合格
20040832,18,61,44,93,29,245,不合格
20040833,22,33,81,5,88,229,不合格
20040834,74,92,6,35,90,297,不合格
20040835,58,92,51,26,58,285,不合格
20040836,49,80,60,93,66,348,合格
20040837,53,98,89,33,7,280,不合格
20040838,20,62,17,86,80,265,不合格
20040839,40,18,88,23,9,178,不合格
20040840,15,29,23,28,56,151,不合格
20040841,58,67,33,36,1,195,不合格
20040842,55,79,79,30,98,341,合格
20040843,58,31,79,10,51,229,不合格
20040844,77,32,54,69,17,249,不合格
20040845,96,85,76,32,28,317,合格
20040846,44,29,32,62,82,249,不合格
20040847,86,94,16,81,82,359,合格
20040848,9,41,45,5,37,137,不合格
20040849,45,29,89,67,11,241,不合格
20040850,29,41,28,35,83,216,不合格
20040851,3,10,58,3,94,168,不合格
20040852,7,83,38,86,44,258,不合格
20040853,37,0,69,72,10,188,不合格
20040854,19,15,24,91,22,171,不合格
20040855,19,77,84,27,84,291,不合格
20040856,92,89,37,16,86,320,合格
20040857,45,19,22,58,32,176,不合格
20040858,24,33,2,31,82,172,不合格
20040859,1,95,57,90,55,298,不合格
20040860,64,37,99,21,87,308,合格
20040861,8,90,18,56,28,200,不合格
20040862,58,24,82,30,38,232,不合格
20040863,24,41,70,10,70,215,不合格
20040864,98,12,30,93,97,330,合格
20040865,78,23,78,31,5,215,不合格
20040866,30,71,54,38,68,261,不合格
20040867,33,42,39,12,54,180,不合格
20040868,65,94,72,29,92,352,合格
20040869,5,35,15,89,44,188,不合格
20040870,45,93,15,56,34,243,不合格
20040871,13,38,77,23,96,247,不合格
20040872,21,7,11,45,94,178,不合格
20040873,68,60,7,45,46,226,不合格
20040874,28,7,57,73,9,174,不合格
20040875,19,12,25,1,71,128,不合格
20040876,81,39,27,97,9,253,不合格
20040877,20,54,22,86,25,207,不合格
20040878,47,2,6,29,44,128,不合格
20040879,89,35,93,9,24,250,不合格
20040880,2,72,3,33,21,131,不合格
20040881,40,79,6,97,95,317,合格
20040882,43,57,65,87,94,346,合格
20040883,3,45,51,72,47,218,不合格
20040884,98,91,12,35,26,262,不合格
20040885,31,75,39,68,11,224,不合格
20040886,59,17,66,9,56,207,不合格
20040887,24,59,14,67,98,262,不合格
20040888,47,67,3,69,76,262,不合格
20040889,33,7,60,42,41,183,不合格
20040890,78,75,19,15,9,196,不合格
20040891,63,55,27,33,55,233,不合格
20040892,14,77,38,16,68,213,不合格
20040893,88,89,27,29,86,319,合格
20040894,64,29,1,67,64,225,不合格
20040895,4,77,6,97,85,269,不合格
20040896,84,72,97,22,81,356,合格
20040897,85,62,13,12,55,227,不合格
20040898,49,62,38,54,32,235,不合格
20040899,38,84,75,89,17,303,合格
20040900,26,12,28,35,2,103,不合格
20040901,75,41,75,75,71,337,合格
20040902,0,71,26,91,13,201,不合格
20040903,21,83,74,33,91,302,合格
20040904,44,22,99,87,32,284,不合格
20040905,34,81,67,15,51,248,不合格
20040906,59,92,66,41,53,311,合格
20040907,3,73,37,1,1,115,不合格
20040908,19,33,40,48,83,223,不合格
20040909,55,81,39,46,22,243,不合格
20040910,17,40,48,40,28,173,不合格
20040911,15,72,16,14,57,174,不合格
20040912,56,56,68,39,27,246,不合格
20040913,75,78,71,21,89,334,合格
20040914,86,30,50,26,14,206,不合格
20040915,72,39,85,17,58,271,不合格
20040916,52,71,13,0,83,219,不合格
20040917,71,5,70,88,63,297,不合格
20040918,3,50,32,28,70,183,不合格
20040919,10,63,81,74,25,253,不合格
20040920,22,50,9,43,46,170,不合格
20040921,2,69,69,7,16,163,不合格
20040922,87,65,48,98,89,387,合格
20040923,61,46,6,10,33,156,不合格
20040924,6,93,29,31,39,198,不合格
20040925,57,25,31,59,25,197,不合格
20040926,89,21,95,28,78,311,合格
20040927,37,50,70,94,68,319,合格
20040928,42,79,65,22,58,266,不合格
20040929,39,85,10,91,51,276,不合格
20040930,22,93,4,90,6,215,不合格
20040931,65,86,36,44,35,266,不合格
20040932,82,3,45,61,10,201,不合格
20040933,13,86,72,21,77,269,不合格
20040934,71,72,78,41,59,321,合格
20040935,97,3,93,80,86,359,合格
20040936,12,29,92,52,55,240,不合格
20040937,49,2,28,79,84,242,不合格
20040938,94,47,56,23,10,230,不合格
20040939,58,32,54,46,65,255,不合格
20040940,69,25,8,42,57,201,不合格
20040941,27,12,39,36,96,210,不合格
20040942,49,64,84,11,50,258,不合格
20040943,71,64,31,82,85,333,合格
20040944,40,70,82,51,71,314,合格
20040945,75,59,9,48,55,246,不合格
20040946,20,45,49,89,39,242,不合格
20040947,76,85,79,64,74,378,合格
20040948,33,21,52,37,30,173,不合格
20040949,48,11,60,54,7,180,不合格
20040950,7,39,37,21,43,147,不合格
20040951,48,62,22,51,55,238,不合格
20040952,7,41,8,82,17,155,不合格
20040953,13,14,40,7,37,111,不合格
20040954,42,89,98,68,62,359,合格
20040955,43,88,45,44,3,223,不合格
20040956,14,35,85,8,87,229,不合格
20040957,96,11,1,93,69,270,不合格
20040958,0,50,17,85,37,189,不合格
20040959,42,22,45,36,28,173,不合格
20040960,89,52,43,92,12,288,不合格
20040961,39,68,60,40,86,293,不合格
20040962,67,29,41,77,51,265,不合格
20040963,36,19,95,39,5,194,不合格
20040964,41,92,47,73,94,347,合格
20040965,45,42,93,41,48,269,不合格
20040966,71,45,86,88,24,314,合格
20040967,26,86,45,38,35,230,不合格
20040968,48,50,12,72,94,276,不合格
20040969,17,86,86,96,72,357,合格
20040970,43,3,37,55,84,222,不合格
20040971,24,17,66,15,77,199,不合格
20040972,81,24,58,92,68,323,合格
20040973,62,56,93,80,14,305,合格
20040974,29,88,12,78,20,227,不合格
20040975,93,0,20,74,39,226,不合格
20040976,58,82,7,6,21,174,不合格
20040977,63,88,13,34,96,294,不合格
20040978,66,25,37,11,49,188,不合格
20040979,85,53,15,23,98,274,不合格
20040980,22,16,90,95,44,267,不合格
20040981,89,73,44,25,20,251,不合格
20040982,92,89,3,80,74,338,合格
20040983,3,3,81,46,69,202,不合格
20040984,61,15,21,68,48,213,不合格
20040985,89,95,10,42,31,267,不合格
20040986,2,27,24,20,90,163,不合格
20040987,30,22,8,33,61,154,不合格
20040988,41,39,28,41,23,172,不合格
20040989,75,70,80,89,63,377,合格
20040990,18,74,41,28,0,161,不合格
20040991,35,12,29,70,69,215,不合格
20040992,31,76,28,68,95,298,不合格
20040993,9,26,6,83,77,201,不合格
20040994,55,18,40,6,58,177,不合格
20040995,87,10,28,70,56,251,不合格
20040996,77,17,49,47,86,276,不合格
20040997,41,23,50,75,36,225,不合格
20040998,65,31,54,54,91,295,不合格
20040999,27,93,84,22,28,254,不合格
20041000,34,42,46,26,77,225,不合格
20041001,6,16,20,52,72,166,不合格
20041002,50,85,57,66,51,309,合格
20041003,23,46,46,3,2,120,不合格
20041004,23,60,99,29,67,278,不合格
20041005,87,72,28,75,99,361,合格
20041006,85,32,76,74,89,356,合格
20041007,47,69,18,45,48,227,不合格
20041008,14,48,97,74,82,315,合格
20041009,97,68,14,58,45,282,不合格
20041010,62,20,5,30,30,147,不合格
20041011,38,77,49,6,94,264,不合格
20041012,13,37,3,32,61,146,不合格
20041013,91,80,40,27,54,292,不合格
20041014,58,39,29,12,27,165,不合格
20041015,3,25,1,17,67,113,不合格
20041016,1,98,6,37,39,181,不合格
20041017,82,21,23,12,18,156,不合格
20041018,16,51,94,60,81,302,合格
20041019,14,67,81,0,34,196,不合格
20041020,44,60,3,41,86,234,不合格
20041021,32,5,5,75,15,132,不合格
20041022,86,81,56,31,5,259,不合格
20041023,4,91,3,13,82,193,不合格
20041024,88,90,15,60,52,305,合格
20041025,59,27,23,3,22,134,不合格
20041026,66,73,59,14,11,223,不合格
20041027,94,80,88,66,23,351,合格
20041028,58,26,86,32,8,210,不合格
20041029,80,26,11,62,49,228,不合格
20041030,2,48,91,61,28,230,不合格
20041031,36,39,42,96,71,284,不合格
20041032,63,11,69,25,67,235,不合格
20041033,68,71,43,36,18,236,不合格
20041034,66,82,20,50,53,271,不合格
20041035,15,91,79,89,47,321,合格
20041036,14,72,26,51,7,170,不合格
20041037,81,80,56,61,40,318,合格
20041038,32,65,85,58,86,326,合格
20041039,67,73,34,15,40,229,不合格
20041040,22,94,44,37,94,291,不合格
20041041,98,17,61,4,15,195,不合格
20041042,26,96,30,0,14,166,不合格
20041043,80,72,45,90,47,334,合格
20041044,98,29,36,33,14,210,不合格
20041045,45,1,17,81,67,211,不合格
20041046,46,57,28,67,26,224,不合格
20041047,82,69,5,97,44,297,不合格
20041048,94,46,15,20,52,227,不合格
20041049,99,39,15,69,78,300,合格
20041050,79,75,37,77,76,344,合格
20041051,64,12,67,79,23,245,不合格
20041052,33,3,34,68,63,201,不合格
20041053,42,57,34,23,55,211,不合格
20041054,68,28,59,41,70,266,不合格
20041055,96,0,57,54,33,240,不合格
20041056,70,94,53,51,83,351,合格
20041057,52,21,55,2,29,159,不合格
20041058,13,89,62,81,23,268,不合格
20041059,38,45,21,72,95,271,不合格
20041060,60,82,18,98,81,339,合格
20041061,14,32,31,5,48,130,不合格
20041062,62,28,65,55,26,236,不合格
20041063,54,68,87,10,20,239,不合格
20041064,8,17,9,72,95,201,不合格
20041065,5,84,93,35,92,309,合格
20041066,87,99,92,26,49,353,合格
20041067,87,17,63,11,80,258,不合格
20041068,73,21,17,17,0,128,不合格
20041069,35,31,55,24,56,201,不合格
20041070,35,23,9,61,95,223,不合格
20041071,82,55,32,36,56,261,不合格
20041072,56,67,38,41,5,207,不合格
20041073,75,34,73,66,12,260,不合格
20041074,47,54,81,39,80,301,合格
20041075,78,4,67,61,76,286,不合格
20041076,78,45,28,26,23,200,不合格
20041077,22,79,49,58,1,209,不合格
20041078,38,97,80,96,25,336,合格
20041079,49,61,26,44,12,192,不合格
20041080,28,6,60,75,17,186,不合格
20041081,68,51,99,86,45,349,合格
20041082,84,2,0,74,20,180,不合格
20041083,67,41,84,90,36,318,合格
20041084,25,14,76,75,43,233,不合格
20041085,83,86,96,76,94,435,合格
20041086,0,55,65,89,53,262,不合格
20041087,57,48,66,55,46,272,不合格
20041088,25,71,19,93,58,266,不合格
20041089,17,78,51,6,79,231,不合格
20041090,61,36,90,71,94,352,合格
20041091,99,51,31,14,42,237,不合格
20041092,36,62,13,22,96,229,不合格
20041093,77,51,64,56,25,273,不合格
20041094,27,23,43,15,46,154,不合格
20041095,86,35,60,68,48,297,不合格
20041096,27,37,55,91,8,218,不合格
20041097,53,83,15,37,15,203,不合格
20041098,9,93,51,95,49,297,不合格
20041099,76,32,18,60,91,277,不合格
20041100,49,43,81,93,83,349,合格
20041101,41,2,64,82,9,198,不合格
20041102,1,28,6,32,80,147,不合格
20041103,27,71,95,98,80,371,合格
20041104,18,23,8,1,89,139,不合格
20041105,72,25,67,52,49,265,不合格
20041106,51,89,64,47,42,293,不合格
20041107,58,72,77,65,55,327,合格
20041108,66,26,69,40,91,292,不合格
20041109,8,9,15,83,70,185,不合格
20041110,83,2,63,79,21,248,不合格
20041111,23,94,99,98,31,345,合格
20041112,9,8,19,24,97,157,不合格
20041113,6,62,66,57,65,256,不合格
20041114,60,75,47,52,26,260,不合格
20041115,82,84,12,79,58,315,合格
20041116,55,55,47,82,45,284,不合格
20041117,32,82,12,87,37,250,不合格
20041118,96,72,64,57,27,316,合格
20041119,31,83,87,85,79,365,合格
20041120,32,59,91,18,89,289,不合格
20041121,69,47,25,70,16,227,不合格
20041122,90,10,11,90,47,248,不合格
20041123,55,36,53,83,80,307,合格
20041124,24,74,23,21,33,175,不合格
20041125,60,95,52,32,58,297,不合格
20041126,3,30,22,34,13,102,不合格
20041127,78,10,75,64,21,248,不合格
20041128,11,1,95,29,24,160,不合格
20041129,36,94,20,28,90,268,不合格
20041130,80,32,76,49,20,257,不合格
20041131,9,41,86,51,75,262,不合格
20041132,13,52,66,99,93,323,合格
20041133,7,43,65,67,96,278,不合格
20041134,12,96,71,4,52,235,不合格
20041135,1,23,38,23,62,147,不合格
20041136,77,34,72,73,9,265,不合格
20041137,97,72,27,87,60,343,合格
20041138,75,81,73,20,82,331,合格
20041139,89,1,97,96,21,304,合格
20041140,37,23,88,32,37,217,不合格
20041141,11,53,31,98,53,246,不合格
20041142,52,28,19,27,57,183,不合格
20041143,43,28,14,33,1,119,不合格
20041144,82,0,80,5,17,184,不合格
20041145,56,72,57,32,4,221,不合格
20041146,21,5,15,73,65,179,不合格
20041147,86,21,10,24,91,232,不合格
20041148,7,94,55,62,1,219,不合格
20041149,52,65,65,42,36,260,不合格
20041150,89,59,87,8,58,301,合格
20041151,81,52,27,15,43,218,不合格
20041152,36,99,72,67,82,356,合格
20041153,65,46,67,72,91,341,合格
20041154,12,70,8,10,99,199,不合格
20041155,73,38,5,80,76,272,不合格
20041156,79,86,14,96,1,276,不合格
20041157,26,28,13,44,0,111,不合格
20041158,10,69,9,96,50,234,不合格
20041159,59,95,22,5,1,182,不合格
20041160,41,62,68,59,45,275,不合格
20041161,82,30,50,80,18,260,不合格
20041162,9,38,40,46,76,209,不合格
20041163,87,20,39,71,77,294,不合格
20041164,93,53,75,79,40,340,合格
20041165,3,83,39,17,39,181,不合格
20041166,19,97,73,59,55,303,合格
20041167,75,85,45,60,88,353,合格
20041168,4,79,15,23,88,209,不合格
20041169,59,42,8,61,2,172,不合格
20041170,17,82,95,43,63,300,合格
20041171,93,20,73,90,67,343,合格
20041172,32,92,80,91,27,322,合格
20041173,55,11,29,40,93,228,不合格
20041174,27,32,15,95,50,219,不合格
20041175,3,42,72,81,14,212,不合格
20041176,78,63,11,56,70,278,不合格
20041177,32,14,26,61,37,170,不合格
20041178,67,4,29,24,70,194,不合格
20041179,75,6,83,59,79,302,合格
20041180,4,75,98,57,14,248,不合格
20041181,6,74,28,1,71,180,不合格
20041182,92,67,31,45,4,239,不合格
20041183,9,23,67,63,82,244,不合格
20041184,65,15,58,33,24,195,不合格
20041185,90,0,15,28,52,185,不合格
20041186,32,27,61,30,64,214,不合格
20041187,20,9,8,99,1,137,不合格
20041188,82,64,90,7,45,288,不合格
20041189,62,0,42,87,7,198,不合格
20041190,6,53,75,4,70,208,不合格
20041191,27,25,34,23,26,135,不合格
20041192,92,53,64,60,35,304,合格
20041193,15,83,50,65,83,296,不合格
20041194,13,45,87,44,78,267,不合格
20041195,49,29,23,39,18,158,不合格
20041196,32,15,12,24,33,116,不合格
20041197,11,47,54,95,74,281,不合格
20041198,22,62,25,24,66,199,不合格
20041199,68,11,34,7,67,187,不合格
20041200,84,26,76,81,19,286,不合格
20041201,72,28,45,73,97,315,合格
20041202,3,60,60,99,14,236,不合格
20041203,15,74,8,95,16,208,不合格
20041204,5,4,26,38,79,152,不合格
20041205,92,75,16,89,24,296,不合格
20041206,81,39,20,84,72,296,不合格
20041207,16,49,19,90,3,177,不合格
20041208,36,11,42,8,82,179,不合格
20041209,1,15,84,79,11,190,不合格
20041210,58,8,83,55,6,210,不合格
20041211,35,63,53,0,48,199,不合格
20041212,75,97,74,75,5,326,合格
20041213,59,37,71,42,26,235,不合格
20041214,61,97,86,23,79,346,合格
20041215,44,46,74,27,11,202,不合格
20041216,30,7,40,54,88,219,不合格
20041217,14,26,21,85,56,202,不合格
20041218,56,9,40,52,74,231,不合格
20041219,45,93,99,48,60,345,合格
20041220,44,38,56,70,54,262,不合格
20041221,9,52,77,6,37,181,不合格
20041222,57,85,17,15,91,265,不合格
20041223,81,80,77,84,30,352,合格
20041224,82,96,49,82,86,395,合格
20041225,39,42,13,81,23,198,不合格
20041226,15,55,53,47,97,267,不合格
20041227,24,8,62,89,96,279,不合格
20041228,52,21,45,59,73,250,不合格
20041229,84,44,94,26,90,338,合格
20041230,26,20,18,1,25,90,不合格
20041231,29,5,78,52,69,233,不合格
20041232,29,45,97,24,87,282,不合格
20041233,9,91,56,91,23,270,不合格
20041234,79,14,24,68,79,264,不合格
20041235,23,63,40,32,8,166,不合格
20041236,73,93,85,25,48,324,合格
20041237,11,80,86,26,22,225,不合格
20041238,59,80,69,13,19,240,不合格
20041239,72,62,46,67,14,261,不合格
20041240,30,26,85,27,30,198,不合格
20041241,70,99,14,26,6,215,不合格
20041242,63,84,7,12,45,211,不合格
20041243,50,60,59,50,87,306,合格
20041244,28,77,68,37,25,235,不合格
20041245,13,54,65,9,71,212,不合格
20041246,16,2,84,60,99,261,不合格
20041247,26,4,73,49,47,199,不合格
20041248,82,75,43,94,27,321,合格
20041249,10,74,10,79,59,232,不合格
20041250,22,37,13,74,96,242,不合格
20041251,96,63,36,82,52,329,合格
20041252,34,36,88,49,81,288,不合格
20041253,39,8,28,5,16,96,不合格
20041254,6,33,0,88,71,198,不合格
20041255,45,95,96,55,48,339,合格
20041256,22,21,60,88,56,247,不合格
20041257,89,15,66,97,81,348,合格
20041258,94,10,83,0,50,237,不合格
20041259,0,8,50,23,9,90,不合格
20041260,93,3,25,32,28,181,不合格
20041261,18,75,51,34,43,221,不合格
20041262,46,11,36,40,13,146,不合格
20041263,32,71,74,57,20,254,不合格
20041264,64,65,2,76,16,223,不合格
20041265,30,35,27,16,29,137,不合格
20041266,86,9,50,32,10,187,不合格
20041267,68,74,99,73,34,348,合格
20041268,95,34,93,54,38,314,合格
20041269,44,39,6,6,77,172,不合格
20041270,33,20,49,89,35,226,不合格
20041271,76,79,35,20,47,257,不合格
20041272,14,20,27,93,75,229,不合格
20041273,74,99,53,10,95,331,合格
20041274,51,49,82,95,51,328,合格
20041275,76,53,22,23,86,260,不合格
20041276,38,85,91,66,31,311,合格
20041277,91,13,6,0,20,130,不合格
20041278,79,80,63,93,55,370,合格
20041279,59,61,60,21,45,246,不合格
20041280,68,98,9,92,41,308,合格
20041281,72,5,24,70,46,217,不合格
20041282,45,22,73,35,39,214,不合格
20041283,73,8,29,60,56,226,不合格
20041284,98,6,67,26,55,252,不合格
20041285,96,6,89,25,44,260,不合格
20041286,6,92,57,4,83,242,不合格
20041287,93,51,1,28,85,258,不合格
20041288,10,53,87,65,10,225,不合格
20041289,30,65,86,77,88,346,合格
20041290,1,4,11,82,54,152,不合格
20041291,12,7,89,12,98,218,不合格
20041292,24,16,4,22,13,79,不合格
20041293,53,86,57,81,92,369,合格
20041294,68,76,88,15,84,331,合格
20041295,87,55,2,67,40,251,不合格
20041296,86,85,89,67,77,404,合格
20041297,58,21,71,20,79,249,不合格
20041298,32,5,22,55,48,162,不合格
20041299,19,79,85,61,82,326,合格
20041300,13,91,0,40,34,178,不合格
20041301,76,34,55,94,99,358,合格
20041302,75,88,25,67,88,343,合格
20041303,90,27,14,38,75,244,不合格
20041304,23,27,63,99,14,226,不合格
20041305,20,90,61,28,70,269,不合格
20041306,15,27,41,74,11,168,不合格
20041307,7,89,44,18,6,164,不合格
20041308,19,80,5,84,91,279,不合格
20041309,60,52,38,97,66,313,合格
20041310,45,53,56,54,37,245,不合格
20041311,42,49,40,91,62,284,不合格
20041312,73,9,86,81,26,275,不合格
20041313,77,90,69,36,94,366,合格
20041314,91,12,98,5,91,297,不合格
20041315,5,14,93,55,63,230,不合格
20041316,94,94,77,48,17,330,合格
20041317,48,82,8,66,35,239,不合格
20041318,99,50,76,71,86,382,合格
20041319,74,39,78,41,43,275,不合格
20041320,34,73,18,86,41,252,不合格
20041321,26,1,61,82,10,180,不合格
20041322,58,83,52,14,91,298,不合格
20041323,66,44,45,30,48,233,不合格
20041324,50,26,89,76,74,315,合格
20041325,78,34,85,88,95,380,合格
20041326,98,16,56,42,18,230,不合格
20041327,87,30,45,80,47,289,不合格
20041328,16,50,79,51,4,200,不合格
20041329,79,20,55,71,9,234,不合格
20041330,68,86,66,92,89,401,合格
20041331,22,61,19,65,18,185,不合格
20041332,0,51,64,89,29,233,不合格
20041333,60,26,81,40,81,288,不合格
20041334,85,47,29,76,31,268,不合格
20041335,37,66,69,72,89,333,合格
20041336,34,80,35,89,18,256,不合格
20041337,29,29,44,26,49,177,不合格
20041338,21,76,57,32,5,191,不合格
20041339,39,10,2,85,74,210,不合格
20041340,42,73,72,95,91,373,合格
20041341,98,25,95,86,41,345,合格
20041342,8,83,4,49,60,204,不合格
20041343,73,95,99,64,50,381,合格
20041344,39,56,42,79,22,238,不合格
20041345,3,46,65,50,90,254,不合格
20041346,12,74,43,38,0,167,不合格
20041347,2,37,8,0,34,81,不合格
20041348,75,43,2,18,79,217,不合格
20041349,79,27,80,64,40,290,不合格
20041350,34,67,46,55,34,236,不合格
20041351,24,70,66,41,35,236,不合格
20041352,42,61,16,13,44,176,不合格
20041353,75,66,37,34,97,309,合格
20041354,59,87,89,80,28,343,合格
20041355,97,76,83,44,94,394,合格
20041356,83,55,62,72,27,299,不合格
20041357,79,19,39,73,69,279,不合格
20041358,30,2,42,97,6,177,不合格
20041359,39,52,6,99,13,209,不合格
20041360,92,52,43,32,62,281,不合格
20041361,33,2,11,34,77,157,不合格
20041362,57,88,6,12,68,231,不合格
20041363,47,78,55,79,86,345,合格
20041364,42,34,70,8,89,243,不合格
20041365,76,58,70,49,82,335,合格
20041366,15,44,88,71,1,219,不合格
20041367,1,5,42,30,36,114,不合格
20041368,72,88,49,60,81,350,合格
20041369,88,18,40,61,73,280,不合格
20041370,47,6,10,28,38,129,不合格
20041371,68,68,91,31,42,300,合格
20041372,40,12,87,76,15,230,不合格
20041373,66,35,53,44,16,214,不合格
20041374,8,63,22,50,53,196,不合格
20041375,61,96,69,46,37,309,合格
20041376,21,30,84,19,78,232,不合格
20041377,27,45,45,64,88,269,不合格
20041378,2,15,15,24,27,83,不合格
20041379,79,44,45,18,4,190,不合格
20041380,35,35,88,65,74,297,不合格
20041381,92,37,48,29,61,267,不合格
20041382,85,26,52,87,80,330,合格
20041383,12,26,53,80,87,258,不合格
20041384,91,47,32,67,96,333,合格
20041385,41,48,9,0,94,192,不合格
20041386,34,69,43,76,73,295,不合格
20041387,58,98,63,89,35,343,合格
20041388,62,93,71,91,3,320,合格
20041389,47,79,22,61,84,293,不合格
20041390,66,52,28,33,2,181,不合格
20041391,81,68,87,70,80,386,合格
20041392,0,64,15,85,1,165,不合格
20041393,66,35,74,58,55,288,不合格
20041394,38,83,13,52,10,196,不合格
20041395,26,91,33,11,24,185,不合格
20041396,12,30,72,21,23,158,不合格
20041397,80,37,39,22,31,209,不合格
20041398,10,57,25,64,92,248,不合格
20041399,32,90,8,27,76,233,不合格
20041400,70,8,71,57,21,227,不合格
20041401,85,43,37,88,75,328,合格
20041402,8,12,35,34,34,123,不合格
20041403,48,81,88,66,96,379,合格
20041404,31,66,58,42,84,281,不合格
20041405,97,43,28,7,73,248,不合格
20041406,19,55,60,19,5,158,不合格
20041407,86,92,15,30,35,258,不合格
20041408,35,36,45,42,17,175,不合格
20041409,51,87,37,80,99,354,合格
20041410,52,72,21,75,82,302,合格
20041411,68,64,63,30,53,278,不合格
20041412,75,48,2,34,95,254,不合格
20041413,54,14,21,65,76,230,不合格
20041414,46,96,77,18,30,267,不合格
20041415,16,42,66,57,63,244,不合格
20041416,86,62,47,26,97,318,合格
20041417,40,5,65,45,3,158,不合格
20041418,92,5,56,51,2,206,不合格
20041419,4,61,47,45,6,163,不合格
20041420,89,42,98,0,74,303,合格
20041421,94,9,57,10,56,226,不合格
20041422,62,56,59,8,30,215,不合格
20041423,91,47,99,14,10,261,不合格
20041424,65,7,63,49,64,248,不合格
20041425,77,72,84,91,43,367,合格
20041426,73,54,27,84,3,241,不合格
20041427,70,62,89,69,61,351,合格
20041428,0,8,24,55,74,161,不合格
20041429,84,51,51,49,19,254,不合格
20041430,39,88,2,50,69,248,不合格
20041431,51,84,40,57,3,235,不合格
20041432,51,80,72,56,82,341,合格
20041433,55,91,13,30,47,236,不合格
20041434,48,54,95,11,95,303,合格
20041435,2,12,57,83,12,166,不合格
20041436,38,70,0,7,44,159,不合格
20041437,17,90,56,82,56,301,合格
20041438,67,9,28,17,26,147,不合格
20041439,81,53,85,87,97,403,合格
20041440,34,6,80,6,15,141,不合格
20041441,48,0,86,91,2,227,不合格
20041442,15,16,55,64,35,185,不合格
20041443,71,54,51,68,78,322,合格
20041444,62,96,34,14,48,254,不合格
20041445,16,76,33,14,92,231,不合格
20041446,57,20,68,93,28,266,不合格
20041447,92,80,40,84,61,357,合格
20041448,52,49,20,26,71,218,不合格
20041449,6,73,30,36,79,224,不合格
20041450,7,71,86,52,78,294,不合格
20041451,99,25,59,28,54,265,不合格
20041452,53,48,14,18,4,137,不合格
20041453,68,9,67,56,73,273,不合格
20041454,20,40,5,72,95,232,不合格
20041455,96,13,0,75,2,186,不合格
20041456,26,53,57,36,86,258,不合格
20041457,30,71,57,24,62,244,不合格
20041458,77,6,65,28,53,229,不合格
20041459,47,43,62,42,64,258,不合格
20041460,13,56,71,34,31,205,不合格
20041461,15,45,98,43,37,238,不合格
20041462,66,64,45,32,81,288,不合格
20041463,27,75,45,78,97,322,合格
20041464,37,51,5,49,83,225,不合格
20041465,20,8,92,69,50,239,不合格
20041466,85,81,34,71,11,282,不合格
20041467,72,73,36,40,76,297,不合格
20041468,60,45,98,92,3,298,不合格
20041469,67,15,60,91,89,322,合格
20041470,1,18,55,69,82,225,不合格
20041471,62,82,49,6,2,201,不合格
20041472,3,72,4,82,20,181,不合格
20041473,75,22,25,44,5,171,不合格
20041474,72,3,53,26,60,214,不合格
20041475,99,68,28,13,37,245,不合格
20041476,14,89,90,25,95,313,合格
20041477,58,19,8,35,46,166,不合格
20041478,1,14,41,19,54,129,不合格
20041479,43,2,37,30,63,175,不合格
20041480,89,90,88,30,13,310,合格
20041481,31,61,79,16,29,216,不合格
20041482,73,54,59,7,35,228,不合格
20041483,22,65,75,10,26,198,不合格
20041484,35,10,77,35,77,234,不合格
20041485,88,37,66,70,30,291,不合格
20041486,46,99,82,40,63,330,合格
20041487,25,7,82,2,91,207,不合格
20041488,68,17,49,87,86,307,合格
20041489,56,41,36,29,63,225,不合格
20041490,31,79,15,69,35,229,不合格
20041491,11,82,41,40,91,265,不合格
20041492,81,77,91,24,31,304,合格
20041493,48,37,9,66,70,230,不合格
20041494,0,6,49,12,29,96,不合格
20041495,12,87,1,59,0,159,不合格
20041496,98,63,91,98,60,410,合格
20041497,92,25,29,69,16,231,不合格
20041498,8,38,82,27,7,162,不合格
20041499,22,6,54,27,17,126,不合格
20041500,48,51,58,81,80,318,合格
20041501,88,88,72,91,75,414,合格
20041502,52,79,95,5,36,267,不合格
20041503,48,85,51,93,44,321,合格
20041504,13,17,6,45,29,110,不合格
20041505,5,21,5,75,69,175,不合格
20041506,60,7,10,41,65,183,不合格
20041507,22,71,36,63,15,207,不合格
20041508,86,78,92,45,95,396,合格
20041509,57,45,60,61,48,271,不合格
20041510,62,41,60,93,98,354,合格
20041511,23,4,17,27,60,131,不合格
20041512,50,95,50,17,60,272,不合格
20041513,97,17,89,53,29,285,不合格
20041514,71,44,96,38,49,298,不合格
20041515,9,22,63,24,93,211,不合格
20041516,77,98,23,70,29,297,不合格
20041517,32,79,58,16,70,255,不合格
20041518,3,78,58,7,63,209,不合格
20041519,90,60,3,63,60,276,不合格
20041520,58,88,0,89,28,263,不合格
20041521,60,93,26,27,78,284,不合格
20041522,60,34,25,97,96,312,合格
20041523,79,51,40,48,56,274,不合格
20041524,37,5,45,33,13,133,不合格
20041525,67,21,61,30,77,256,不合格
20041526,85,34,18,95,26,258,不合格
20041527,94,81,58,2,99,334,合格
20041528,52,19,16,59,96,242,不合格
20041529,23,98,56,17,67,261,不合格
20041530,85,93,85,34,13,310,合格
20041531,0,15,70,14,49,148,不合格
20041532,53,75,93,68,72,361,合格
20041533,59,37,18,98,28,240,不合格
20041534,26,98,41,20,6,191,不合格
20041535,9,26,57,26,99,217,不合格
20041536,51,43,7,74,39,214,不合格
20041537,66,46,23,13,85,233,不合格
20041538,15,88,98,25,68,294,不合格
20041539,31,71,10,43,89,244,不合格
20041540,75,46,58,66,46,291,不合格
20041541,0,90,11,55,47,203,不合格
20041542,13,96,28,2,5,144,不合格
20041543,42,62,69,90,58,321,合格
20041544,1,29,78,0,94,202,不合格
20041545,5,24,80,54,78,241,不合格
20041546,60,82,35,28,63,268,不合格
20041547,9,18,97,9,52,185,不合格
20041548,13,58,85,88,9,253,不合格
20041549,47,66,59,85,55,312,合格
20041550,44,84,51,45,69,293,不合格
20041551,10,18,59,75,70,232,不合格
20041552,14,0,95,61,61,231,不合格
20041553,62,40,93,88,63,346,合格
20041554,59,29,17,90,35,230,不合格
20041555,24,19,53,68,48,212,不合格
20041556,55,52,81,81,1,270,不合格
20041557,54,9,29,75,5,172,不合格
20041558,89,34,43,52,6,224,不合格
20041559,50,1,23,93,85,252,不合格
20041560,79,45,19,87,46,276,不合格
20041561,86,52,90,62,92,382,合格
20041562,62,23,96,62,19,262,不合格
20041563,54,28,87,40,41,250,不合格
20041564,87,24,13,14,73,211,不合格
20041565,76,90,44,45,0,255,不合格
20041566,42,99,37,80,83,341,合格
20041567,57,12,75,71,0,215,不合格
20041568,71,97,80,37,52,337,合格
20041569,25,88,98,16,17,244,不合格
20041570,88,53,25,76,51,293,不合格
20041571,36,92,78,25,32,263,不合格
20041572,8,26,46,91,11,182,不合格
20041573,65,65,96,17,19,262,不合格
20041574,63,81,90,17,2,253,不合格
20041575,65,47,5,79,99,295,不合格
20041576,79,22,22,33,95,251,不合格
20041577,88,7,42,78,85,300,合格
20041578,90,47,39,36,0,212,不合格
20041579,97,22,64,46,4,233,不合格
20041580,74,34,9,50,26,193,不合格
20041581,49,45,20,74,49,237,不合格
20041582,99,68,72,3,85,327,合格
20041583,56,68,86,48,18,276,不合格
20041584,19,58,74,25,40,216,不合格
20041585,42,44,8,12,58,164,不合格
20041586,68,91,44,24,62,289,不合格
20041587,32,45,6,22,91,196,不合格
20041588,86,60,63,24,64,297,不合格
20041589,20,91,86,31,53,281,不合格
20041590,84,97,61,5,8,255,不合格
20041591,2,45,26,18,52,143,不合格
20041592,83,50,67,18,64,282,不合格
20041593,39,4,90,33,37,203,不合格
20041594,10,20,31,40,85,186,不合格
20041595,77,27,86,97,32,319,合格
20041596,57,81,57,55,8,258,不合格
20041597,56,66,88,39,24,273,不合格
20041598,51,12,40,52,9,164,不合格
20041599,82,57,79,9,91,318,合格
20041600,85,94,50,64,10,303,合格
20041601,36,86,79,74,28,303,合格
20041602,33,76,8,35,2,154,不合格
20041603,17,29,53,45,24,168,不合格
20041604,36,45,50,68,19,218,不合格
20041605,17,57,39,43,61,217,不合格
20041606,77,95,18,51,31,272,不合格
20041607,23,6,22,95,58,204,不合格
20041608,47,20,74,66,93,300,合格
20041609,75,18,23,36,51,203,不合格
20041610,60,18,98,84,63,323,合格
20041611,16,73,98,4,5,196,不合格
20041612,52,94,28,94,4,272,不合格
20041613,34,24,90,88,0,236,不合格
20041614,80,80,80,98,92,430,合格
20041615,82,82,42,61,70,337,合格
20041616,31,56,72,33,99,291,不合格
20041617,71,63,75,27,38,274,不合格
20041618,92,7,32,81,55,267,不合格
20041619,98,24,57,16,43,238,不合格
20041620,86,40,75,85,88,374,合格
20041621,60,24,50,81,6,221,不合格
20041622,24,18,42,72,44,200,不合格
20041623,90,16,91,13,65,275,不合格
20041624,13,53,58,16,8,148,不合格
20041625,41,70,33,10,18,172,不合格
20041626,28,34,94,69,31,256,不合格
20041627,49,93,99,64,22,327,合格
20041628,35,95,35,19,11,195,不合格
20041629,37,96,41,6,32,212,不合格
20041630,19,35,13,50,56,173,不合格
20041631,29,75,54,54,58,270,不合格
20041632,35,17,8,25,87,172,不合格
20041633,24,14,61,76,76,251,不合格
20041634,86,3,27,80,42,238,不合格
20041635,43,2,91,32,16,184,不合格
20041636,55,35,88,30,3,211,不合格
20041637,55,80,48,32,16,231,不合格
20041638,28,52,88,58,7,233,不合格
20041639,90,40,62,66,73,331,合格
20041640,89,95,14,71,54,323,合格
20041641,88,52,73,19,98,330,合格
20041642,51,65,48,84,99,347,合格
20041643,63,12,36,65,13,189,不合格
20041644,42,12,25,70,32,181,不合格
20041645,44,37,0,72,20,173,不合格
20041646,30,36,5,6,33,110,不合格
20041647,75,2,85,87,12,261,不合格
20041648,94,84,63,69,71,381,合格
20041649,54,32,21,16,11,134,不合格
20041650,78,16,30,19,26,169,不合格
20041651,65,59,50,71,25,270,不合格
20041652,25,26,87,71,33,242,不合格
20041653,31,52,84,92,18,277,不合格
20041654,6,39,87,45,33,210,不合格
20041655,5,4,9,30,98,146,不合格
20041656,5,61,46,58,88,258,不合格
20041657,26,68,9,52,22,177,不合格
20041658,68,4,12,33,89,206,不合格
20041659,22,1,5,26,6,60,不合格
20041660,33,64,25,87,48,257,不合格
20041661,95,86,82,8,28,299,不合格
20041662,87,5,17,32,75,216,不合格
20041663,15,77,59,38,24,213,不合格
20041664,51,84,66,54,58,313,合格
20041665,87,92,44,4,95,322,合格
20041666,1,75,28,22,69,195,不合格
20041667,92,7,40,48,18,205,不合格
20041668,52,86,6,6,83,233,不合格
20041669,11,90,63,9,71,244,不合格
20041670,20,68,38,93,45,264,不合格
20041671,20,35,23,12,6,96,不合格
20041672,58,20,36,19,18,151,不合格
20041673,18,70,31,88,95,302,合格
20041674,95,59,75,18,39,286,不合格
20041675,52,42,55,89,52,290,不合格
20041676,45,77,18,47,8,195,不合格
20041677,80,65,93,86,54,378,合格
20041678,99,88,27,63,41,318,合格
20041679,10,27,58,76,39,210,不合格
20041680,41,20,53,22,86,222,不合格
20041681,8,53,61,80,94,296,不合格
20041682,67,25,59,72,82,305,合格
20041683,50,70,93,60,80,353,合格
20041684,29,55,15,22,58,179,不合格
20041685,36,14,93,94,58,295,不合格
20041686,96,43,92,81,65,377,合格
20041687,36,11,53,81,18,199,不合格
20041688,46,14,71,31,49,211,不合格
20041689,23,34,77,99,15,248,不合格
20041690,42,43,49,20,79,233,不合格
20041691,14,93,32,45,74,258,不合格
20041692,4,53,94,57,13,221,不合格
20041693,60,97,74,56,89,376,合格
20041694,54,73,33,10,71,241,不合格
20041695,45,96,58,57,95,351,合格
20041696,94,70,98,4,51,317,合格
20041697,10,36,2,10,24,82,不合格
20041698,63,89,66,9,98,325,合格
20041699,62,27,59,82,51,281,不合格
20041700,8,37,34,15,82,176,不合格
20041701,68,26,78,7,49,228,不合格
20041702,95,93,11,77,94,370,合格
20041703,63,37,45,33,0,178,不合格
20041704,71,4,0,66,87,228,不合格
20041705,57,4,80,45,96,282,不合格
20041706,94,1,5,22,96,218,不合格
20041707,23,31,68,24,47,193,不合格
20041708,25,73,60,14,34,206,不合格
20041709,83,0,21,30,22,156,不合格
20041710,72,13,11,50,86,232,不合格
20041711,39,14,86,24,26,189,不合格
20041712,80,37,21,42,46,226,不合格
20041713,81,72,25,18,78,274,不合格
20041714,54,24,5,32,27,142,不合格
20041715,1,23,7,59,44,134,不合格
20041716,68,62,93,8,96,327,合格
20041717,65,58,20,68,29,240,不合格
20041718,40,78,24,28,72,242,不合格
20041719,51,62,1,75,40,229,不合格
20041720,83,37,0,50,53,223,不合格
20041721,73,38,32,88,65,296,不合格
20041722,82,26,63,1,25,197,不合格
20041723,37,88,11,50,59,245,不合格
20041724,90,24,9,55,13,191,不合格
20041725,31,73,52,89,13,258,不合格
20041726,5,97,7,24,67,200,不合格
20041727,15,58,12,88,50,223,不合格
20041728,37,48,59,6,50,200,不合格
20041729,38,18,39,11,63,169,不合格
20041730,89,16,25,85,12,227,不合格
20041731,92,54,24,27,65,262,不合格
20041732,55,38,72,52,42,259,不合格
20041733,60,50,46,40,74,270,不合格
20041734,98,59,6,28,17,208,不合格
20041735,64,48,27,53,76,268,不合格
20041736,84,31,22,15,3,155,不合格
20041737,29,91,56,78,78,332,合格
20041738,77,96,26,82,25,306,合格
20041739,88,30,40,13,72,243,不合格
20041740,33,49,37,26,36,181,不合格
20041741,55,72,43,91,23,284,不合格
20041742,47,26,50,66,45,234,不合格
20041743,51,43,6,73,52,225,不合格
20041744,70,69,10,5,50,204,不合格
20041745,28,41,31,97,14,211,不合格
20041746,97,69,1,64,87,318,合格
20041747,42,22,37,98,98,297,不合格
20041748,95,79,10,68,62,314,合格
20041749,75,78,50,87,22,312,合格
20041750,91,92,80,94,1,358,合格
20041751,59,1,52,60,49,221,不合格
20041752,23,44,61,7,6,141,不合格
20041753,75,64,85,50,68,342,合格
20041754,77,27,28,37,80,249,不合格
20041755,41,34,19,10,54,158,不合格
20041756,54,34,74,79,20,261,不合格
20041757,20,93,31,76,38,258,不合格
20041758,32,9,44,72,75,232,不合格
20041759,6,91,84,36,25,242,不合格
20041760,39,54,80,33,85,291,不合格
20041761,18,47,18,56,45,184,不合格
20041762,27,85,20,52,54,238,不合格
20041763,12,83,23,70,77,265,不合格
20041764,10,30,87,34,68,229,不合格
20041765,73,25,79,65,75,317,合格
20041766,2,49,70,45,94,260,不合格
20041767,52,55,33,56,37,233,不合格
20041768,15,22,63,57,48,205,不合格
20041769,63,27,73,87,3,253,不合格
20041770,35,20,14,93,29,191,不合格
20041771,98,20,47,86,95,346,合格
20041772,93,49,94,93,52,381,合格
20041773,28,50,58,86,70,292,不合格
20041774,90,8,36,54,60,248,不合格
20041775,39,10,76,48,53,226,不合格
20041776,18,13,64,45,3,143,不合格
20041777,76,46,59,61,90,332,合格
20041778,57,35,49,60,6,207,不合格
20041779,39,79,43,85,3,249,不合格
20041780,50,50,48,73,59,280,不合格
20041781,39,57,55,61,80,292,不合格
20041782,45,6,28,36,30,145,不合格
20041783,19,66,21,76,63,245,不合格
20041784,2,23,4,40,85,154,不合格
20041785,69,60,21,47,28,225,不合格
20041786,98,49,49,20,37,253,不合格
20041787,89,63,40,2,31,225,不合格
20041788,13,34,90,62,25,224,不合格
20041789,60,85,66,11,83,305,合格
20041790,51,70,0,39,49,209,不合格
20041791,41,78,3,68,34,224,不合格
20041792,47,84,74,6,14,225,不合格
20041793,85,4,30,55,89,263,不合格
20041794,27,13,28,17,44,129,不合格
20041795,99,90,24,18,59,290,不合格
20041796,92,1,3,12,94,202,不合格
20041797,70,44,58,15,38,225,不合格
20041798,77,28,89,72,97,363,合格
20041799,52,71,89,89,61,362,合格
20041800,5,42,20,43,11,121,不合格
20041801,8,16,80,74,82,260,不合格
20041802,25,70,35,40,19,189,不合格
20041803,59,50,66,82,0,257,不合格
20041804,30,72,81,77,97,357,合格
20041805,11,47,98,88,31,275,不合格
20041806,40,56,76,69,65,306,合格
20041807,46,31,17,60,71,225,不合格
20041808,66,45,77,28,12,228,不合格
20041809,64,3,24,13,87,191,不合格
20041810,25,10,70,97,94,296,不合格
20041811,8,91,39,80,64,282,不合格
20041812,32,72,21,49,58,232,不合格
20041813,6,13,88,20,16,143,不合格
20041814,86,13,90,12,39,240,不合格
20041815,64,82,11,81,56,294,不合格
20041816,18,81,68,89,17,273,不合格
20041817,74,9,28,44,57,212,不合格
20041818,50,37,52,12,99,250,不合格
20041819,46,94,76,31,24,271,不合格
20041820,21,12,7,78,81,199,不合格
20041821,35,56,92,2,84,269,不合格
20041822,15,43,60,65,53,236,不合格
20041823,32,91,39,44,21,227,不合格
20041824,56,57,56,33,92,294,不合格
20041825,42,49,70,54,68,283,不合格
20041826,24,13,99,62,91,289,不合格
20041827,3,55,56,99,51,264,不合格
20041828,5,48,7,91,59,210,不合格
20041829,46,13,6,14,31,110,不合格
20041830,6,90,3,61,74,234,不合格
20041831,15,13,82,84,48,242,不合格
20041832,68,28,23,70,37,226,不合格
20041833,97,38,44,87,32,298,不合格
20041834,19,33,32,70,78,232,不合格
20041835,97,25,92,90,31,335,合格
20041836,93,8,41,71,49,262,不合格
20041837,55,1,49,97,76,278,不合格
20041838,3,7,69,91,41,211,不合格
20041839,7,95,59,42,36,239,不合格
20041840,45,88,80,24,19,256,不合格
20041841,69,27,67,33,22,218,不合格
20041842,34,49,52,68,13,216,不合格
20041843,70,76,41,75,80,342,合格
20041844,88,46,91,44,30,299,不合格
20041845,70,51,97,95,2,315,合格
20041846,26,21,21,30,19,117,不合格
20041847,14,49,53,86,25,227,不合格
20041848,31,21,4,0,26,82,不合格
20041849,64,14,26,78,66,248,不合格
20041850,32,31,2,32,17,114,不合格
20041851,97,79,80,12,21,289,不合格
20041852,36,4,2,20,82,144,不合格
20041853,37,85,70,37,38,267,不合格
20041854,10,22,88,71,92,283,不合格
20041855,71,64,96,14,75,320,合格
20041856,2,71,72,95,73,313,合格
20041857,73,16,94,34,17,234,不合格
20041858,42,31,5,54,40,172,不合格
20041859,59,53,11,65,30,218,不合格
20041860,56,68,50,40,1,215,不合格
20041861,69,25,69,35,49,247,不合格
20041862,57,81,98,29,20,285,不合格
20041863,79,3,85,76,21,264,不合格
20041864,64,8,91,2,72,237,不合格
20041865,54,58,60,73,49,294,不合格
20041866,18,77,64,50,12,221,不合格
20041867,15,12,19,77,93,216,不合格
20041868,34,43,21,18,46,162,不合格
20041869,69,97,54,87,61,368,合格
20041870,63,28,64,75,60,290,不合格
20041871,20,44,81,95,49,289,不合格
20041872,59,71,23,92,87,332,合格
20041873,72,72,8,92,41,285,不合格
20041874,95,86,21,60,12,274,不合格
20041875,98,51,96,89,64,398,合格
20041876,99,14,2,44,93,252,不合格
20041877,50,14,23,12,80,179,不合格
20041878,77,21,81,16,46,241,不合格
20041879,72,95,44,65,11,287,不合格
20041880,49,40,87,64,47,287,不合格
20041881,68,73,58,84,37,320,合格
20041882,44,87,75,66,84,356,合格
20041883,76,66,53,33,66,294,不合格
20041884,77,1,65,84,56,283,不合格
20041885,11,60,8,79,87,245,不合格
20041886,55,45,5,19,80,204,不合格
20041887,90,61,44,94,55,344,合格
20041888,39,39,61,37,87,263,不合格
20041889,16,60,34,84,99,293,不合格
20041890,47,58,54,60,47,266,不合格
20041891,79,55,37,52,54,277,不合格
20041892,11,31,78,4,10,134,不合格
20041893,42,79,2,86,31,240,不合格
20041894,7,70,17,69,84,247,不合格
20041895,19,82,37,61,25,224,不合格
20041896,15,41,76,22,66,220,不合格
20041897,22,45,73,87,12,239,不合格
20041898,67,97,71,52,6,293,不合格
20041899,37,66,12,44,85,244,不合格
20041900,66,98,88,10,80,342,合格
20041901,60,22,39,51,7,179,不合格
20041902,85,70,77,61,59,352,合格
20041903,82,70,12,12,10,186,不合格
20041904,87,89,58,14,73,321,合格
20041905,49,47,44,58,40,238,不合格
20041906,26,49,5,41,53,174,不合格
20041907,75,55,98,97,33,358,合格
20041908,96,76,62,40,91,365,合格
20041909,73,8,35,79,88,283,不合格
20041910,3,82,59,0,24,168,不合格
20041911,70,51,66,88,27,302,合格
20041912,51,17,54,34,8,164,不合格
20041913,13,61,57,73,1,205,不合格
20041914,5,33,35,41,68,182,不合格
20041915,24,10,51,22,44,151,不合格
20041916,79,98,24,19,31,251,不合格
20041917,30,67,18,87,30,232,不合格
20041918,27,96,72,31,37,263,不合格
20041919,53,48,56,9,7,173,不合格
20041920,65,23,8,56,58,210,不合格
20041921,29,5,28,49,70,181,不合格
20041922,74,4,65,52,45,240,不合格
20041923,65,15,75,28,40,223,不合格
20041924,36,67,10,74,34,221,不合格
20041925,80,29,85,20,2,216,不合格
20041926,97,54,6,47,67,271,不合格
20041927,43,31,96,98,63,331,合格
20041928,97,29,10,42,19,197,不合格
20041929,22,89,96,68,3,278,不合格
20041930,46,9,56,41,83,235,不合格
20041931,65,1,57,77,63,263,不合格
20041932,36,32,37,57,96,258,不合格
20041933,58,62,32,90,14,256,不合格
20041934,85,90,23,89,21,308,合格
20041935,93,15,14,90,82,294,不合格
20041936,38,96,5,7,21,167,不合格
20041937,13,56,73,47,98,287,不合格
20041938,14,20,68,86,20,208,不合格
20041939,12,76,89,22,99,298,不合格
20041940,71,76,92,5,82,326,合格
20041941,72,21,39,91,69,292,不合格
20041942,78,64,87,32,72,333,合格
20041943,22,54,92,47,77,292,不合格
20041944,72,75,38,27,83,295,不合格
20041945,89,63,28,59,97,336,合格
20041946,43,25,7,91,6,172,不合格
20041947,65,58,74,96,52,345,合格
20041948,70,4,21,12,9,116,不合格
20041949,98,53,74,56,56,337,合格
20041950,1,40,19,24,92,176,不合格
20041951,23,13,20,56,66,178,不合格
20041952,13,59,84,61,26,243,不合格
20041953,50,9,70,76,18,223,不合格
20041954,20,23,81,41,24,189,不合格
20041955,14,19,83,50,4,170,不合格
20041956,8,70,79,87,45,289,不合格
20041957,13,92,57,3,97,262,不合格
20041958,44,61,97,66,92,360,合格
20041959,39,50,15,29,34,167,不合格
20041960,1,68,44,17,68,198,不合格
20041961,64,53,53,71,5,246,不合格
20041962,61,75,20,91,97,344,合格
20041963,75,23,40,65,88,291,不合格
20041964,98,5,19,94,26,242,不合格
20041965,76,54,5,70,39,244,不合格
20041966,47,30,13,55,78,223,不合格
20041967,59,27,38,45,28,197,不合格
20041968,81,41,57,26,93,298,不合格
20041969,71,53,76,60,21,281,不合格
20041970,26,35,32,99,45,237,不合格
20041971,70,93,15,45,59,282,不合格
20041972,72,40,21,73,69,275,不合格
20041973,88,21,28,76,79,292,不合格
20041974,75,89,42,64,43,313,合格
20041975,59,3,82,64,11,219,不合格
20041976,18,97,4,22,97,238,不合格
20041977,72,12,50,37,77,248,不合格
20041978,89,73,32,53,51,298,不合格
20041979,88,16,76,98,61,339,合格
20041980,40,38,21,96,66,261,不合格
20041981,99,31,38,9,96,273,不合格
20041982,99,10,3,50,24,186,不合格
20041983,92,45,5,29,72,243,不合格
20041984,1,18,72,5,11,107,不合格
20041985,16,48,43,29,60,196,不合格
20041986,30,48,24,27,50,179,不合格
20041987,15,63,86,52,12,228,不合格
20041988,53,70,11,41,46,221,不合格
20041989,34,20,63,99,8,224,不合格
20041990,57,9,65,12,4,147,不合格
20041991,36,20,18,80,3,157,不合格
20041992,83,26,98,34,76,317,合格
20041993,26,20,40,41,48,175,不合格
20041994,57,62,22,59,2,202,不合格
20041995,72,99,60,99,19,349,合格
20041996,8,63,86,16,46,219,不合格
20041997,50,30,8,3,44,135,不合格
20041998,55,29,40,15,35,174,不合格
20041999,47,47,56,36,18,204,不合格
20042000,91,7,20,52,72,242,不合格
20042001,24,94,8,88,61,275,不合格
20042002,40,17,18,0,50,125,不合格
20042003,26,16,76,97,82,297,不合格
20042004,43,66,27,88,6,230,不合格
20042005,1,40,34,84,89,248,不合格
20042006,85,3,80,44,14,226,不合格
20042007,48,82,16,11,98,255,不合格
20042008,94,6,81,93,86,360,合格
20042009,11,83,46,48,71,259,不合格
20042010,84,67,63,83,55,352,合格
20042011,57,86,80,20,59,302,合格
20042012,96,13,30,22,60,221,不合格
20042013,45,87,78,44,88,342,合格
20042014,82,30,12,48,22,194,不合格
20042015,21,86,16,36,95,254,不合格
20042016,35,65,63,60,62,285,不合格
20042017,4,97,94,70,33,298,不合格
20042018,42,51,26,3,10,132,不合格
20042019,9,31,8,48,22,118,不合格
20042020,87,35,78,74,30,304,合格
20042021,58,29,79,93,39,298,不合格
20042022,33,90,98,67,63,351,合格
20042023,41,85,73,63,97,359,合格
20042024,93,94,75,0,70,332,合格
20042025,2,89,84,45,49,269,不合格
20042026,46,10,28,8,47,139,不合格
20042027,80,41,57,71,93,342,合格
20042028,84,36,16,5,72,213,不合格
20042029,7,97,29,30,17,180,不合格
20042030,71,5,33,58,72,239,不合格
20042031,32,89,83,33,55,292,不合格
20042032,86,62,12,71,90,321,合格
20042033,40,51,65,95,42,293,不合格
20042034,52,80,48,67,72,319,合格
20042035,17,26,10,91,39,183,不合格
20042036,20,64,53,48,68,253,不合格
20042037,82,25,87,80,70,344,合格
20042038,56,36,85,57,52,286,不合格
20042039,72,58,26,89,79,324,合格
20042040,96,43,16,25,42,222,不合格
20042041,80,11,76,54,45,266,不合格
20042042,60,90,49,94,66,359,合格
20042043,37,34,8,72,60,211,不合格
20042044,56,17,35,86,91,285,不合格
20042045,90,41,37,15,73,256,不合格
20042046,31,3,61,48,37,180,不合格
20042047,64,82,19,73,6,244,不合格
20042048,20,47,49,25,5,146,不合格
20042049,84,96,95,67,47,389,合格
20042050,16,43,58,25,38,180,不合格
20042051,76,1,36,14,77,204,不合格
20042052,44,96,99,36,50,325,合格
20042053,19,63,5,65,99,251,不合格
20042054,98,63,63,12,26,262,不合格
20042055,51,69,58,14,87,279,不合格
20042056,56,32,60,93,49,290,不合格
20042057,77,65,75,81,92,390,合格
20042058,53,39,16,44,57,209,不合格
20042059,12,59,47,82,81,281,不合格
20042060,63,77,40,38,34,252,不合格
20042061,17,48,47,84,72,268,不合格
20042062,9,91,81,85,65,331,合格
20042063,3,9,33,92,43,180,不合格
20042064,98,29,21,9,25,182,不合格
20042065,86,6,35,7,17,151,不合格
20042066,20,81,91,43,36,271,不合格
20042067,31,22,1,75,48,177,不合格
20042068,27,84,2,78,5,196,不合格
20042069,42,98,85,49,6,280,不合格
20042070,44,44,68,97,87,340,合格
20042071,14,19,11,41,89,174,不合格
20042072,70,58,92,55,63,338,合格
20042073,91,42,68,37,0,238,不合格
20042074,3,7,73,21,39,143,不合格
20042075,6,38,80,68,29,221,不合格
20042076,26,26,63,50,53,218,不合格
20042077,39,0,84,32,22,177,不合格
20042078,69,26,62,33,98,288,不合格
20042079,31,83,3,36,79,232,不合格
20042080,66,69,25,47,67,274,不合格
20042081,66,0,95,43,22,226,不合格
20042082,88,95,30,92,8,313,合格
20042083,60,30,89,95,59,333,合格
20042084,9,88,33,49,72,251,不合格
20042085,80,27,70,91,84,352,合格
20042086,76,64,87,5,54,286,不合格
20042087,49,40,40,76,23,228,不合格
20042088,57,41,17,57,10,182,不合格
20042089,41,70,56,0,87,254,不合格
20042090,67,68,85,85,40,345,合格
20042091,87,35,84,4,26,236,不合格
20042092,0,86,85,91,57,319,合格
20042093,46,43,20,15,22,146,不合格
20042094,32,97,57,11,46,243,不合格
20042095,27,5,60,91,27,210,不合格
20042096,82,57,51,98,91,379,合格
20042097,18,81,73,98,32,302,合格
20042098,81,79,3,63,50,276,不合格
20042099,0,11,27,80,46,164,不合格
20042100,6,3,21,35,94,159,不合格
20042101,7,87,32,65,69,260,不合格
20042102,32,10,23,40,11,116,不合格
20042103,26,86,89,39,20,260,不合格
20042104,15,5,18,12,33,83,不合格
20042105,65,24,35,88,48,260,不合格
20042106,82,75,82,11,38,288,不合格
20042107,87,64,81,31,5,268,不合格
20042108,91,58,25,35,51,260,不合格
20042109,80,56,54,3,48,241,不合格
20042110,58,55,48,38,32,231,不合格
20042111,33,38,45,94,93,303,合格
20042112,67,68,42,25,87,289,不合格
20042113,63,65,92,8,0,228,不合格
20042114,77,93,40,5,64,279,不合格
20042115,19,16,9,27,78,149,不合格
20042116,32,59,74,12,65,242,不合格
20042117,27,85,66,39,9,226,不合格
20042118,11,11,16,77,60,175,不合格
20042119,83,7,22,95,32,239,不合格
20042120,85,83,77,38,37,320,合格
20042121,65,95,12,98,50,320,合格
20042122,12,99,51,15,5,182,不合格
20042123,43,91,38,23,21,216,不合格
20042124,72,13,65,72,33,255,不合格
20042125,28,17,88,47,82,262,不合格
20042126,54,47,11,35,55,202,不合格
20042127,25,9,91,32,54,211,不合格
20042128,62,56,88,13,62,281,不合格
20042129,20,72,71,40,28,231,不合格
20042130,59,93,19,8,67,246,不合格
20042131,5,0,98,24,4,131,不合格
20042132,15,98,73,92,57,335,合格
20042133,73,70,5,18,62,228,不合格
20042134,55,64,16,50,93,278,不合格
20042135,26,74,70,78,90,338,合格
20042136,74,23,77,43,75,292,不合格
20042137,40,51,59,59,83,292,不合格
20042138,11,78,44,91,17,241,不合格
20042139,52,29,40,28,57,206,不合格
20042140,84,48,85,39,81,337,合格
20042141,82,15,9,18,88,212,不合格
20042142,62,64,91,4,39,260,不合格
20042143,31,24,57,40,97,249,不合格
20042144,92,31,38,89,34,284,不合格
20042145,93,14,21,26,64,218,不合格
20042146,8,12,1,49,68,138,不合格
20042147,70,11,66,57,52,256,不合格
20042148,83,6,22,82,75,268,不合格
20042149,10,7,97,86,69,269,不合格
20042150,51,67,30,17,50,215,不合格
20042151,49,21,66,87,18,241,不合格
20042152,21,40,0,86,84,231,不合格
20042153,20,62,63,20,52,217,不合格
20042154,64,39,37,41,85,266,不合格
20042155,63,35,96,64,89,347,合格
20042156,1,71,15,61,89,237,不合格
20042157,4,83,30,61,90,268,不合格
20042158,49,48,15,50,91,253,不合格
20042159,12,39,48,3,91,193,不合格
20042160,99,3,39,40,71,252,不合格
20042161,44,12,2,96,45,199,不合格
20042162,30,39,15,73,95,252,不合格
20042163,88,87,28,24,81,308,合格
20042164,9,57,72,26,2,166,不合格
20042165,43,3,70,37,74,227,不合格
20042166,14,98,65,11,61,249,不合格
20042167,99,78,26,56,29,288,不合格
20042168,11,44,43,17,45,160,不合格
20042169,11,79,83,28,33,234,不合格
20042170,91,90,10,98,45,334,合格
20042171,32,29,74,5,51,191,不合格
20042172,40,35,43,50,57,225,不合格
20042173,22,35,51,7,83,198,不合格
20042174,73,53,45,26,46,243,不合格
20042175,51,67,11,28,56,213,不合格
20042176,73,34,48,58,2,215,不合格
20042177,94,97,77,34,55,357,合格
20042178,56,21,61,36,97,271,不合格
20042179,18,81,81,67,13,260,不合格
20042180,92,7,45,82,3,229,不合格
20042181,0,38,60,35,72,205,不合格
20042182,11,0,25,72,32,140,不合格
20042183,40,45,16,48,40,189,不合格
20042184,2,85,26,69,65,247,不合格
20042185,64,87,61,4,87,303,合格
20042186,65,57,51,6,3,182,不合格
20042187,75,21,32,96,68,292,不合格
20042188,87,61,41,33,48,270,不合格
20042189,47,58,50,74,75,304,合格
20042190,47,32,60,7,82,228,不合格
20042191,65,32,82,20,54,253,不合格
20042192,74,71,40,80,46,311,合格
20042193,57,55,74,34,32,252,不合格
20042194,1,38,42,28,23,132,不合格
20042195,37,47,98,91,61,334,合格
20042196,6,11,39,19,33,108,不合格
20042197,3,57,97,24,5,186,不合格
20042198,80,17,69,46,83,295,不合格
20042199,85,16,53,23,56,233,不合格
20042200,65,33,37,46,27,208,不合格
20042201,73,39,37,32,72,253,不合格
20042202,76,52,80,87,29,324,合格
20042203,32,5,10,71,53,171,不合格
20042204,88,79,83,73,17,340,合格
20042205,29,28,71,8,22,158,不合格
20042206,97,11,38,39,94,279,不合格
20042207,89,42,4,64,62,261,不合格
20042208,59,15,73,17,25,189,不合格
20042209,94,21,14,37,59,225,不合格
20042210,1,93,61,72,27,254,不合格
20042211,52,34,69,23,63,241,不合格
20042212,86,79,74,52,57,348,合格
20042213,5,29,0,25,9,68,不合格
20042214,18,41,81,40,66,246,不合格
20042215,51,1,65,42,20,179,不合格
20042216,90,67,31,38,63,289,不合格
20042217,76,37,6,8,6,133,不合格
20042218,18,81,92,60,18,269,不合格
20042219,85,64,88,23,31,291,不合格
20042220,29,78,95,29,79,310,合格
20042221,49,53,95,6,63,266,不合格
20042222,50,99,10,4,7,170,不合格
20042223,1,8,15,1,56,81,不合格
20042224,21,54,98,14,5,192,不合格
20042225,85,65,52,50,63,315,合格
20042226,38,49,85,63,64,299,不合格
20042227,19,90,73,63,91,336,合格
20042228,69,95,30,11,97,302,合格
20042229,85,55,95,1,75,311,合格
20042230,18,28,11,67,88,212,不合格
20042231,14,99,10,39,33,195,不合格
20042232,39,96,93,93,22,343,合格
20042233,36,31,77,34,23,201,不合格
20042234,48,8,74,50,5,185,不合格
20042235,26,1,0,7,51,85,不合格
20042236,95,48,61,10,34,248,不合格
20042237,30,24,83,16,4,157,不合格
20042238,31,81,55,43,11,221,不合格
20042239,23,44,6,86,89,248,不合格
20042240,44,46,83,88,27,288,不合格
20042241,5,9,1,46,26,87,不合格
20042242,98,20,64,56,0,238,不合格
20042243,5,96,5,57,5,168,不合格
20042244,86,16,30,2,90,224,不合格
20042245,46,43,16,63,71,239,不合格
20042246,59,18,19,97,65,258,不合格
20042247,28,94,63,28,99,312,合格
20042248,32,6,72,90,66,266,不合格
20042249,54,52,28,90,70,294,不合格
20042250,18,74,86,14,55,247,不合格
20042251,92,45,10,77,21,245,不合格
20042252,40,41,71,77,51,280,不合格
20042253,84,73,94,35,87,373,合格
20042254,37,11,85,71,85,289,不合格
20042255,41,48,17,8,60,174,不合格
20042256,16,62,43,42,14,177,不合格
20042257,99,34,51,95,76,355,合格
20042258,10,71,47,22,69,219,不合格
20042259,47,27,0,12,64,150,不合格
20042260,64,70,6,73,5,218,不合格
20042261,73,58,46,80,31,288,不合格
20042262,81,2,95,49,69,296,不合格
20042263,31,95,99,75,81,381,合格
20042264,99,76,70,68,57,370,合格
20042265,23,37,47,12,76,195,不合格
20042266,8,59,14,90,83,254,不合格
20042267,34,48,76,70,69,297,不合格
20042268,57,50,73,6,53,239,不合格
20042269,98,5,37,16,52,208,不合格
20042270,21,64,38,70,10,203,不合格
20042271,76,53,66,21,73,289,不合格
20042272,3,26,16,37,71,153,不合格
20042273,12,47,69,91,11,230,不合格
20042274,27,84,55,38,43,247,不合格
20042275,26,75,6,39,10,156,不合格
20042276,26,1,10,4,16,57,不合格
20042277,1,15,0,32,82,130,不合格
20042278,44,0,87,53,72,256,不合格
20042279,90,29,49,10,29,207,不合格
20042280,6,44,68,49,62,229,不合格
20042281,56,86,83,54,15,294,不合格
20042282,62,29,66,82,34,273,不合格
20042283,28,47,2,7,70,154,不合格
20042284,17,89,44,36,78,264,不合格
20042285,70,81,7,64,64,286,不合格
20042286,9,44,5,67,91,216,不合格
20042287,29,33,41,45,84,232,不合格
20042288,29,70,60,21,9,189,不合格
20042289,35,25,36,95,71,262,不合格
20042290,56,46,36,69,0,207,不合格
20042291,98,93,95,92,12,390,合格
20042292,63,46,89,67,10,275,不合格
20042293,6,5,49,23,52,135,不合格
20042294,21,75,94,36,7,233,不合格
20042295,22,27,37,71,19,176,不合格
20042296,2,5,28,64,75,174,不合格
20042297,41,0,88,99,70,298,不合格
20042298,30,22,86,79,24,241,不合格
20042299,99,19,99,84,55,356,合格
20042300,12,45,72,66,26,221,不合格
20042301,96,1,12,28,26,163,不合格
20042302,89,69,17,83,1,259,不合格
20042303,54,83,69,81,48,335,合格
20042304,74,78,61,54,0,267,不合格
20042305,61,21,70,5,70,227,不合格
20042306,67,86,75,70,45,343,合格
20042307,83,94,60,89,95,421,合格
20042308,52,12,60,23,66,213,不合格
20042309,57,44,35,43,98,277,不合格
20042310,37,69,20,34,82,242,不合格
20042311,36,21,58,37,64,216,不合格
20042312,96,37,32,13,14,192,不合格
20042313,19,96,95,91,12,313,合格
20042314,82,98,62,31,51,324,合格
20042315,89,95,70,18,27,299,不合格
20042316,47,5,63,98,18,231,不合格
20042317,44,41,99,15,10,209,不合格
20042318,18,78,23,88,90,297,不合格
20042319,28,64,56,8,97,253,不合格
20042320,66,53,96,52,66,333,合格
20042321,31,5,62,54,79,231,不合格
20042322,43,91,61,72,91,358,合格
20042323,69,28,12,19,99,227,不合格
20042324,31,89,95,80,26,321,合格
20042325,28,71,76,89,83,347,合格
20042326,76,9,76,90,77,328,合格
20042327,89,93,47,96,8,333,合格
20042328,56,36,91,58,97,338,合格
20042329,46,93,24,44,94,301,合格
20042330,76,36,46,85,24,267,不合格
20042331,27,23,10,75,55,190,不合格
20042332,7,63,46,61,3,180,不合格
20042333,2,44,1,8,10,65,不合格
20042334,80,44,0,17,96,237,不合格
20042335,7,60,6,37,97,207,不合格
20042336,2,65,50,42,6,165,不合格
20042337,33,7,72,83,94,289,不合格
20042338,65,63,28,97,22,275,不合格
20042339,11,78,5,21,89,204,不合格
20042340,78,50,96,52,56,332,合格
20042341,97,19,89,69,36,310,合格
20042342,10,53,31,74,53,221,不合格
20042343,91,23,83,45,88,330,合格
20042344,21,84,62,10,22,199,不合格
20042345,23,2,18,77,92,212,不合格
20042346,38,81,58,94,7,278,不合格
20042347,37,70,50,59,17,233,不合格
20042348,36,29,80,47,60,252,不合格
20042349,56,92,41,2,40,231,不合格
20042350,94,19,24,10,41,188,不合格
20042351,82,72,79,27,29,289,不合格
20042352,97,60,21,32,40,250,不合格
20042353,79,89,23,50,46,287,不合格
20042354,71,76,86,52,50,335,合格
20042355,53,29,43,11,77,213,不合格
20042356,25,32,56,92,72,277,不合格
20042357,67,7,20,28,37,159,不合格
20042358,42,74,71,38,62,287,不合格
20042359,57,48,28,30,46,209,不合格
20042360,72,12,35,86,12,217,不合格
20042361,3,24,36,82,65,210,不合格
20042362,58,10,33,21,34,156,不合格
20042363,43,95,38,22,20,218,不合格
20042364,7,35,46,53,32,173,不合格
20042365,0,4,8,30,33,75,不合格
20042366,74,78,67,75,52,346,合格
20042367,62,99,30,62,77,330,合格
20042368,10,50,25,57,14,156,不合格
20042369,90,76,82,38,34,320,合格
20042370,84,33,28,6,25,176,不合格
20042371,19,42,89,83,90,323,合格
20042372,2,36,3,10,47,98,不合格
20042373,73,40,34,69,2,218,不合格
20042374,18,72,14,93,42,239,不合格
20042375,53,8,35,67,94,257,不合格
20042376,38,53,35,48,8,182,不合格
20042377,80,43,23,84,50,280,不合格
20042378,2,40,12,87,39,180,不合格
20042379,69,55,99,35,19,277,不合格
20042380,54,7,39,38,44,182,不合格
20042381,44,22,75,14,40,195,不合格
20042382,26,25,63,84,29,227,不合格
20042383,83,46,53,23,74,279,不合格
20042384,87,83,6,47,73,296,不合格
20042385,9,37,78,98,18,240,不合格
20042386,5,35,77,40,55,212,不合格
20042387,32,66,5,13,46,162,不合格
20042388,15,13,70,43,15,156,不合格
20042389,17,95,14,64,48,238,不合格
20042390,70,71,74,15,43,273,不合格
20042391,63,14,24,34,13,148,不合格
20042392,3,50,15,98,20,186,不合格
20042393,53,16,67,84,18,238,不合格
20042394,54,8,51,34,57,204,不合格
20042395,32,75,50,17,60,234,不合格
20042396,25,27,43,85,25,205,不合格
20042397,16,38,3,46,41,144,不合格
20042398,11,42,52,25,68,198,不合格
20042399,44,24,48,0,80,196,不合格
20042400,14,48,15,64,60,201,不合格
20042401,60,83,20,55,6,224,不合格
20042402,51,12,31,7,80,181,不合格
20042403,78,52,53,93,7,283,不合格
20042404,25,18,43,51,6,143,不合格
20042405,59,80,35,30,0,204,不合格
20042406,55,54,97,32,89,327,合格
20042407,86,13,30,85,15,229,不合格
20042408,55,16,89,50,54,264,不合格
20042409,54,12,6,93,16,181,不合格
20042410,73,97,2,57,86,315,合格
20042411,89,49,43,70,78,329,合格
20042412,15,12,87,42,26,182,不合格
20042413,25,0,6,5,48,84,不合格
20042414,83,81,87,90,64,405,合格
20042415,2,95,9,1,69,176,不合格
20042416,14,85,55,54,87,295,不合格
20042417,20,47,47,94,98,306,合格
20042418,29,66,99,50,2,246,不合格
20042419,66,86,85,74,43,354,合格
20042420,96,61,75,14,34,280,不合格
20042421,96,17,6,24,77,220,不合格
20042422,42,16,80,29,38,205,不合格
20042423,95,14,1,89,74,273,不合格
20042424,65,97,61,54,18,295,不合格
20042425,84,48,40,39,84,295,不合格
20042426,12,12,33,51,35,143,不合格
20042427,85,21,39,40,26,211,不合格
20042428,45,63,61,82,2,253,不合格
20042429,40,31,85,18,28,202,不合格
20042430,7,61,83,41,31,223,不合格
20042431,71,67,0,24,40,202,不合格
20042432,0,43,43,89,96,271,不合格
20042433,39,31,44,25,76,215,不合格
20042434,70,0,30,37,35,172,不合格
20042435,19,24,39,56,68,206,不合格
20042436,96,31,98,70,89,384,合格
20042437,13,93,61,2,85,254,不合格
20042438,89,68,76,43,78,354,合格
20042439,94,26,56,11,93,280,不合格
20042440,31,52,94,6,24,207,不合格
20042441,96,70,27,70,52,315,合格
20042442,61,10,80,44,76,271,不合格
20042443,94,23,80,64,15,276,不合格
20042444,55,28,83,68,41,275,不合格
20042445,14,32,26,41,98,211,不合格
20042446,94,90,28,87,92,391,合格
20042447,44,72,76,23,14,229,不合格
20042448,18,84,65,28,4,199,不合格
20042449,40,7,70,89,87,293,不合格
20042450,20,94,22,49,94,279,不合格
20042451,40,95,72,3,54,264,不合格
20042452,23,90,39,43,16,211,不合格
20042453,40,18,74,0,35,167,不合格
20042454,96,26,26,68,63,279,不合格
20042455,1,61,41,46,8,157,不合格
20042456,96,16,28,92,55,287,不合格
20042457,95,70,79,55,32,331,合格
20042458,84,73,81,91,38,367,合格
20042459,63,84,71,29,75,322,合格
20042460,17,4,83,80,37,221,不合格
20042461,3,45,23,1,76,148,不合格
20042462,62,22,27,51,23,185,不合格
20042463,94,29,59,41,5,228,不合格
20042464,95,46,72,65,45,323,合格
20042465,1,63,24,49,0,137,不合格
20042466,85,35,97,66,48,331,合格
20042467,71,88,74,46,45,324,合格
20042468,4,47,31,88,4,174,不合格
20042469,68,9,23,90,0,190,不合格
20042470,74,23,41,23,15,176,不合格
20042471,27,94,20,50,44,235,不合格
20042472,75,8,77,56,61,277,不合格
20042473,13,50,45,78,33,219,不合格
20042474,8,19,81,89,41,238,不合格
20042475,45,5,33,9,38,130,不合格
20042476,34,47,60,91,60,292,不合格
20042477,35,83,95,4,4,221,不合格
20042478,24,80,28,40,77,249,不合格
20042479,63,49,93,95,92,392,合格
20042480,55,68,39,84,49,295,不合格
20042481,74,88,7,26,3,198,不合格
20042482,55,39,36,63,3,196,不合格
20042483,77,63,15,36,63,254,不合格
20042484,17,75,68,30,26,216,不合格
20042485,77,54,87,75,49,342,合格
20042486,41,20,2,21,47,131,不合格
20042487,59,64,63,42,6,234,不合格
20042488,68,49,3,81,9,210,不合格
20042489,20,0,65,92,49,226,不合格
20042490,19,73,23,93,14,222,不合格
20042491,33,70,48,42,12,205,不合格
20042492,0,64,95,79,7,245,不合格
20042493,86,7,26,78,51,248,不合格
20042494,36,8,56,92,61,253,不合格
20042495,98,65,42,72,79,356,合格
20042496,98,56,5,64,6,229,不合格
20042497,71,41,89,73,38,312,合格
20042498,69,68,27,90,88,342,合格
20042499,88,13,51,60,96,308,合格
20042500,85,93,64,67,4,313,合格
20042501,53,87,33,70,48,291,不合格
20042502,90,93,85,1,84,353,合格
20042503,40,33,69,67,89,298,不合格
20042504,98,4,53,46,29,230,不合格
20042505,56,15,11,33,42,157,不合格
20042506,31,23,2,15,50,121,不合格
20042507,54,35,57,63,82,291,不合格
20042508,30,43,9,76,72,230,不合格
20042509,23,8,91,67,28,217,不合格
20042510,16,66,84,6,6,178,不合格
20042511,17,34,42,20,57,170,不合格
20042512,8,83,27,8,42,168,不合格
20042513,84,74,24,44,25,251,不合格
20042514,10,85,21,4,61,181,不合格
20042515,58,2,80,81,89,310,合格
20042516,71,23,51,66,61,272,不合格
20042517,68,82,37,74,10,271,不合格
20042518,21,6,47,88,68,230,不合格
20042519,88,80,32,16,12,228,不合格
20042520,67,67,64,20,34,252,不合格
20042521,66,85,24,50,76,301,合格
20042522,32,55,65,1,75,228,不合格
20042523,49,80,78,99,80,386,合格
20042524,69,46,11,87,64,277,不合格
20042525,61,35,66,5,89,256,不合格
20042526,83,53,24,92,73,325,合格
20042527,17,67,98,42,99,323,合格
20042528,13,38,81,15,44,191,不合格
20042529,45,63,97,59,64,328,合格
20042530,30,26,78,58,14,206,不合格
20042531,4,8,7,99,54,172,不合格
20042532,23,4,40,18,47,132,不合格
20042533,50,30,31,10,81,202,不合格
20042534,49,51,11,78,32,221,不合格
20042535,56,84,77,72,95,384,合格
20042536,37,77,39,78,15,246,不合格
20042537,48,41,89,42,79,299,不合格
20042538,82,18,12,71,1,184,不合格
20042539,64,14,99,57,40,274,不合格
20042540,39,65,50,9,12,175,不合格
20042541,76,66,64,71,66,343,合格
20042542,80,72,4,87,86,329,合格
20042543,44,81,17,29,8,179,不合格
20042544,97,51,32,93,47,320,合格
20042545,94,34,52,36,6,222,不合格
20042546,76,21,11,95,43,246,不合格
20042547,90,87,67,61,71,376,合格
20042548,96,82,93,35,7,313,合格
20042549,45,2,58,28,87,220,不合格
20042550,44,4,67,45,53,213,不合格
20042551,18,80,37,6,55,196,不合格
20042552,10,41,95,64,70,280,不合格
20042553,70,32,21,9,26,158,不合格
20042554,52,37,35,14,71,209,不合格
20042555,83,81,40,92,9,305,合格
20042556,31,61,11,89,28,220,不合格
20042557,51,81,53,78,22,285,不合格
20042558,19,82,11,44,21,177,不合格
20042559,85,68,73,22,51,299,不合格
20042560,85,5,13,84,96,283,不合格
20042561,66,28,98,95,28,315,合格
20042562,69,57,95,68,76,365,合格
20042563,3,27,57,97,81,265,不合格
20042564,18,6,2,73,99,198,不合格
20042565,36,76,23,99,73,307,合格
20042566,43,67,24,94,43,271,不合格
20042567,74,58,40,58,71,301,合格
20042568,50,2,62,74,44,232,不合格
20042569,10,17,12,33,37,109,不合格
20042570,75,14,92,29,83,293,不合格
20042571,58,59,49,99,91,356,合格
20042572,92,15,12,32,84,235,不合格
20042573,23,17,61,15,97,213,不合格
20042574,28,39,68,22,91,248,不合格
20042575,41,25,64,99,82,311,合格
20042576,36,87,46,67,65,301,合格
20042577,80,35,37,12,10,174,不合格
20042578,99,46,83,44,82,354,合格
20042579,47,45,84,29,25,230,不合格
20042580,59,42,58,20,34,213,不合格
20042581,63,84,49,19,77,292,不合格
20042582,79,79,7,32,28,225,不合格
20042583,4,29,27,1,74,135,不合格
20042584,8,4,4,93,20,129,不合格
20042585,64,81,98,52,38,333,合格
20042586,51,97,95,81,70,394,合格
20042587,28,84,63,11,99,285,不合格
20042588,27,11,4,16,77,135,不合格
20042589,71,69,96,26,7,269,不合格
20042590,88,46,97,12,30,273,不合格
20042591,26,25,90,64,34,239,不合格
20042592,35,61,74,15,33,218,不合格
20042593,65,38,31,87,91,312,合格
20042594,82,49,55,41,16,243,不合格
20042595,29,52,87,80,37,285,不合格
20042596,94,26,10,76,79,285,不合格
20042597,95,4,59,85,64,307,合格
20042598,89,2,38,53,98,280,不合格
20042599,89,4,34,44,91,262,不合格
20042600,65,20,63,1,51,200,不合格
20042601,65,91,28,42,6,232,不合格
20042602,17,22,11,8,48,106,不合格
20042603,92,61,56,0,24,233,不合格
20042604,6,88,86,86,33,299,不合格
20042605,42,89,37,51,71,290,不合格
20042606,46,74,54,44,4,222,不合格
20042607,75,4,68,82,86,315,合格
20042608,36,86,89,55,4,270,不合格
20042609,39,90,61,59,39,288,不合格
20042610,63,50,43,57,60,273,不合格
20042611,91,44,37,83,79,334,合格
20042612,14,5,97,47,87,250,不合格
20042613,70,22,38,94,54,278,不合格
20042614,12,29,39,41,63,184,不合格
20042615,25,31,62,52,50,220,不合格
20042616,23,76,94,87,36,316,合格
20042617,31,78,18,51,8,186,不合格
20042618,44,81,45,14,70,254,不合格
20042619,23,51,43,38,23,178,不合格
20042620,18,82,74,93,92,359,合格
20042621,33,28,64,77,82,284,不合格
20042622,94,35,24,75,97,325,合格
20042623,91,77,59,51,73,351,合格
20042624,37,81,61,74,9,262,不合格
20042625,24,44,83,26,52,229,不合格
20042626,74,80,93,87,68,402,合格
20042627,15,41,33,85,48,222,不合格
20042628,11,93,84,34,37,259,不合格
20042629,57,53,53,97,63,323,合格
20042630,50,22,83,55,6,216,不合格
20042631,71,98,82,95,96,442,合格
20042632,87,80,60,68,45,340,合格
20042633,18,46,24,95,72,255,不合格
20042634,36,98,14,56,62,266,不合格
20042635,73,90,60,33,93,349,合格
20042636,28,30,69,9,73,209,不合格
20042637,69,21,34,34,77,235,不合格
20042638,4,35,0,21,35,95,不合格
20042639,58,69,30,36,63,256,不合格
20042640,20,66,58,62,35,241,不合格
20042641,51,19,56,37,41,204,不合格
20042642,49,69,99,31,11,259,不合格
20042643,36,2,47,64,22,171,不合格
20042644,82,64,48,97,26,317,合格
20042645,73,65,53,60,50,301,合格
20042646,25,16,85,28,54,208,不合格
20042647,7,63,71,30,81,252,不合格
20042648,76,87,95,98,0,356,合格
20042649,61,91,42,22,9,225,不合格
20042650,3,82,21,21,56,183,不合格
20042651,8,47,71,82,47,255,不合格
20042652,56,99,43,19,45,262,不合格
20042653,13,70,39,23,18,163,不合格
20042654,42,96,41,65,2,246,不合格
20042655,71,5,20,78,91,265,不合格
20042656,50,89,42,76,2,259,不合格
20042657,64,41,85,0,36,226,不合格
20042658,89,69,20,94,0,272,不合格
20042659,18,63,20,35,69,205,不合格
20042660,1,94,16,76,19,206,不合格
20042661,56,94,93,70,56,369,合格
20042662,99,53,19,20,84,275,不合格
20042663,61,27,97,39,67,291,不合格
20042664,70,5,84,59,21,239,不合格
20042665,14,14,92,41,28,189,不合格
20042666,49,12,46,19,71,197,不合格
20042667,9,5,22,21,5,62,不合格
20042668,9,58,79,71,74,291,不合格
20042669,31,99,85,12,2,229,不合格
20042670,16,88,72,61,12,249,不合格
20042671,10,58,38,6,17,129,不合格
20042672,59,1,93,90,20,263,不合格
20042673,91,3,29,65,34,222,不合格
20042674,76,56,63,86,19,300,合格
20042675,53,29,37,48,63,230,不合格
20042676,73,85,73,59,39,329,合格
20042677,11,78,98,84,49,320,合格
20042678,80,36,3,56,18,193,不合格
20042679,66,90,13,88,47,304,合格
20042680,0,0,31,9,51,91,不合格
20042681,48,14,46,77,87,272,不合格
20042682,24,66,58,80,97,325,合格
20042683,83,78,95,68,24,348,合格
20042684,59,3,4,67,24,157,不合格
20042685,31,1,55,3,99,189,不合格
20042686,32,45,34,60,13,184,不合格
20042687,12,99,29,37,3,180,不合格
20042688,40,7,20,68,37,172,不合格
20042689,38,74,1,97,70,280,不合格
20042690,48,9,71,62,4,194,不合格
20042691,28,28,62,11,57,186,不合格
20042692,33,19,33,99,43,227,不合格
20042693,14,20,73,90,38,235,不合格
20042694,43,69,22,23,26,183,不合格
20042695,10,1,68,78,23,180,不合格
20042696,94,74,53,42,8,271,不合格
20042697,87,38,54,68,4,251,不合格
20042698,52,43,5,57,67,224,不合格
20042699,8,74,24,5,75,186,不合格
20042700,49,16,31,91,52,239,不合格
20042701,93,18,50,18,50,229,不合格
20042702,3,13,42,29,94,181,不合格
20042703,26,4,54,54,70,208,不合格
20042704,47,81,99,22,28,277,不合格
20042705,26,42,94,80,88,330,合格
20042706,99,12,44,27,79,261,不合格
20042707,77,41,95,79,90,382,合格
20042708,82,54,87,84,18,325,合格
20042709,61,60,79,81,39,320,合格
20042710,57,16,47,80,31,231,不合格
20042711,69,17,80,52,21,239,不合格
20042712,56,86,51,18,89,300,合格
20042713,90,16,14,18,83,221,不合格
20042714,97,56,60,27,70,310,合格
20042715,78,88,37,14,11,228,不合格
20042716,89,94,32,61,65,341,合格
20042717,88,21,69,11,32,221,不合格
20042718,26,59,84,76,22,267,不合格
20042719,20,69,92,19,92,292,不合格
20042720,78,68,64,85,87,382,合格
20042721,14,52,79,92,27,264,不合格
20042722,70,26,6,68,31,201,不合格
20042723,31,13,84,15,89,232,不合格
20042724,26,64,63,69,5,227,不合格
20042725,50,90,85,79,36,340,合格
20042726,71,61,49,64,44,289,不合格
20042727,15,70,12,0,96,193,不合格
20042728,82,60,69,70,82,363,合格
20042729,38,26,34,81,73,252,不合格
20042730,49,47,19,30,11,156,不合格
20042731,62,35,43,17,47,204,不合格
20042732,88,38,22,16,97,261,不合格
20042733,89,93,91,64,25,362,合格
20042734,25,92,4,56,94,271,不合格
20042735,80,97,66,86,4,333,合格
20042736,30,64,64,28,1,187,不合格
20042737,4,87,96,19,4,210,不合格
20042738,73,46,91,53,53,316,合格
20042739,29,64,67,32,55,247,不合格
20042740,28,6,65,25,75,199,不合格
20042741,94,51,94,16,45,300,合格
20042742,61,58,96,11,82,308,合格
20042743,23,84,42,39,35,223,不合格
20042744,15,55,49,47,36,202,不合格
20042745,33,26,35,1,58,153,不合格
20042746,8,86,51,61,27,233,不合格
20042747,67,27,17,40,0,151,不合格
20042748,45,67,3,26,18,159,不合格
20042749,43,64,92,48,57,304,合格
20042750,98,0,16,13,57,184,不合格
20042751,82,77,0,25,42,226,不合格
20042752,23,37,94,18,26,198,不合格
20042753,80,77,56,61,53,327,合格
20042754,48,92,88,66,69,363,合格
20042755,42,10,29,26,27,134,不合格
20042756,48,75,42,16,4,185,不合格
20042757,20,10,91,4,3,128,不合格
20042758,1,35,49,64,33,182,不合格
20042759,31,9,75,63,64,242,不合格
20042760,29,34,49,74,2,188,不合格
20042761,20,58,3,59,53,193,不合格
20042762,7,80,7,89,83,266,不合格
20042763,39,13,55,18,22,147,不合格
20042764,62,52,61,47,95,317,合格
20042765,78,6,4,25,10,123,不合格
20042766,66,46,28,96,2,238,不合格
20042767,85,92,68,18,77,340,合格
20042768,79,29,81,27,40,256,不合格
20042769,21,55,21,7,4,108,不合格
20042770,39,84,60,61,89,333,合格
20042771,68,83,2,37,76,266,不合格
20042772,73,20,69,67,32,261,不合格
20042773,16,44,92,4,20,176,不合格
20042774,27,47,61,61,74,270,不合格
20042775,38,16,49,29,61,193,不合格
20042776,39,79,78,54,61,311,合格
20042777,33,22,66,78,17,216,不合格
20042778,91,86,25,19,78,299,不合格
20042779,93,93,30,20,33,269,不合格
20042780,95,77,99,39,46,356,合格
20042781,37,96,37,57,56,283,不合格
20042782,27,29,19,1,2,78,不合格
20042783,47,29,79,10,20,185,不合格
20042784,46,6,31,17,56,156,不合格
20042785,26,74,79,67,95,341,合格
20042786,89,78,20,22,18,227,不合格
20042787,20,73,34,95,19,241,不合格
20042788,37,89,34,56,3,219,不合格
20042789,18,41,38,43,10,150,不合格
20042790,35,47,99,84,3,268,不合格
20042791,88,82,5,70,10,255,不合格
20042792,14,83,9,37,33,176,不合格
20042793,71,76,92,6,55,300,合格
20042794,86,96,21,59,9,271,不合格
20042795,86,71,62,25,6,250,不合格
20042796,18,8,21,16,84,147,不合格
20042797,35,29,56,78,37,235,不合格
20042798,5,85,71,17,94,272,不合格
20042799,96,11,46,1,97,251,不合格
20042800,42,70,95,2,62,271,不合格
20042801,99,7,36,78,69,289,不合格
20042802,54,83,69,22,75,303,合格
20042803,34,67,78,18,2,199,不合格
20042804,69,0,23,37,0,129,不合格
20042805,1,79,98,31,90,299,不合格
20042806,62,93,3,50,44,252,不合格
20042807,12,21,32,90,12,167,不合格
20042808,73,63,59,78,22,295,不合格
20042809,2,45,57,17,54,175,不合格
20042810,57,84,27,23,97,288,不合格
20042811,41,30,16,1,39,127,不合格
20042812,16,17,16,48,84,181,不合格
20042813,39,23,59,99,91,311,合格
20042814,0,2,49,59,10,120,不合格
20042815,45,69,9,59,14,196,不合格
20042816,43,95,82,86,46,352,合格
20042817,21,18,16,35,97,187,不合格
20042818,40,88,90,17,99,334,合格
20042819,20,88,25,57,84,274,不合格
20042820,56,14,95,66,62,293,不合格
20042821,94,26,82,75,22,299,不合格
20042822,12,93,72,60,8,245,不合格
20042823,62,19,7,64,46,198,不合格
20042824,5,57,20,4,51,137,不合格
20042825,45,2,20,79,27,173,不合格
20042826,64,75,93,52,6,290,不合格
20042827,78,61,56,1,59,255,不合格
20042828,86,54,15,3,64,222,不合格
20042829,19,48,83,34,83,267,不合格
20042830,10,96,18,12,34,170,不合格
20042831,45,37,92,70,29,273,不合格
20042832,12,38,39,61,46,196,不合格
20042833,98,77,34,32,24,265,不合格
20042834,26,67,78,76,30,277,不合格
20042835,94,69,31,36,98,328,合格
20042836,3,30,69,86,31,219,不合格
20042837,11,13,68,26,59,177,不合格
20042838,12,14,83,63,84,256,不合格
20042839,41,1,41,44,93,220,不合格
20042840,22,64,32,90,83,291,不合格
20042841,39,52,50,97,70,308,合格
20042842,13,20,27,57,15,132,不合格
20042843,62,59,55,90,74,340,合格
20042844,26,24,84,69,31,234,不合格
20042845,17,23,17,27,79,163,不合格
20042846,0,3,74,33,69,179,不合格
20042847,18,8,48,49,83,206,不合格
20042848,72,29,88,22,68,279,不合格
20042849,43,5,46,81,89,264,不合格
20042850,85,57,98,53,25,318,合格
20042851,49,59,12,10,94,224,不合格
20042852,20,33,0,75,6,134,不合格
20042853,11,30,36,44,30,151,不合格
20042854,15,96,60,17,95,283,不合格
20042855,97,35,87,44,3,266,不合格
20042856,31,74,80,1,94,280,不合格
20042857,49,5,98,63,87,302,合格
20042858,55,71,53,70,54,303,合格
20042859,19,63,49,9,88,228,不合格
20042860,86,95,67,39,70,357,合格
20042861,36,17,33,4,34,124,不合格
20042862,98,77,75,90,10,350,合格
20042863,56,42,68,76,88,330,合格
20042864,50,73,67,12,17,219,不合格
20042865,22,46,21,74,42,205,不合格
20042866,39,34,10,49,21,153,不合格
20042867,79,84,70,86,59,378,合格
20042868,91,83,59,88,86,407,合格
20042869,28,17,9,40,96,190,不合格
20042870,96,53,94,38,60,341,合格
20042871,42,40,20,59,31,192,不合格
20042872,48,77,69,94,21,309,合格
20042873,6,49,70,51,22,198,不合格
20042874,97,62,58,4,21,242,不合格
20042875,60,62,20,10,3,155,不合格
20042876,75,43,16,23,16,173,不合格
20042877,15,77,19,56,60,227,不合格
20042878,61,1,77,17,36,192,不合格
20042879,36,69,3,47,44,199,不合格
20042880,11,85,5,44,97,242,不合格
20042881,28,43,89,83,9,252,不合格
20042882,88,15,23,2,96,224,不合格
20042883,94,94,2,52,79,321,合格
20042884,53,38,40,2,36,169,不合格
20042885,29,25,73,6,6,139,不合格
20042886,43,3,55,56,68,225,不合格
20042887,41,56,96,47,64,304,合格
20042888,98,50,3,81,40,272,不合格
20042889,89,97,60,49,36,331,合格
20042890,64,7,63,50,35,219,不合格
20042891,19,57,7,78,0,161,不合格
20042892,21,55,94,45,99,314,合格
20042893,2,67,17,6,10,102,不合格
20042894,23,92,51,57,45,268,不合格
20042895,74,87,6,26,32,225,不合格
20042896,47,40,25,13,25,150,不合格
20042897,1,53,91,77,60,282,不合格
20042898,94,53,99,37,34,317,合格
20042899,84,42,10,32,6,174,不合格
20042900,3,40,55,78,15,191,不合格
20042901,46,34,80,72,26,258,不合格
20042902,97,5,78,48,76,304,合格
20042903,1,85,82,92,92,352,合格
20042904,0,81,54,96,88,319,合格
20042905,77,78,56,93,40,344,合格
20042906,33,21,20,86,72,232,不合格
20042907,57,81,99,27,24,288,不合格
20042908,7,52,86,59,45,249,不合格
20042909,71,51,68,40,33,263,不合格
20042910,91,37,15,68,77,288,不合格
20042911,25,37,39,94,87,282,不合格
20042912,45,8,31,32,11,127,不合格
20042913,34,22,60,78,93,287,不合格
20042914,29,14,58,55,3,159,不合格
20042915,77,24,70,76,86,333,合格
20042916,4,49,93,36,96,278,不合格
20042917,66,61,2,67,32,228,不合格
20042918,40,27,92,42,0,201,不合格
20042919,9,53,60,21,73,216,不合格
20042920,8,6,42,49,94,199,不合格
20042921,63,99,57,95,73,387,合格
20042922,95,1,10,76,2,184,不合格
20042923,1,9,98,0,91,199,不合格
20042924,62,53,55,27,75,272,不合格
20042925,32,89,72,76,13,282,不合格
20042926,68,9,45,57,41,220,不合格
20042927,17,60,88,53,22,240,不合格
20042928,95,85,18,24,18,240,不合格
20042929,13,88,61,48,79,289,不合格
20042930,55,82,5,26,96,264,不合格
20042931,55,67,18,26,6,172,不合格
20042932,50,66,1,1,89,207,不合格
20042933,74,44,32,95,27,272,不合格
20042934,99,87,62,29,34,311,合格
20042935,10,36,74,66,28,214,不合格
20042936,77,50,85,96,16,324,合格
20042937,92,54,81,90,91,408,合格
20042938,95,63,28,60,55,301,合格
20042939,36,49,36,26,58,205,不合格
20042940,94,14,96,69,76,349,合格
20042941,54,35,80,20,20,209,不合格
20042942,60,11,4,14,82,171,不合格
20042943,18,18,94,15,66,211,不合格
20042944,8,28,18,56,87,197,不合格
20042945,14,33,77,82,16,222,不合格
20042946,26,51,91,26,77,271,不合格
20042947,17,84,29,28,30,188,不合格
20042948,69,51,82,1,4,207,不合格
20042949,94,76,89,94,29,382,合格
20042950,48,95,37,77,72,329,合格
20042951,0,54,3,13,17,87,不合格
20042952,5,9,22,9,25,70,不合格
20042953,33,27,3,80,0,143,不合格
20042954,15,16,3,12,38,84,不合格
20042955,17,84,1,17,87,206,不合格
20042956,44,40,41,93,44,262,不合格
20042957,60,87,38,78,2,265,不合格
20042958,14,94,72,52,33,265,不合格
20042959,85,40,31,93,24,273,不合格
20042960,99,39,58,57,95,348,合格
20042961,70,69,23,8,3,173,不合格
20042962,47,50,61,24,73,255,不合格
20042963,41,25,73,35,77,251,不合格
20042964,14,83,10,1,82,190,不合格
20042965,90,28,97,5,97,317,合格
20042966,33,27,75,94,76,305,合格
20042967,67,1,79,28,30,205,不合格
20042968,97,83,24,45,37,286,不合格
20042969,45,21,26,6,35,133,不合格
20042970,59,84,41,53,5,242,不合格
20042971,80,30,54,18,93,275,不合格
20042972,67,81,21,82,41,292,不合格
20042973,9,63,85,9,43,209,不合格
20042974,98,93,75,61,49,376,合格
20042975,66,87,76,89,2,320,合格
20042976,41,93,30,61,59,284,不合格
20042977,91,19,28,98,97,333,合格
20042978,31,46,17,6,39,139,不合格
20042979,34,95,95,36,21,281,不合格
20042980,6,94,45,24,21,190,不合格
20042981,43,16,81,87,54,281,不合格
20042982,39,42,2,13,5,101,不合格
20042983,96,96,50,7,62,311,合格
20042984,12,92,51,5,38,198,不合格
20042985,46,26,1,38,90,201,不合格
20042986,63,64,38,1,67,233,不合格
20042987,62,68,18,66,71,285,不合格
20042988,85,53,12,15,82,247,不合格
20042989,98,79,60,52,81,370,合格
20042990,33,35,26,9,79,182,不合格
20042991,17,39,39,22,71,188,不合格
20042992,15,13,43,0,96,167,不合格
20042993,20,94,8,32,22,176,不合格
20042994,42,95,56,56,28,277,不合格
20042995,93,54,86,95,52,380,合格
20042996,55,39,32,75,50,251,不合格
20042997,1,38,83,60,91,273,不合格
20042998,46,32,20,97,90,285,不合格
20042999,38,32,99,44,99,312,合格
20043000,65,34,35,84,21,239,不合格
20043001,86,67,24,45,6,228,不合格
20043002,56,11,14,45,5,131,不合格
20043003,39,46,59,32,93,269,不合格
20043004,91,68,55,42,85,341,合格
20043005,33,86,5,88,69,281,不合格
20043006,41,7,15,61,94,218,不合格
20043007,52,83,7,68,61,271,不合格
20043008,86,32,5,73,40,236,不合格
20043009,66,48,83,29,99,325,合格
20043010,81,46,78,99,32,336,合格
20043011,43,86,52,89,32,302,合格
20043012,82,18,20,44,5,169,不合格
20043013,28,69,24,35,65,221,不合格
20043014,4,65,49,87,46,251,不合格
20043015,42,45,72,11,23,193,不合格
20043016,23,79,93,13,18,226,不合格
20043017,35,86,34,99,81,335,合格
20043018,8,38,27,98,74,245,不合格
20043019,41,59,67,88,5,260,不合格
20043020,56,9,83,26,78,252,不合格
20043021,23,10,8,2,96,139,不合格
20043022,24,29,20,41,10,124,不合格
20043023,48,94,45,77,13,277,不合格
20043024,93,26,79,60,48,306,合格
20043025,8,80,1,19,56,164,不合格
20043026,34,44,45,73,67,263,不合格
20043027,84,75,43,61,41,304,合格
20043028,89,14,67,18,45,233,不合格
20043029,43,58,90,14,86,291,不合格
20043030,21,43,38,12,70,184,不合格
20043031,97,43,29,60,25,254,不合格
20043032,66,0,59,62,96,283,不合格
20043033,13,77,20,61,32,203,不合格
20043034,77,21,91,22,47,258,不合格
20043035,60,49,80,55,52,296,不合格
20043036,11,92,81,31,3,218,不合格
20043037,0,58,32,46,37,173,不合格
20043038,22,36,27,34,75,194,不合格
20043039,51,59,79,65,93,347,合格
20043040,97,35,19,24,32,207,不合格
20043041,13,82,2,34,51,182,不合格
20043042,80,14,49,33,71,247,不合格
20043043,37,58,72,35,70,272,不合格
20043044,98,60,56,55,51,320,合格
20043045,68,94,68,22,69,321,合格
20043046,3,65,90,40,70,268,不合格
20043047,56,27,10,26,93,212,不合格
20043048,25,49,50,8,59,191,不合格
20043049,25,90,88,81,11,295,不合格
20043050,84,30,55,51,54,274,不合格
20043051,97,89,98,84,59,427,合格
20043052,42,4,7,93,9,155,不合格
20043053,44,14,28,24,40,150,不合格
20043054,55,31,59,57,65,267,不合格
20043055,78,64,3,31,53,229,不合格
20043056,30,37,12,24,73,176,不合格
20043057,19,63,30,79,15,206,不合格
20043058,67,50,84,16,71,288,不合格
20043059,95,3,14,56,65,233,不合格
20043060,67,95,4,13,89,268,不合格
20043061,29,66,2,51,83,231,不合格
20043062,60,12,41,49,54,216,不合格
20043063,22,86,52,95,8,263,不合格
20043064,45,5,43,55,80,228,不合格
20043065,5,86,91,28,58,268,不合格
20043066,7,50,31,3,77,168,不合格
20043067,30,48,61,83,97,319,合格
20043068,51,33,60,89,96,329,合格
20043069,12,58,0,45,64,179,不合格
20043070,10,59,63,15,22,169,不合格
20043071,55,53,21,88,70,287,不合格
20043072,96,22,38,27,21,204,不合格
20043073,51,69,10,63,12,205,不合格
20043074,53,81,58,27,1,220,不合格
20043075,90,59,95,71,74,389,合格
20043076,57,59,27,59,96,298,不合格
20043077,21,15,7,81,24,148,不合格
20043078,61,72,12,56,89,290,不合格
20043079,83,72,65,91,24,335,合格
20043080,31,40,68,20,32,191,不合格
20043081,36,67,95,98,74,370,合格
20043082,19,36,83,79,84,301,合格
20043083,84,8,70,71,86,319,合格
20043084,85,9,76,58,15,243,不合格
20043085,29,73,33,58,20,213,不合格
20043086,21,16,50,79,65,231,不合格
20043087,34,58,90,63,92,337,合格
20043088,41,29,37,69,63,239,不合格
20043089,76,26,86,56,1,245,不合格
20043090,19,26,0,21,97,163,不合格
20043091,34,27,14,23,78,176,不合格
20043092,96,14,22,54,59,245,不合格
20043093,20,30,22,38,19,129,不合格
20043094,61,31,21,1,37,151,不合格
20043095,76,43,84,60,10,273,不合格
20043096,58,74,19,4,48,203,不合格
20043097,84,97,1,14,8,204,不合格
20043098,88,7,54,3,74,226,不合格
20043099,71,50,43,51,81,296,不合格
20043100,37,19,97,77,93,323,合格
20043101,95,45,84,52,29,305,合格
20043102,11,90,68,59,12,240,不合格
20043103,97,20,71,51,25,264,不合格
20043104,49,14,62,24,43,192,不合格
20043105,53,20,58,9,2,142,不合格
20043106,89,1,47,83,59,279,不合格
20043107,31,51,99,74,68,323,合格
20043108,15,6,31,3,4,59,不合格
20043109,81,98,63,75,2,319,合格
20043110,83,91,34,19,5,232,不合格
20043111,93,34,64,82,65,338,合格
20043112,44,55,40,10,23,172,不合格
20043113,18,99,71,24,97,309,合格
20043114,55,58,50,97,58,318,合格
20043115,21,90,96,51,15,273,不合格
20043116,5,73,71,65,37,251,不合格
20043117,40,53,59,20,47,219,不合格
20043118,40,87,38,11,35,211,不合格
20043119,54,92,7,86,95,334,合格
20043120,79,59,0,5,11,154,不合格
20043121,49,14,12,73,51,199,不合格
20043122,66,31,15,34,87,233,不合格
20043123,22,5,3,71,99,200,不合格
20043124,54,57,33,86,38,268,不合格
20043125,6,13,37,68,87,211,不合格
20043126,11,79,71,58,40,259,不合格
20043127,11,50,71,33,56,221,不合格
20043128,58,54,83,62,4,261,不合格
20043129,36,52,27,44,45,204,不合格
20043130,49,70,68,30,46,263,不合格
20043131,85,41,93,41,13,273,不合格
20043132,31,35,88,83,7,244,不合格
20043133,56,97,79,11,86,329,合格
20043134,4,43,52,4,13,116,不合格
20043135,83,19,17,3,58,180,不合格
20043136,69,24,17,22,33,165,不合格
20043137,20,18,67,0,46,151,不合格
20043138,18,61,97,84,21,281,不合格
20043139,88,89,87,17,7,288,不合格
20043140,78,74,38,77,95,362,合格
20043141,50,77,16,37,54,234,不合格
20043142,75,4,31,16,21,147,不合格
20043143,74,64,20,83,6,247,不合格
20043144,67,18,76,96,36,293,不合格
20043145,63,95,56,19,99,332,合格
20043146,93,6,74,22,89,284,不合格
20043147,87,2,70,80,47,286,不合格
20043148,64,1,81,48,69,263,不合格
20043149,72,91,29,87,46,325,合格
20043150,60,72,78,63,89,362,合格
20043151,24,62,94,90,91,361,合格
20043152,60,13,3,32,42,150,不合格
20043153,81,98,9,70,6,264,不合格
20043154,9,49,3,0,7,68,不合格
20043155,67,43,5,23,38,176,不合格
20043156,49,32,88,41,0,210,不合格
20043157,6,4,96,19,0,125,不合格
20043158,17,72,78,64,95,326,合格
20043159,61,84,72,51,49,317,合格
20043160,34,34,79,83,68,298,不合格
20043161,43,18,45,9,78,193,不合格
20043162,13,96,60,75,7,251,不合格
20043163,40,72,35,7,1,155,不合格
20043164,60,70,11,72,31,244,不合格
20043165,33,13,61,71,6,184,不合格
20043166,13,4,86,51,11,165,不合格
20043167,29,88,42,36,75,270,不合格
20043168,61,1,83,34,60,239,不合格
20043169,86,61,79,25,7,258,不合格
20043170,52,83,44,84,18,281,不合格
20043171,20,51,16,48,74,209,不合格
20043172,79,90,27,68,39,303,合格
20043173,87,49,69,7,44,256,不合格
20043174,92,20,75,29,98,314,合格
20043175,99,42,61,99,2,303,合格
20043176,30,63,28,59,15,195,不合格
20043177,8,62,62,70,2,204,不合格
20043178,60,18,87,90,15,270,不合格
20043179,52,4,44,90,58,248,不合格
20043180,63,35,77,45,57,277,不合格
20043181,18,44,30,6,33,131,不合格
20043182,58,3,70,43,0,174,不合格
20043183,98,21,62,89,73,343,合格
20043184,89,81,5,15,57,247,不合格
20043185,20,32,75,11,78,216,不合格
20043186,70,65,43,36,90,304,合格
20043187,54,34,11,94,34,227,不合格
20043188,56,52,88,47,67,310,合格
20043189,92,75,65,13,37,282,不合格
20043190,68,62,61,91,15,297,不合格
20043191,14,48,41,31,85,219,不合格
20043192,4,95,55,70,70,294,不合格
20043193,59,77,58,69,74,337,合格
20043194,53,69,90,39,55,306,合格
20043195,37,0,78,48,54,217,不合格
20043196,59,83,53,2,82,279,不合格
20043197,86,64,60,45,25,280,不合格
20043198,77,99,90,82,51,399,合格
20043199,26,19,61,14,1,121,不合格
20043200,89,91,52,20,86,338,合格
20043201,20,43,35,62,78,238,不合格
20043202,83,41,92,25,55,296,不合格
20043203,48,93,66,79,28,314,合格
20043204,23,20,40,35,79,197,不合格
20043205,5,92,54,95,88,334,合格
20043206,1,95,95,49,38,278,不合格
20043207,23,89,98,32,64,306,合格
20043208,19,75,12,66,7,179,不合格
20043209,6,29,63,59,69,226,不合格
20043210,48,85,23,83,62,301,合格
20043211,83,81,55,91,13,323,合格
20043212,94,34,61,40,25,254,不合格
20043213,46,83,64,29,43,265,不合格
20043214,60,80,97,23,26,286,不合格
20043215,17,60,87,24,4,192,不合格
20043216,54,75,31,43,80,283,不合格
20043217,26,72,17,15,47,177,不合格
20043218,28,23,96,73,58,278,不合格
20043219,81,17,76,12,62,248,不合格
20043220,51,85,53,15,3,207,不合格
20043221,69,54,3,5,58,189,不合格
20043222,76,98,87,52,60,373,合格
20043223,67,36,55,2,54,214,不合格
20043224,52,48,49,33,46,228,不合格
20043225,93,80,7,29,59,268,不合格
20043226,14,66,86,94,79,339,合格
20043227,7,97,97,53,27,281,不合格
20043228,15,69,8,89,46,227,不合格
20043229,29,52,37,31,6,155,不合格
20043230,97,27,42,46,86,298,不合格
20043231,54,66,67,35,50,272,不合格
20043232,61,58,11,53,1,184,不合格
20043233,14,88,35,97,46,280,不合格
20043234,2,12,40,25,55,134,不合格
20043235,21,76,29,6,46,178,不合格
20043236,66,77,96,29,12,280,不合格
20043237,58,84,32,74,26,274,不合格
20043238,49,62,2,93,37,243,不合格
20043239,16,21,92,98,32,259,不合格
20043240,26,14,6,16,57,119,不合格
20043241,50,12,33,95,53,243,不合格
20043242,98,66,93,90,97,444,合格
20043243,73,58,86,84,20,321,合格
20043244,65,19,81,17,24,206,不合格
20043245,68,43,31,52,27,221,不合格
20043246,53,25,95,99,94,366,合格
20043247,92,20,30,38,38,218,不合格
20043248,16,19,57,77,47,216,不合格
20043249,55,11,7,37,65,175,不合格
20043250,42,42,51,28,30,193,不合格
20043251,9,22,18,33,49,131,不合格
20043252,32,15,80,84,46,257,不合格
20043253,96,10,14,75,72,267,不合格
20043254,97,80,22,94,23,316,合格
20043255,65,94,32,15,87,293,不合格
20043256,20,64,80,44,3,211,不合格
20043257,19,34,62,53,2,170,不合格
20043258,6,70,20,23,36,155,不合格
20043259,22,78,64,4,35,203,不合格
20043260,49,25,31,35,55,195,不合格
20043261,48,58,48,39,97,290,不合格
20043262,60,21,70,29,68,248,不合格
20043263,76,59,28,74,32,269,不合格
20043264,45,15,97,73,32,262,不合格
20043265,68,76,61,73,25,303,合格
20043266,28,87,15,94,45,269,不合格
20043267,76,27,69,56,72,300,合格
20043268,67,62,50,2,82,263,不合格
20043269,50,63,92,71,20,296,不合格
20043270,35,39,61,79,94,308,合格
20043271,55,98,47,6,38,244,不合格
20043272,53,67,58,81,32,291,不合格
20043273,82,59,84,95,42,362,合格
20043274,80,74,7,50,71,282,不合格
20043275,95,28,53,45,50,271,不合格
20043276,66,23,2,25,71,187,不合格
20043277,10,24,74,25,47,180,不合格
20043278,63,47,60,16,48,234,不合格
20043279,18,81,79,22,97,297,不合格
20043280,51,13,69,62,58,253,不合格
20043281,36,9,17,93,41,196,不合格
20043282,63,52,98,98,91,402,合格
20043283,48,68,39,30,8,193,不合格
20043284,0,63,99,54,25,241,不合格
20043285,92,38,97,67,3,297,不合格
20043286,23,58,81,3,31,196,不合格
20043287,96,93,57,76,15,337,合格
20043288,47,67,59,10,68,251,不合格
20043289,96,93,2,56,39,286,不合格
20043290,28,21,19,13,66,147,不合格
20043291,74,30,24,31,64,223,不合格
20043292,89,6,3,79,70,247,不合格
20043293,43,89,58,33,7,230,不合格
20043294,79,98,55,65,11,308,合格
20043295,23,5,88,0,1,117,不合格
20043296,52,18,9,49,98,226,不合格
20043297,68,43,78,41,62,292,不合格
20043298,3,49,73,49,92,266,不合格
20043299,62,33,76,72,26,269,不合格
20043300,33,53,88,63,68,305,合格
20043301,54,14,89,9,88,254,不合格
20043302,90,29,34,31,7,191,不合格
20043303,49,91,92,23,10,265,不合格
20043304,74,77,91,16,4,262,不合格
20043305,68,10,19,74,90,261,不合格
20043306,36,54,43,50,75,258,不合格
20043307,74,40,53,34,16,217,不合格
20043308,71,24,89,97,79,360,合格
20043309,2,32,92,24,11,161,不合格
20043310,71,50,95,1,43,260,不合格
20043311,15,78,86,56,76,311,合格
20043312,36,84,78,22,18,238,不合格
20043313,14,78,34,36,4,166,不合格
20043314,84,99,71,53,86,393,合格
20043315,41,83,44,56,45,269,不合格
20043316,20,79,97,68,44,308,合格
20043317,80,82,90,23,93,368,合格
20043318,69,1,26,58,63,217,不合格
20043319,91,53,38,33,0,215,不合格
20043320,89,43,71,43,87,333,合格
20043321,76,33,38,84,60,291,不合格
20043322,1,76,55,90,15,237,不合格
20043323,6,95,48,97,89,335,合格
20043324,84,35,30,60,24,233,不合格
20043325,89,62,78,92,67,388,合格
20043326,68,77,55,64,1,265,不合格
20043327,67,65,4,42,24,202,不合格
20043328,6,30,16,25,85,162,不合格
20043329,67,17,70,71,13,238,不合格
20043330,67,45,6,98,18,234,不合格
20043331,25,25,45,23,49,167,不合格
20043332,42,44,88,2,23,199,不合格
20043333,32,92,59,27,46,256,不合格
20043334,84,36,12,96,12,240,不合格
20043335,74,95,69,15,43,296,不合格
20043336,28,10,1,24,73,136,不合格
20043337,49,77,98,57,51,332,合格
20043338,97,42,5,53,16,213,不合格
20043339,53,37,44,73,31,238,不合格
20043340,46,72,34,74,68,294,不合格
20043341,73,43,58,96,7,277,不合格
20043342,22,99,27,75,58,281,不合格
20043343,22,13,8,36,33,112,不合格
20043344,69,81,20,57,75,302,合格
20043345,49,31,78,76,99,333,合格
20043346,78,91,10,36,22,237,不合格
20043347,20,22,58,49,86,235,不合格
20043348,54,74,87,67,95,377,合格
20043349,36,43,18,44,36,177,不合格
20043350,50,52,47,61,83,293,不合格
20043351,29,85,28,99,34,275,不合格
20043352,1,3,94,71,80,249,不合格
20043353,75,63,50,67,38,293,不合格
20043354,46,96,72,89,50,353,合格
20043355,63,80,17,41,60,261,不合格
20043356,40,26,73,8,95,242,不合格
20043357,40,59,57,94,99,349,合格
20043358,63,53,27,90,22,255,不合格
20043359,36,37,58,99,97,327,合格
20043360,28,63,39,94,27,251,不合格
20043361,1,70,55,76,81,283,不合格
20043362,48,25,79,58,45,255,不合格
20043363,94,44,6,40,63,247,不合格
20043364,23,2,88,8,26,147,不合格
20043365,21,3,23,43,61,151,不合格
20043366,81,74,90,20,36,301,合格
20043367,56,25,30,60,36,207,不合格
20043368,2,13,84,60,35,194,不合格
20043369,76,3,77,98,19,273,不合格
20043370,27,22,26,77,34,186,不合格
20043371,47,76,64,95,25,307,合格
20043372,71,21,27,72,91,282,不合格
20043373,6,29,84,30,71,220,不合格
20043374,14,25,69,82,20,210,不合格
20043375,97,77,5,90,42,311,合格
20043376,26,44,2,84,88,244,不合格
20043377,58,27,14,20,87,206,不合格
20043378,28,69,28,87,5,217,不合格
20043379,12,48,71,88,43,262,不合格
20043380,34,63,26,58,83,264,不合格
20043381,64,47,78,88,27,304,合格
20043382,39,60,66,90,32,287,不合格
20043383,16,24,40,32,78,190,不合格
20043384,53,79,9,26,21,188,不合格
20043385,13,23,20,22,70,148,不合格
20043386,80,85,3,15,59,242,不合格
20043387,26,5,90,40,89,250,不合格
20043388,0,46,11,85,1,143,不合格
20043389,34,40,13,12,83,182,不合格
20043390,66,97,43,82,59,347,合格
20043391,10,11,73,64,53,211,不合格
20043392,52,5,88,64,17,226,不合格
20043393,85,44,53,63,77,322,合格
20043394,46,29,68,29,88,260,不合格
20043395,3,16,25,56,67,167,不合格
20043396,75,87,32,92,86,372,合格
20043397,79,67,15,42,91,294,不合格
20043398,75,64,83,92,70,384,合格
20043399,40,31,33,33,66,203,不合格
20043400,43,22,87,26,6,184,不合格
20043401,94,52,16,77,70,309,合格
20043402,73,82,24,70,41,290,不合格
20043403,7,28,21,70,79,205,不合格
20043404,25,81,45,25,36,212,不合格
20043405,10,42,28,57,27,164,不合格
20043406,39,77,94,38,48,296,不合格
20043407,62,7,78,30,8,185,不合格
20043408,12,1,91,36,85,225,不合格
20043409,80,22,76,31,55,264,不合格
20043410,66,39,96,15,57,273,不合格
20043411,45,7,51,52,4,159,不合格
20043412,77,87,97,4,63,328,合格
20043413,10,34,74,56,50,224,不合格
20043414,14,73,55,3,56,201,不合格
20043415,6,33,87,18,28,172,不合格
20043416,2,4,95,28,0,129,不合格
20043417,52,77,67,4,82,282,不合格
20043418,49,62,87,48,15,261,不合格
20043419,36,23,42,81,6,188,不合格
20043420,48,65,50,88,98,349,合格
20043421,34,21,25,15,54,149,不合格
20043422,32,88,51,82,95,348,合格
20043423,10,62,68,92,85,317,合格
20043424,83,21,38,26,82,250,不合格
20043425,74,17,75,52,66,284,不合格
20043426,57,60,14,87,47,265,不合格
20043427,0,95,27,79,69,270,不合格
20043428,89,73,96,11,43,312,合格
20043429,60,90,49,57,56,312,合格
20043430,46,77,0,54,9,186,不合格
20043431,6,25,35,78,72,216,不合格
20043432,55,84,85,81,74,379,合格
20043433,97,2,15,28,37,179,不合格
20043434,97,69,54,70,23,313,合格
20043435,98,45,64,77,79,363,合格
20043436,98,94,82,12,73,359,合格
20043437,71,82,5,17,42,217,不合格
20043438,22,51,46,57,85,261,不合格
20043439,47,61,94,80,87,369,合格
20043440,69,84,51,84,15,303,合格
20043441,34,21,61,16,97,229,不合格
20043442,42,67,58,97,29,293,不合格
20043443,45,33,68,58,58,262,不合格
20043444,61,10,76,66,38,251,不合格
20043445,13,93,19,66,73,264,不合格
20043446,92,8,49,41,12,202,不合格
20043447,31,50,76,76,62,295,不合格
20043448,2,17,37,38,80,174,不合格
20043449,85,2,92,95,66,340,合格
20043450,38,50,15,3,53,159,不合格
20043451,28,64,62,55,14,223,不合格
20043452,49,77,6,94,53,279,不合格
20043453,1,61,49,63,39,213,不合格
20043454,50,1,48,16,35,150,不合格
20043455,59,78,42,20,37,236,不合格
20043456,45,49,38,28,91,251,不合格
20043457,39,43,29,87,24,222,不合格
20043458,1,86,97,62,56,302,合格
20043459,99,24,0,22,46,191,不合格
20043460,42,90,61,92,6,291,不合格
20043461,8,94,90,68,80,340,合格
20043462,14,7,92,61,50,224,不合格
20043463,50,96,78,48,68,340,合格
20043464,14,95,5,66,36,216,不合格
20043465,74,18,83,97,39,311,合格
20043466,42,37,93,47,72,291,不合格
20043467,26,3,29,49,97,204,不合格
20043468,25,27,5,1,18,76,不合格
20043469,8,11,30,66,26,141,不合格
20043470,61,43,37,52,28,221,不合格
20043471,73,6,30,99,99,307,合格
20043472,54,22,79,39,62,256,不合格
20043473,26,11,54,3,95,189,不合格
20043474,29,26,55,80,56,246,不合格
20043475,44,81,66,79,90,360,合格
20043476,40,39,60,80,70,289,不合格
20043477,3,74,65,22,88,252,不合格
20043478,83,10,38,56,58,245,不合格
20043479,85,28,21,79,79,292,不合格
20043480,83,75,80,60,97,395,合格
20043481,60,76,45,18,38,237,不合格
20043482,69,65,54,30,17,235,不合格
20043483,10,75,50,82,5,222,不合格
20043484,7,37,27,98,38,207,不合格
20043485,0,52,0,27,97,176,不合格
20043486,52,98,98,4,73,325,合格
20043487,61,40,37,20,97,255,不合格
20043488,67,0,61,18,71,217,不合格
20043489,67,15,75,48,88,293,不合格
20043490,42,35,38,29,91,235,不合格
20043491,44,37,64,57,38,240,不合格
20043492,75,58,93,93,41,360,合格
20043493,12,7,70,83,30,202,不合格
20043494,63,55,56,21,48,243,不合格
20043495,58,49,99,33,26,265,不合格
20043496,79,87,40,8,51,265,不合格
20043497,97,33,8,3,53,194,不合格
20043498,46,53,78,66,29,272,不合格
20043499,30,80,75,73,43,301,合格
20043500,63,61,25,61,10,220,不合格
20043501,43,53,61,53,63,273,不合格
20043502,77,84,28,7,13,209,不合格
20043503,85,92,13,45,0,235,不合格
20043504,90,32,55,44,10,231,不合格
20043505,32,6,87,10,26,161,不合格
20043506,43,84,37,80,56,300,合格
20043507,49,93,68,66,56,332,合格
20043508,1,66,39,76,56,238,不合格
20043509,85,11,30,64,46,236,不合格
20043510,91,91,26,2,46,256,不合格
20043511,71,25,63,90,25,274,不合格
20043512,53,68,35,76,58,290,不合格
20043513,3,29,7,8,32,79,不合格
20043514,72,49,58,58,89,326,合格
20043515,48,3,42,58,17,168,不合格
20043516,9,63,22,56,31,181,不合格
20043517,60,68,45,81,27,281,不合格
20043518,52,33,42,49,99,275,不合格
20043519,89,20,80,31,80,300,合格
20043520,74,6,80,19,20,199,不合格
20043521,77,63,50,95,86,371,合格
20043522,8,55,76,27,99,265,不合格
20043523,37,25,72,32,18,184,不合格
20043524,14,4,58,35,86,197,不合格
20043525,81,79,36,89,25,310,合格
20043526,86,65,15,77,69,312,合格
20043527,20,35,91,69,8,223,不合格
20043528,4,60,23,54,64,205,不合格
20043529,33,78,49,31,24,215,不合格
20043530,30,93,40,53,53,269,不合格
20043531,36,80,73,31,54,274,不合格
20043532,71,63,7,28,96,265,不合格
20043533,95,50,22,36,34,237,不合格
20043534,32,32,63,46,71,244,不合格
20043535,15,98,4,7,19,143,不合格
20043536,75,47,63,13,75,273,不合格
20043537,33,16,84,45,18,196,不合格
20043538,62,61,96,26,33,278,不合格
20043539,83,88,69,14,70,324,合格
20043540,25,5,64,88,36,218,不合格
20043541,83,14,27,50,92,266,不合格
20043542,55,0,71,45,39,210,不合格
20043543,20,21,15,37,79,172,不合格
20043544,65,7,60,84,7,223,不合格
20043545,84,7,39,82,67,279,不合格
20043546,61,64,58,49,72,304,合格
20043547,37,4,28,98,72,239,不合格
20043548,97,1,82,82,24,286,不合格
20043549,63,39,1,37,39,179,不合格
20043550,59,88,3,80,26,256,不合格
20043551,2,7,42,37,44,132,不合格
20043552,72,45,85,58,62,322,合格
20043553,78,52,47,62,26,265,不合格
20043554,42,90,1,52,66,251,不合格
20043555,13,70,55,60,5,203,不合格
20043556,75,40,15,64,45,239,不合格
20043557,11,88,55,28,49,231,不合格
20043558,16,61,48,44,63,232,不合格
20043559,8,70,8,50,15,151,不合格
20043560,24,11,2,36,86,159,不合格
20043561,78,41,8,56,83,266,不合格
20043562,30,80,92,44,49,295,不合格
20043563,14,15,84,15,57,185,不合格
20043564,21,33,67,53,34,208,不合格
20043565,5,48,86,86,84,309,合格
20043566,4,34,91,64,5,198,不合格
20043567,48,68,69,0,46,231,不合格
20043568,63,12,40,53,82,250,不合格
20043569,58,18,32,22,50,180,不合格
20043570,41,67,53,98,27,286,不合格
20043571,54,12,64,61,77,268,不合格
20043572,70,65,37,98,15,285,不合格
20043573,22,79,72,33,69,275,不合格
20043574,86,88,52,12,78,316,合格
20043575,21,42,88,46,29,226,不合格
20043576,93,91,55,57,1,297,不合格
20043577,77,52,84,60,44,317,合格
20043578,3,95,23,70,78,269,不合格
20043579,36,47,47,57,7,194,不合格
20043580,24,90,36,10,51,211,不合格
20043581,80,69,91,83,50,373,合格
20043582,17,22,62,97,30,228,不合格
20043583,8,36,33,77,4,158,不合格
20043584,72,96,61,31,47,307,合格
20043585,75,33,59,98,79,344,合格
20043586,85,71,80,28,5,269,不合格
20043587,20,85,4,17,86,212,不合格
20043588,30,76,47,19,42,214,不合格
20043589,40,48,33,87,4,212,不合格
20043590,54,63,30,53,32,232,不合格
20043591,58,62,0,7,93,220,不合格
20043592,74,67,49,22,58,270,不合格
20043593,19,88,12,99,93,311,合格
20043594,57,52,8,60,17,194,不合格
20043595,56,47,70,80,38,291,不合格
20043596,46,89,30,29,54,248,不合格
20043597,23,20,84,89,60,276,不合格
20043598,13,56,34,93,45,241,不合格
20043599,67,51,64,39,70,291,不合格
20043600,79,69,60,44,29,281,不合格
20043601,33,31,31,58,72,225,不合格
20043602,25,1,46,99,35,206,不合格
20043603,15,33,82,87,95,312,合格
20043604,91,74,20,62,63,310,合格
20043605,85,48,49,1,67,250,不合格
20043606,74,88,83,34,29,308,合格
20043607,44,25,64,64,76,273,不合格
20043608,91,42,56,93,98,380,合格
20043609,45,84,59,19,98,305,合格
20043610,82,34,36,6,39,197,不合格
20043611,6,41,31,64,23,165,不合格
20043612,20,13,24,70,18,145,不合格
20043613,35,54,20,53,48,210,不合格
20043614,81,56,72,43,70,322,合格
20043615,9,8,50,41,82,190,不合格
20043616,34,42,61,26,66,229,不合格
20043617,97,46,69,76,66,354,合格
20043618,80,96,95,73,23,367,合格
20043619,8,79,70,94,3,254,不合格
20043620,87,99,60,89,11,346,合格
20043621,78,67,5,61,15,226,不合格
20043622,61,24,3,39,71,198,不合格
20043623,66,20,20,91,14,211,不合格
20043624,31,65,48,45,2,191,不合格
20043625,95,30,87,31,19,262,不合格
20043626,74,24,38,71,82,289,不合格
20043627,20,99,55,69,84,327,合格
20043628,77,61,71,48,93,350,合格
20043629,72,51,86,59,14,282,不合格
20043630,99,27,92,96,84,398,合格
20043631,38,83,34,33,17,205,不合格
20043632,36,66,41,17,32,192,不合格
20043633,56,38,32,53,17,196,不合格
20043634,10,76,70,97,69,322,合格
20043635,80,0,78,57,33,248,不合格
20043636,69,37,35,29,41,211,不合格
20043637,73,74,9,84,17,257,不合格
20043638,89,28,88,52,48,305,合格
20043639,75,91,60,71,65,362,合格
20043640,88,73,61,80,87,389,合格
20043641,50,16,38,18,55,177,不合格
20043642,63,14,69,27,48,221,不合格
20043643,23,8,95,3,23,152,不合格
20043644,82,60,71,1,48,262,不合格
20043645,7,39,94,79,69,288,不合格
20043646,48,28,46,27,84,233,不合格
20043647,5,27,89,6,76,203,不合格
20043648,50,16,28,48,65,207,不合格
20043649,99,88,76,77,49,389,合格
20043650,83,23,49,37,28,220,不合格
20043651,0,20,12,43,37,112,不合格
20043652,10,15,63,79,69,236,不合格
20043653,4,56,12,72,19,163,不合格
20043654,90,67,45,5,99,306,合格
20043655,54,94,57,87,52,344,合格
20043656,46,96,81,77,92,392,合格
20043657,23,8,26,53,97,207,不合格
20043658,4,60,0,14,94,172,不合格
20043659,31,28,66,66,38,229,不合格
20043660,21,83,2,99,43,248,不合格
20043661,24,48,4,86,46,208,不合格
20043662,34,40,11,70,57,212,不合格
20043663,79,92,6,24,86,287,不合格
20043664,44,56,29,82,87,298,不合格
20043665,51,40,4,53,54,202,不合格
20043666,73,77,16,38,78,282,不合格
20043667,37,84,42,82,43,288,不合格
20043668,84,83,33,9,56,265,不合格
20043669,20,84,97,78,40,319,合格
20043670,26,67,8,97,1,199,不合格
20043671,9,40,82,26,26,183,不合格
20043672,89,48,33,86,76,332,合格
20043673,75,1,58,43,90,267,不合格
20043674,97,2,0,68,6,173,不合格
20043675,5,34,93,42,72,246,不合格
20043676,45,42,90,2,7,186,不合格
20043677,26,9,35,83,72,225,不合格
20043678,82,47,28,61,65,283,不合格
20043679,74,52,64,67,77,334,合格
20043680,33,2,81,92,1,209,不合格
20043681,19,61,60,44,90,274,不合格
20043682,49,90,70,3,72,284,不合格
20043683,1,34,43,96,98,272,不合格
20043684,45,69,52,31,53,250,不合格
20043685,56,10,79,94,59,298,不合格
20043686,99,53,85,53,20,310,合格
20043687,93,27,60,59,99,338,合格
20043688,31,25,86,46,42,230,不合格
20043689,39,85,56,92,24,296,不合格
20043690,49,83,61,13,94,300,合格
20043691,10,17,42,51,99,219,不合格
20043692,72,40,1,6,92,211,不合格
20043693,63,49,19,95,19,245,不合格
20043694,3,68,45,76,46,238,不合格
20043695,47,1,1,97,49,195,不合格
20043696,89,41,28,4,3,165,不合格
20043697,73,19,66,70,62,290,不合格
20043698,64,52,38,1,89,244,不合格
20043699,48,47,90,79,99,363,合格
20043700,47,75,7,29,81,239,不合格
20043701,28,47,63,54,53,245,不合格
20043702,4,76,90,0,94,264,不合格
20043703,14,20,73,67,57,231,不合格
20043704,84,32,38,22,90,266,不合格
20043705,40,65,36,69,87,297,不合格
20043706,45,17,58,69,30,219,不合格
20043707,23,64,73,17,51,228,不合格
20043708,78,41,47,73,87,326,合格
20043709,78,30,20,59,4,191,不合格
20043710,35,47,65,29,65,241,不合格
20043711,45,10,78,74,44,251,不合格
20043712,51,65,52,3,90,261,不合格
20043713,19,2,40,36,73,170,不合格
20043714,98,76,90,87,57,408,合格
20043715,95,66,17,71,44,293,不合格
20043716,94,93,71,79,38,375,合格
20043717,18,34,95,62,58,267,不合格
20043718,62,13,62,19,89,245,不合格
20043719,37,48,5,39,87,216,不合格
20043720,92,91,93,28,91,395,合格
20043721,69,9,84,36,2,200,不合格
20043722,23,9,70,59,24,185,不合格
20043723,66,71,36,6,85,264,不合格
20043724,29,95,48,16,23,211,不合格
20043725,63,69,13,77,39,261,不合格
20043726,56,29,31,28,46,190,不合格
20043727,45,33,79,14,19,190,不合格
20043728,80,21,86,97,48,332,合格
20043729,55,29,21,10,83,198,不合格
20043730,54,97,90,16,7,264,不合格
20043731,35,48,95,34,77,289,不合格
20043732,3,62,22,37,9,133,不合格
20043733,2,26,24,96,92,240,不合格
20043734,82,80,13,43,55,273,不合格
20043735,47,1,50,60,5,163,不合格
20043736,30,70,35,11,57,203,不合格
20043737,78,32,67,44,98,319,合格
20043738,10,74,1,15,37,137,不合格
20043739,85,38,25,90,27,265,不合格
20043740,60,43,39,36,64,242,不合格
20043741,17,61,11,94,20,203,不合格
20043742,90,36,40,63,65,294,不合格
20043743,42,87,48,30,8,215,不合格
20043744,50,27,86,16,56,235,不合格
20043745,99,76,60,79,51,365,合格
20043746,57,12,62,79,58,268,不合格
20043747,28,81,42,77,18,246,不合格
20043748,20,93,58,19,28,218,不合格
20043749,4,27,46,48,42,167,不合格
20043750,40,55,75,72,68,310,合格
20043751,1,19,80,22,83,205,不合格
20043752,80,91,94,38,13,316,合格
20043753,56,88,81,10,6,241,不合格
20043754,49,35,97,59,44,284,不合格
20043755,26,18,33,6,66,149,不合格
20043756,81,6,45,91,65,288,不合格
20043757,82,69,85,71,34,341,合格
20043758,29,71,0,38,95,233,不合格
20043759,11,65,84,34,38,232,不合格
20043760,29,16,82,89,6,222,不合格
20043761,13,62,37,62,42,216,不合格
20043762,64,52,25,89,39,269,不合格
20043763,71,31,26,88,7,223,不合格
20043764,84,62,37,11,68,262,不合格
20043765,8,51,10,58,50,177,不合格
20043766,95,75,15,85,95,365,合格
20043767,49,34,75,5,99,262,不合格
20043768,90,55,56,42,58,301,合格
20043769,22,16,75,43,76,232,不合格
20043770,77,37,47,94,67,322,合格
20043771,10,67,72,59,37,245,不合格
20043772,26,72,17,22,2,139,不合格
20043773,92,22,4,20,89,227,不合格
20043774,19,45,12,55,8,139,不合格
20043775,97,86,40,92,65,380,合格
20043776,35,75,37,7,72,226,不合格
20043777,45,99,16,36,80,276,不合格
20043778,53,63,2,57,79,254,不合格
20043779,70,17,51,3,3,144,不合格
20043780,30,88,66,83,77,344,合格
20043781,98,57,43,36,50,284,不合格
20043782,86,38,95,71,0,290,不合格
20043783,17,23,36,21,82,179,不合格
20043784,41,31,79,55,40,246,不合格
20043785,37,45,4,21,54,161,不合格
20043786,26,61,61,5,62,215,不合格
20043787,28,27,49,41,49,194,不合格
20043788,62,54,62,43,95,316,合格
20043789,73,96,31,69,75,344,合格
20043790,29,13,31,72,53,198,不合格
20043791,61,71,69,75,57,333,合格
20043792,31,83,94,64,39,311,合格
20043793,41,60,39,2,86,228,不合格
20043794,24,81,58,19,36,218,不合格
20043795,21,73,32,49,9,184,不合格
20043796,65,67,12,24,8,176,不合格
20043797,78,80,72,10,96,336,合格
20043798,94,60,98,21,43,316,合格
20043799,15,38,40,96,32,221,不合格
20043800,17,28,34,12,64,155,不合格
20043801,4,45,75,76,23,223,不合格
20043802,21,80,86,57,45,289,不合格
20043803,64,36,90,47,56,293,不合格
20043804,28,39,68,89,95,319,合格
20043805,53,66,79,78,99,375,合格
20043806,88,92,75,75,60,390,合格
20043807,26,88,56,53,14,237,不合格
20043808,84,29,62,70,9,254,不合格
20043809,92,12,45,96,29,274,不合格
20043810,84,54,31,85,29,283,不合格
20043811,92,52,76,97,49,366,合格
20043812,67,73,12,14,48,214,不合格
20043813,8,69,51,2,45,175,不合格
20043814,68,6,43,86,40,243,不合格
20043815,13,12,10,35,9,79,不合格
20043816,70,35,74,59,21,259,不合格
20043817,46,5,33,27,32,143,不合格
20043818,63,64,70,28,90,315,合格
20043819,45,7,45,75,60,232,不合格
20043820,17,43,17,93,64,234,不合格
20043821,0,95,22,11,90,218,不合格
20043822,21,49,91,68,2,231,不合格
20043823,27,36,80,83,16,242,不合格
20043824,57,3,31,38,98,227,不合格
20043825,45,91,10,75,23,244,不合格
20043826,42,73,26,77,84,302,合格
20043827,54,6,24,69,57,210,不合格
20043828,40,31,83,36,69,259,不合格
20043829,84,46,74,36,78,318,合格
20043830,85,34,6,77,43,245,不合格
20043831,81,32,82,51,88,334,合格
20043832,45,58,7,32,59,201,不合格
20043833,96,33,10,75,40,254,不合格
20043834,81,76,69,95,71,392,合格
20043835,49,92,5,22,97,265,不合格
20043836,1,41,9,27,59,137,不合格
20043837,7,59,41,55,52,214,不合格
20043838,88,72,37,50,2,249,不合格
20043839,67,1,57,62,72,259,不合格
20043840,23,45,85,82,58,293,不合格
20043841,61,18,95,87,25,286,不合格
20043842,69,94,49,16,76,304,合格
20043843,60,39,69,10,35,213,不合格
20043844,74,24,80,23,82,283,不合格
20043845,39,34,99,74,83,329,合格
20043846,69,62,80,92,11,314,合格
20043847,60,79,41,54,3,237,不合格
20043848,43,4,62,62,17,188,不合格
20043849,99,74,78,0,28,279,不合格
20043850,37,57,29,51,44,218,不合格
20043851,90,38,22,55,54,259,不合格
20043852,91,15,59,52,68,285,不合格
20043853,89,62,51,18,41,261,不合格
20043854,84,23,7,58,74,246,不合格
20043855,83,87,19,57,80,326,合格
20043856,95,88,9,36,71,299,不合格
20043857,68,12,94,83,95,352,合格
20043858,84,8,24,34,19,169,不合格
20043859,47,26,9,28,45,155,不合格
20043860,54,84,42,89,51,320,合格
20043861,4,63,68,85,88,308,合格
20043862,72,9,27,77,9,194,不合格
20043863,13,70,42,90,13,228,不合格
20043864,98,76,61,7,86,328,合格
20043865,77,41,7,88,64,277,不合格
20043866,13,8,6,87,42,156,不合格
20043867,90,47,98,3,88,326,合格
20043868,94,83,36,0,72,285,不合格
20043869,23,67,63,43,41,237,不合格
20043870,56,8,62,53,30,209,不合格
20043871,67,89,53,31,84,324,合格
20043872,96,6,80,42,77,301,合格
20043873,48,49,38,62,30,227,不合格
20043874,15,32,84,63,82,276,不合格
20043875,73,63,26,7,39,208,不合格
20043876,90,10,9,93,78,280,不合格
20043877,20,48,95,57,85,305,合格
20043878,47,36,80,22,16,201,不合格
20043879,70,29,19,52,35,205,不合格
20043880,10,85,33,99,82,309,合格
20043881,79,36,27,26,52,220,不合格
20043882,71,26,61,25,36,219,不合格
20043883,46,53,3,23,40,165,不合格
20043884,71,95,64,66,32,328,合格
20043885,44,13,13,39,64,173,不合格
20043886,53,90,30,88,40,301,合格
20043887,24,95,64,72,93,348,合格
20043888,69,76,65,41,57,308,合格
20043889,51,28,88,10,65,242,不合格
20043890,79,65,52,75,4,275,不合格
20043891,59,23,3,85,65,235,不合格
20043892,35,25,65,58,74,257,不合格
20043893,30,45,0,1,24,100,不合格
20043894,26,44,38,6,41,155,不合格
20043895,48,36,71,51,52,258,不合格
20043896,26,51,7,25,47,156,不合格
20043897,80,71,45,14,8,218,不合格
20043898,63,43,94,17,76,293,不合格
20043899,10,84,30,45,96,265,不合格
20043900,70,61,12,8,68,219,不合格
20043901,7,59,14,0,6,86,不合格
20043902,27,17,91,98,12,245,不合格
20043903,38,35,25,19,68,185,不合格
20043904,57,83,50,55,16,261,不合格
20043905,44,38,24,31,95,232,不合格
20043906,79,23,13,65,6,186,不合格
20043907,63,56,39,9,11,178,不合格
20043908,30,27,81,55,95,288,不合格
20043909,50,71,8,75,34,238,不合格
20043910,70,97,0,59,20,246,不合格
20043911,60,79,60,16,61,276,不合格
20043912,88,76,51,66,22,303,合格
20043913,21,27,73,65,16,202,不合格
20043914,81,25,84,90,68,348,合格
20043915,24,60,8,4,38,134,不合格
20043916,79,13,86,7,53,238,不合格
20043917,34,16,91,92,71,304,合格
20043918,47,58,50,55,30,240,不合格
20043919,66,30,23,52,45,216,不合格
20043920,26,30,64,88,33,241,不合格
20043921,8,25,40,52,15,140,不合格
20043922,56,49,49,6,89,249,不合格
20043923,52,14,83,17,81,247,不合格
20043924,76,46,34,4,0,160,不合格
20043925,74,40,29,98,58,299,不合格
20043926,65,35,47,28,61,236,不合格
20043927,47,42,52,61,91,293,不合格
20043928,73,82,78,38,44,315,合格
20043929,85,39,4,58,79,265,不合格
20043930,95,39,78,88,62,362,合格
20043931,54,47,92,34,83,310,合格
20043932,64,51,21,65,35,236,不合格
20043933,7,0,18,43,40,108,不合格
20043934,46,71,34,75,95,321,合格
20043935,45,23,91,5,94,258,不合格
20043936,58,74,53,50,3,238,不合格
20043937,56,29,4,40,85,214,不合格
20043938,48,54,28,57,53,240,不合格
20043939,69,77,41,58,2,247,不合格
20043940,7,64,47,45,5,168,不合格
20043941,38,25,61,92,84,300,合格
20043942,15,77,44,39,51,226,不合格
20043943,46,97,82,3,88,316,合格
20043944,11,11,0,66,69,157,不合格
20043945,43,21,47,41,4,156,不合格
20043946,34,26,5,60,77,202,不合格
20043947,52,36,18,65,58,229,不合格
20043948,93,74,43,47,33,290,不合格
20043949,26,33,44,35,80,218,不合格
20043950,30,71,25,62,77,265,不合格
20043951,89,88,87,94,54,412,合格
20043952,95,72,76,33,50,326,合格
20043953,47,82,62,43,50,284,不合格
20043954,4,48,57,63,80,252,不合格
20043955,97,59,43,86,2,287,不合格
20043956,61,30,89,16,67,263,不合格
20043957,28,57,57,36,18,196,不合格
20043958,90,40,9,45,65,249,不合格
20043959,83,82,2,95,44,306,合格
20043960,26,71,30,23,37,187,不合格
20043961,65,26,63,68,49,271,不合格
20043962,9,29,28,79,92,237,不合格
20043963,42,34,17,63,95,251,不合格
20043964,89,51,45,43,13,241,不合格
20043965,4,42,45,9,61,161,不合格
20043966,5,6,68,26,93,198,不合格
20043967,74,19,45,93,80,311,合格
20043968,87,60,87,80,31,345,合格
20043969,76,87,54,54,52,323,合格
20043970,4,70,70,14,47,205,不合格
20043971,98,28,87,2,37,252,不合格
20043972,81,45,50,39,41,256,不合格
20043973,28,68,94,95,12,297,不合格
20043974,36,1,55,28,16,136,不合格
20043975,82,3,22,8,67,182,不合格
20043976,59,51,35,20,61,226,不合格
20043977,9,46,19,67,17,158,不合格
20043978,48,94,59,98,3,302,合格
20043979,39,79,8,85,3,214,不合格
20043980,75,10,37,26,75,223,不合格
20043981,50,10,9,60,19,148,不合格
20043982,3,28,9,48,48,136,不合格
20043983,75,79,69,85,63,371,合格
20043984,98,56,96,39,17,306,合格
20043985,8,88,51,27,89,263,不合格
20043986,92,52,95,48,95,382,合格
20043987,79,43,31,24,10,187,不合格
20043988,77,41,26,27,92,263,不合格
20043989,63,59,96,19,45,282,不合格
20043990,70,38,76,81,90,355,合格
20043991,61,75,54,81,33,304,合格
20043992,42,28,93,45,86,294,不合格
20043993,21,68,85,8,58,240,不合格
20043994,10,67,11,69,68,225,不合格
20043995,44,53,84,40,52,273,不合格
20043996,1,12,85,87,96,281,不合格
20043997,56,73,4,31,66,230,不合格
20043998,36,64,78,25,32,235,不合格
20043999,73,36,55,52,44,260,不合格
20044000,5,68,20,8,3,104,不合格
20044001,27,96,2,69,59,253,不合格
20044002,77,82,54,43,39,295,不合格
20044003,82,55,1,80,80,298,不合格
20044004,21,4,97,48,60,230,不合格
20044005,86,44,53,48,24,255,不合格
20044006,60,54,30,65,98,307,合格
20044007,92,54,58,30,96,330,合格
20044008,6,11,86,89,29,221,不合格
20044009,35,59,30,11,77,212,不合格
20044010,74,33,59,71,65,302,合格
20044011,13,88,35,91,47,274,不合格
20044012,40,18,19,6,95,178,不合格
20044013,48,5,99,33,11,196,不合格
20044014,41,11,41,40,75,208,不合格
20044015,13,51,51,27,9,151,不合格
20044016,25,10,72,42,82,231,不合格
20044017,38,44,63,39,78,262,不合格
20044018,73,77,80,91,66,387,合格
20044019,18,24,32,14,33,121,不合格
20044020,64,75,54,0,25,218,不合格
20044021,45,17,20,44,71,197,不合格
20044022,47,13,83,0,83,226,不合格
20044023,48,16,53,87,7,211,不合格
20044024,97,89,73,56,37,352,合格
20044025,55,99,93,33,89,369,合格
20044026,89,18,60,47,41,255,不合格
20044027,79,7,33,43,97,259,不合格
20044028,99,73,5,63,29,269,不合格
20044029,40,57,6,47,34,184,不合格
20044030,63,14,17,32,1,127,不合格
20044031,9,36,33,37,22,137,不合格
20044032,68,79,98,99,77,421,合格
20044033,89,80,17,51,89,326,合格
20044034,70,41,47,2,81,241,不合格
20044035,61,43,82,76,4,266,不合格
20044036,28,4,81,83,27,223,不合格
20044037,20,23,54,1,76,174,不合格
20044038,33,52,73,28,51,237,不合格
20044039,23,68,89,8,68,256,不合格
20044040,56,77,2,95,49,279,不合格
20044041,85,62,66,16,3,232,不合格
20044042,42,54,62,5,3,166,不合格
20044043,58,12,0,83,86,239,不合格
20044044,68,78,19,59,64,288,不合格
20044045,18,18,54,47,41,178,不合格
20044046,56,14,42,24,61,197,不合格
20044047,73,84,43,17,88,305,合格
20044048,47,26,66,22,45,206,不合格
20044049,0,9,69,19,40,137,不合格
20044050,28,89,24,47,92,280,不合格
20044051,65,29,48,30,78,250,不合格
20044052,46,62,60,17,9,194,不合格
20044053,34,43,31,97,59,264,不合格
20044054,98,78,8,79,41,304,合格
20044055,49,10,79,22,18,178,不合格
20044056,16,67,85,47,16,231,不合格
20044057,66,38,3,7,30,144,不合格
20044058,20,49,97,25,42,233,不合格
20044059,96,22,60,58,56,292,不合格
20044060,76,21,15,73,20,205,不合格
20044061,86,94,18,59,50,307,合格
20044062,36,85,81,28,62,292,不合格
20044063,36,91,55,63,76,321,合格
20044064,70,33,54,30,72,259,不合格
20044065,46,83,97,62,29,317,合格
20044066,63,63,36,29,45,236,不合格
20044067,9,41,37,6,83,176,不合格
20044068,3,32,87,77,54,253,不合格
20044069,69,89,54,24,69,305,合格
20044070,89,38,80,27,11,245,不合格
20044071,92,33,36,83,23,267,不合格
20044072,33,11,19,92,25,180,不合格
20044073,61,31,1,80,30,203,不合格
20044074,19,99,20,40,27,205,不合格
20044075,67,2,71,23,33,196,不合格
20044076,36,50,76,37,72,271,不合格
20044077,80,71,49,22,50,272,不合格
20044078,19,14,21,69,91,214,不合格
20044079,68,64,9,34,50,225,不合格
20044080,74,35,50,81,68,308,合格
20044081,4,3,68,80,40,195,不合格
20044082,58,58,79,45,2,242,不合格
20044083,80,42,89,36,90,337,合格
20044084,5,83,42,30,77,237,不合格
20044085,44,41,69,27,70,251,不合格
20044086,36,32,23,32,79,202,不合格
20044087,95,30,81,67,76,349,合格
20044088,73,69,62,81,91,376,合格
20044089,75,18,27,58,30,208,不合格
20044090,13,83,26,55,92,269,不合格
20044091,71,37,58,96,81,343,合格
20044092,9,71,64,73,30,247,不合格
20044093,54,44,41,47,95,281,不合格
20044094,82,23,21,41,26,193,不合格
20044095,13,32,76,6,24,151,不合格
20044096,75,46,63,80,85,349,合格
20044097,54,56,25,88,35,258,不合格
20044098,85,20,93,67,64,329,合格
20044099,84,26,0,30,78,218,不合格
20044100,76,68,14,41,39,238,不合格
20044101,95,77,24,42,33,271,不合格
20044102,34,10,46,59,55,204,不合格
20044103,12,83,28,19,3,145,不合格
20044104,87,63,92,19,58,319,合格
20044105,51,28,73,18,32,202,不合格
20044106,63,88,64,18,11,244,不合格
20044107,49,6,80,23,54,212,不合格
20044108,35,46,18,47,8,154,不合格
20044109,78,92,86,15,86,357,合格
20044110,17,45,9,84,99,254,不合格
20044111,49,23,40,48,90,250,不合格
20044112,67,98,72,39,68,344,合格
20044113,70,56,63,41,84,314,合格
20044114,99,79,55,93,53,379,合格
20044115,67,23,90,70,19,269,不合格
20044116,91,39,61,90,37,318,合格
20044117,41,87,58,92,19,297,不合格
20044118,40,51,35,96,67,289,不合格
20044119,66,22,65,0,43,196,不合格
20044120,40,11,5,69,82,207,不合格
20044121,86,5,59,95,58,303,合格
20044122,88,20,70,23,10,211,不合格
20044123,43,58,6,28,39,174,不合格
20044124,40,22,85,40,3,190,不合格
20044125,86,79,12,65,54,296,不合格
20044126,51,22,94,80,16,263,不合格
20044127,83,23,4,99,75,284,不合格
20044128,48,0,21,51,81,201,不合格
20044129,34,29,35,94,68,260,不合格
20044130,72,66,30,38,55,261,不合格
20044131,63,35,4,96,71,269,不合格
20044132,9,27,98,16,65,215,不合格
20044133,69,20,94,70,89,342,合格
20044134,37,14,46,35,3,135,不合格
20044135,95,84,31,53,45,308,合格
20044136,20,85,16,2,4,127,不合格
20044137,21,84,79,76,43,303,合格
20044138,39,20,22,35,92,208,不合格
20044139,16,63,9,39,22,149,不合格
20044140,41,83,53,78,27,282,不合格
20044141,29,73,13,84,3,202,不合格
20044142,54,75,69,96,60,354,合格
20044143,74,40,66,41,23,244,不合格
20044144,25,72,27,13,62,199,不合格
20044145,75,35,14,83,75,282,不合格
20044146,4,6,49,49,51,159,不合格
20044147,55,5,54,78,47,239,不合格
20044148,56,90,27,36,66,275,不合格
20044149,97,41,43,21,40,242,不合格
20044150,10,14,52,91,85,252,不合格
20044151,56,71,47,44,67,285,不合格
20044152,36,63,13,26,53,191,不合格
20044153,87,69,57,95,43,351,合格
20044154,47,18,99,8,61,233,不合格
20044155,32,58,33,86,53,262,不合格
20044156,45,97,40,47,7,236,不合格
20044157,43,54,37,8,18,160,不合格
20044158,55,43,70,91,71,330,合格
20044159,84,88,35,32,52,291,不合格
20044160,57,26,14,99,18,214,不合格
20044161,69,43,21,11,90,234,不合格
20044162,96,42,66,25,45,274,不合格
20044163,93,22,68,15,67,265,不合格
20044164,94,77,49,29,44,293,不合格
20044165,69,47,66,95,76,353,合格
20044166,20,44,76,89,99,328,合格
20044167,55,54,29,57,39,234,不合格
20044168,30,18,60,58,30,196,不合格
20044169,75,19,34,72,31,231,不合格
20044170,15,0,31,15,44,105,不合格
20044171,53,84,36,92,90,355,合格
20044172,20,86,49,41,42,238,不合格
20044173,18,29,56,24,86,213,不合格
20044174,44,58,67,74,13,256,不合格
20044175,78,63,24,54,74,293,不合格
20044176,86,18,97,19,29,249,不合格
20044177,30,54,65,71,59,279,不合格
20044178,25,31,24,82,40,202,不合格
20044179,49,41,76,10,20,196,不合格
20044180,57,26,61,48,66,258,不合格
20044181,1,27,13,23,16,80,不合格
20044182,82,22,34,68,6,212,不合格
20044183,35,39,65,8,72,219,不合格
20044184,77,75,86,99,61,398,合格
20044185,67,45,50,88,4,254,不合格
20044186,99,56,99,33,66,353,合格
20044187,63,36,63,49,41,252,不合格
20044188,61,17,84,86,89,337,合格
20044189,26,36,38,53,66,219,不合格
20044190,38,94,71,32,17,252,不合格
20044191,95,87,7,79,88,356,合格
20044192,48,52,66,60,69,295,不合格
20044193,91,89,35,68,71,354,合格
20044194,42,46,88,71,64,311,合格
20044195,48,47,1,47,82,225,不合格
20044196,13,8,79,95,35,230,不合格
20044197,52,97,64,59,76,348,合格
20044198,49,56,23,85,70,283,不合格
20044199,54,21,39,33,12,159,不合格
20044200,80,40,98,2,38,258,不合格
20044201,75,91,37,40,15,258,不合格
20044202,95,23,39,59,67,283,不合格
20044203,11,20,21,57,53,162,不合格
20044204,32,19,64,55,92,262,不合格
20044205,69,62,40,33,80,284,不合格
20044206,58,84,56,90,64,352,合格
20044207,70,25,73,18,95,281,不合格
20044208,21,40,10,24,85,180,不合格
20044209,60,99,34,39,7,239,不合格
20044210,87,38,6,82,85,298,不合格
20044211,15,7,47,77,17,163,不合格
20044212,69,14,15,16,48,162,不合格
20044213,65,25,59,0,92,241,不合格
20044214,8,11,35,16,41,111,不合格
20044215,98,66,6,75,40,285,不合格
20044216,98,56,85,15,21,275,不合格
20044217,0,8,20,48,89,165,不合格
20044218,97,65,10,28,0,200,不合格
20044219,66,0,51,18,1,136,不合格
20044220,78,45,96,44,84,347,合格
20044221,31,94,44,84,75,328,合格
20044222,23,79,27,36,8,173,不合格
20044223,26,42,88,89,99,344,合格
20044224,43,8,37,28,52,168,不合格
20044225,23,79,69,84,90,345,合格
20044226,43,75,48,15,86,267,不合格
20044227,80,8,82,13,40,223,不合格
20044228,34,90,82,64,53,323,合格
20044229,77,85,19,15,80,276,不合格
20044230,18,33,90,12,33,186,不合格
20044231,58,92,85,18,39,292,不合格
20044232,81,67,47,18,5,218,不合格
20044233,89,58,98,58,32,335,合格
20044234,90,20,95,30,51,286,不合格
20044235,52,74,14,97,93,330,合格
20044236,81,99,85,11,17,293,不合格
20044237,35,3,39,72,76,225,不合格
20044238,55,48,11,52,90,256,不合格
20044239,60,66,44,81,56,307,合格
20044240,31,97,77,73,35,313,合格
20044241,74,21,45,3,16,159,不合格
20044242,86,19,7,88,66,266,不合格
20044243,79,71,32,70,51,303,合格
20044244,58,60,81,23,13,235,不合格
20044245,23,90,23,20,52,208,不合格
20044246,57,13,94,71,86,321,合格
20044247,72,84,77,34,49,316,合格
20044248,38,6,94,77,84,299,不合格
20044249,91,45,56,21,91,304,合格
20044250,48,24,87,39,40,238,不合格
20044251,29,50,28,7,36,150,不合格
20044252,39,49,34,34,2,158,不合格
20044253,87,89,53,62,92,383,合格
20044254,39,76,82,27,44,268,不合格
20044255,80,35,8,47,18,188,不合格
20044256,54,11,50,56,4,175,不合格
20044257,78,17,96,63,29,283,不合格
20044258,7,26,23,10,73,139,不合格
20044259,81,72,82,79,19,333,合格
20044260,39,13,4,36,65,157,不合格
20044261,24,51,26,5,47,153,不合格
20044262,17,2,34,74,55,182,不合格
20044263,11,58,2,74,3,148,不合格
20044264,1,8,63,22,93,187,不合格
20044265,12,86,68,55,19,240,不合格
20044266,68,5,45,84,57,259,不合格
20044267,62,81,82,89,74,388,合格
20044268,36,41,78,97,93,345,合格
20044269,43,53,73,57,6,232,不合格
20044270,98,40,83,27,24,272,不合格
20044271,81,53,79,75,93,381,合格
20044272,78,37,67,33,51,266,不合格
20044273,48,2,18,3,90,161,不合格
20044274,48,38,73,89,43,291,不合格
20044275,97,40,49,5,50,241,不合格
20044276,50,41,38,9,87,225,不合格
20044277,74,51,90,88,42,345,合格
20044278,5,72,35,68,83,263,不合格
20044279,98,67,61,70,71,367,合格
20044280,70,19,39,53,43,224,不合格
20044281,79,3,47,45,76,250,不合格
20044282,66,21,50,5,80,222,不合格
20044283,58,18,86,84,54,300,合格
20044284,34,97,97,80,15,323,合格
20044285,53,22,44,17,49,185,不合格
20044286,96,30,69,22,93,310,合格
20044287,40,2,74,84,72,272,不合格
20044288,4,70,52,74,43,243,不合格
20044289,85,86,74,31,99,375,合格
20044290,55,4,65,87,74,285,不合格
20044291,53,62,11,35,54,215,不合格
20044292,76,41,72,57,90,336,合格
20044293,96,5,20,1,56,178,不合格
20044294,23,62,87,85,42,299,不合格
20044295,59,6,5,65,68,203,不合格
20044296,78,44,47,72,89,330,合格
20044297,28,64,8,32,87,219,不合格
20044298,81,98,64,22,92,357,合格
20044299,20,38,41,36,83,218,不合格
20044300,75,27,60,99,19,280,不合格
20044301,44,42,30,25,89,230,不合格
20044302,37,46,69,67,97,316,合格
20044303,38,93,11,55,27,224,不合格
20044304,25,32,88,91,12,248,不合格
20044305,1,17,4,65,71,158,不合格
20044306,83,88,34,81,88,374,合格
20044307,63,97,41,8,69,278,不合格
20044308,58,24,97,72,87,338,合格
20044309,61,53,94,10,45,263,不合格
20044310,43,63,84,97,13,300,合格
20044311,20,43,28,87,52,230,不合格
20044312,16,15,35,74,52,192,不合格
20044313,94,86,10,55,89,334,合格
20044314,48,63,23,8,1,143,不合格
20044315,11,25,96,45,56,233,不合格
20044316,97,29,51,80,72,329,合格
20044317,83,64,88,30,28,293,不合格
20044318,15,86,84,75,53,313,合格
20044319,72,45,54,60,80,311,合格
20044320,19,80,57,6,57,219,不合格
20044321,72,52,34,32,38,228,不合格
20044322,97,39,61,35,77,309,合格
20044323,67,53,51,60,94,325,合格
20044324,5,8,60,89,55,217,不合格
20044325,28,23,53,90,18,212,不合格
20044326,42,33,47,24,24,170,不合格
20044327,63,93,65,53,39,313,合格
20044328,87,54,88,91,10,330,合格
20044329,13,8,25,97,24,167,不合格
20044330,40,43,68,30,90,271,不合格
20044331,63,58,15,4,62,202,不合格
20044332,34,87,16,92,27,256,不合格
20044333,72,81,20,72,84,329,合格
20044334,93,53,46,26,2,220,不合格
20044335,48,16,88,38,9,199,不合格
20044336,50,91,80,55,30,306,合格
20044337,95,59,73,75,62,364,合格
20044338,86,92,89,42,20,329,合格
20044339,35,48,69,97,98,347,合格
20044340,25,80,84,41,14,244,不合格
20044341,67,63,49,30,82,291,不合格
20044342,97,78,29,87,78,369,合格
20044343,86,19,97,1,73,276,不合格
20044344,22,36,94,51,30,233,不合格
20044345,17,36,38,46,62,199,不合格
20044346,56,51,98,14,96,315,合格
20044347,41,68,73,89,83,354,合格
20044348,67,38,63,98,45,311,合格
20044349,34,1,71,4,40,150,不合格
20044350,36,88,59,86,77,346,合格
20044351,54,39,47,79,34,253,不合格
20044352,64,4,72,63,71,274,不合格
20044353,50,23,93,41,54,261,不合格
20044354,24,2,3,80,70,179,不合格
20044355,16,11,78,77,0,182,不合格
20044356,31,14,66,45,76,232,不合格
20044357,62,85,26,42,72,287,不合格
20044358,81,2,49,27,15,174,不合格
20044359,6,97,75,20,53,251,不合格
20044360,59,21,17,27,61,185,不合格
20044361,87,78,1,12,15,193,不合格
20044362,13,76,93,33,19,234,不合格
20044363,34,22,56,19,12,143,不合格
20044364,75,36,88,11,55,265,不合格
20044365,58,48,94,6,43,249,不合格
20044366,60,38,77,65,47,287,不合格
20044367,26,44,10,35,69,184,不合格
20044368,67,37,86,33,90,313,合格
20044369,89,80,30,24,32,255,不合格
20044370,50,60,84,96,55,345,合格
20044371,47,15,46,30,74,212,不合格
20044372,82,64,76,48,86,356,合格
20044373,70,38,75,80,6,269,不合格
20044374,17,27,11,90,92,237,不合格
20044375,8,98,25,71,54,256,不合格
20044376,40,77,31,90,81,319,合格
20044377,15,44,67,16,4,146,不合格
20044378,96,32,69,99,54,350,合格
20044379,93,86,43,69,26,317,合格
20044380,86,93,10,21,48,258,不合格
20044381,94,88,33,71,34,320,合格
20044382,61,52,38,0,87,238,不合格
20044383,84,62,60,10,4,220,不合格
20044384,41,94,59,78,52,324,合格
20044385,59,94,26,24,22,225,不合格
20044386,90,7,80,7,78,262,不合格
20044387,99,51,35,25,79,289,不合格
20044388,62,49,41,14,57,223,不合格
20044389,60,65,27,9,58,219,不合格
20044390,82,53,5,67,43,250,不合格
20044391,68,43,55,56,63,285,不合格
20044392,2,3,31,16,68,120,不合格
20044393,3,74,50,76,53,256,不合格
20044394,85,10,46,40,66,247,不合格
20044395,42,10,35,62,39,188,不合格
20044396,24,24,48,31,25,152,不合格
20044397,12,14,35,43,78,182,不合格
20044398,98,8,59,35,12,212,不合格
20044399,15,51,67,28,14,175,不合格
20044400,46,8,90,76,20,240,不合格
20044401,62,41,45,99,50,297,不合格
20044402,48,73,87,9,19,236,不合格
20044403,84,65,27,92,80,348,合格
20044404,94,42,42,53,69,300,合格
20044405,77,66,94,90,26,353,合格
20044406,49,67,3,74,15,208,不合格
20044407,90,78,0,1,83,252,不合格
20044408,73,69,56,18,61,277,不合格
20044409,29,51,20,13,35,148,不合格
20044410,71,14,28,47,16,176,不合格
20044411,48,32,74,1,96,251,不合格
20044412,99,96,50,5,72,322,合格
20044413,58,70,49,21,38,236,不合格
20044414,53,99,23,1,79,255,不合格
20044415,65,40,58,83,60,306,合格
20044416,92,90,43,25,42,292,不合格
20044417,20,58,97,55,6,236,不合格
20044418,52,26,77,37,83,275,不合格
20044419,98,65,38,18,18,237,不合格
20044420,44,85,52,16,23,220,不合格
20044421,8,37,23,18,45,131,不合格
20044422,10,70,37,94,96,307,合格
20044423,18,79,19,22,9,147,不合格
20044424,69,83,51,65,90,358,合格
20044425,85,24,12,21,33,175,不合格
20044426,67,7,51,25,83,233,不合格
20044427,61,63,36,76,67,303,合格
20044428,66,88,10,97,18,279,不合格
20044429,6,24,30,67,98,225,不合格
20044430,10,44,99,5,90,248,不合格
20044431,33,15,96,23,45,212,不合格
20044432,81,32,4,37,82,236,不合格
20044433,56,94,97,75,59,381,合格
20044434,95,57,54,34,34,274,不合格
20044435,49,71,54,90,32,296,不合格
20044436,86,40,73,40,4,243,不合格
20044437,10,84,54,72,54,274,不合格
20044438,36,35,3,0,96,170,不合格
20044439,37,54,39,53,36,219,不合格
20044440,79,20,98,50,84,331,合格
20044441,56,83,43,16,42,240,不合格
20044442,43,28,47,8,42,168,不合格
20044443,99,93,41,31,40,304,合格
20044444,56,6,39,78,97,276,不合格
20044445,89,49,21,93,98,350,合格
20044446,57,72,88,60,57,334,合格
20044447,80,72,31,21,5,209,不合格
20044448,67,37,6,98,40,248,不合格
20044449,8,15,13,5,39,80,不合格
20044450,16,1,19,41,5,82,不合格
20044451,47,6,94,41,67,255,不合格
20044452,72,66,23,70,11,242,不合格
20044453,20,89,16,13,16,154,不合格
20044454,41,82,87,77,62,349,合格
20044455,26,5,45,81,59,216,不合格
20044456,85,33,60,90,86,354,合格
20044457,24,62,25,0,56,167,不合格
20044458,26,83,7,90,71,277,不合格
20044459,81,31,93,49,18,272,不合格
20044460,83,96,35,33,66,313,合格
20044461,2,59,54,61,64,240,不合格
20044462,32,15,58,74,7,186,不合格
20044463,51,62,84,19,7,223,不合格
20044464,14,51,7,80,9,161,不合格
20044465,38,61,89,29,31,248,不合格
20044466,0,59,0,14,89,162,不合格
20044467,58,86,62,90,99,395,合格
20044468,93,86,31,59,63,332,合格
20044469,32,80,23,56,95,286,不合格
20044470,12,97,37,83,85,314,合格
20044471,7,83,30,52,28,200,不合格
20044472,78,71,41,87,24,301,合格
20044473,79,36,7,63,30,215,不合格
20044474,62,86,67,42,11,268,不合格
20044475,12,52,91,64,78,297,不合格
20044476,29,49,39,21,17,155,不合格
20044477,24,44,43,80,99,290,不合格
20044478,51,57,73,84,58,323,合格
20044479,93,87,69,1,48,298,不合格
20044480,78,34,99,36,4,251,不合格
20044481,57,60,69,1,99,286,不合格
20044482,3,86,60,62,98,309,合格
20044483,38,54,43,36,67,238,不合格
20044484,77,53,73,60,83,346,合格
20044485,1,72,48,19,95,235,不合格
20044486,24,88,97,55,15,279,不合格
20044487,78,33,75,54,63,303,合格
20044488,34,42,62,54,41,233,不合格
20044489,34,93,53,76,71,327,合格
20044490,22,94,46,87,18,267,不合格
20044491,88,44,14,3,17,166,不合格
20044492,82,57,26,94,88,347,合格
20044493,25,65,53,45,91,279,不合格
20044494,96,39,18,91,15,259,不合格
20044495,48,70,99,62,46,325,合格
20044496,97,75,95,27,97,391,合格
20044497,45,2,67,19,91,224,不合格
20044498,99,87,74,38,68,366,合格
20044499,62,20,3,61,90,236,不合格
20044500,92,18,57,8,17,192,不合格
20044501,45,94,36,10,86,271,不合格
20044502,9,24,53,88,13,187,不合格
20044503,36,24,73,52,30,215,不合格
20044504,78,99,48,32,35,292,不合格
20044505,3,10,7,88,85,193,不合格
20044506,79,63,26,19,82,269,不合格
20044507,94,63,74,48,21,300,合格
20044508,14,47,7,54,59,181,不合格
20044509,49,3,69,15,1,137,不合格
20044510,69,31,31,97,93,321,合格
20044511,86,40,48,94,97,365,合格
20044512,54,55,15,92,73,289,不合格
20044513,70,34,53,72,78,307,合格
20044514,5,14,11,33,13,76,不合格
20044515,29,76,66,63,95,329,合格
20044516,29,63,62,5,96,255,不合格
20044517,13,53,39,68,41,214,不合格
20044518,51,60,17,10,18,156,不合格
20044519,18,1,97,98,30,244,不合格
20044520,94,25,52,19,58,248,不合格
20044521,42,90,72,7,19,230,不合格
20044522,20,2,21,40,48,131,不合格
20044523,71,92,99,64,32,358,合格
20044524,17,6,96,22,84,225,不合格
20044525,22,52,75,35,57,241,不合格
20044526,1,50,20,84,98,253,不合格
20044527,88,94,13,17,64,276,不合格
20044528,11,81,3,52,70,217,不合格
20044529,12,3,97,84,86,282,不合格
20044530,63,18,17,72,31,201,不合格
20044531,71,93,24,13,92,293,不合格
20044532,94,99,70,72,5,340,合格
20044533,30,74,15,64,35,218,不合格
20044534,32,87,37,98,94,348,合格
20044535,26,84,37,41,56,244,不合格
20044536,93,36,84,43,78,334,合格
20044537,54,36,26,8,42,166,不合格
20044538,99,35,58,32,92,316,合格
20044539,19,81,49,27,97,273,不合格
20044540,44,44,12,15,16,131,不合格
20044541,67,27,35,75,46,250,不合格
20044542,71,81,5,2,80,239,不合格
20044543,65,32,94,10,49,250,不合格
20044544,6,4,70,64,89,233,不合格
20044545,47,10,44,72,93,266,不合格
20044546,2,12,86,53,81,234,不合格
20044547,82,89,63,51,57,342,合格
20044548,16,45,14,58,25,158,不合格
20044549,26,46,60,36,87,255,不合格
20044550,51,75,31,26,91,274,不合格
20044551,60,39,16,26,8,149,不合格
20044552,32,16,31,61,48,188,不合格
20044553,70,8,51,54,22,205,不合格
20044554,64,32,7,11,53,167,不合格
20044555,9,88,6,81,89,273,不合格
20044556,58,72,69,83,67,349,合格
20044557,53,57,19,45,0,174,不合格
20044558,66,28,49,26,15,184,不合格
20044559,99,17,71,31,33,251,不合格
20044560,30,30,96,84,98,338,合格
20044561,47,7,85,66,53,258,不合格
20044562,46,85,58,9,46,244,不合格
20044563,65,63,50,38,83,299,不合格
20044564,92,61,36,18,14,221,不合格
20044565,58,21,84,91,39,293,不合格
20044566,55,60,69,48,44,276,不合格
20044567,60,1,71,27,18,177,不合格
20044568,60,92,62,8,94,316,合格
20044569,50,66,10,8,56,190,不合格
20044570,49,37,19,81,96,282,不合格
20044571,59,57,25,89,78,308,合格
20044572,82,5,62,71,12,232,不合格
20044573,50,4,65,11,28,158,不合格
20044574,11,33,28,45,10,127,不合格
20044575,51,48,62,36,31,228,不合格
20044576,21,69,75,57,89,311,合格
20044577,14,10,80,12,65,181,不合格
20044578,61,19,76,54,9,219,不合格
20044579,87,63,78,70,28,326,合格
20044580,4,30,31,89,84,238,不合格
20044581,25,90,65,57,80,317,合格
20044582,57,33,50,78,39,257,不合格
20044583,61,78,61,58,91,349,合格
20044584,43,74,53,76,50,296,不合格
20044585,30,39,28,21,98,216,不合格
20044586,51,73,18,93,39,274,不合格
20044587,9,63,25,71,21,189,不合格
20044588,53,62,70,34,47,266,不合格
20044589,34,56,84,46,73,293,不合格
20044590,19,78,18,19,41,175,不合格
20044591,85,38,95,92,9,319,合格
20044592,22,33,0,91,10,156,不合格
20044593,75,62,8,65,38,248,不合格
20044594,14,24,31,26,44,139,不合格
20044595,16,82,70,35,47,250,不合格
20044596,9,81,29,84,9,212,不合格
20044597,89,47,45,26,4,211,不合格
20044598,37,71,5,75,39,227,不合格
20044599,48,74,3,78,78,281,不合格
20044600,70,48,40,17,7,182,不合格
20044601,71,13,90,96,54,324,合格
20044602,63,45,41,62,37,248,不合格
20044603,91,33,46,49,2,221,不合格
20044604,22,5,48,81,0,156,不合格
20044605,77,44,88,54,64,327,合格
20044606,64,93,70,75,47,349,合格
20044607,27,33,38,30,53,181,不合格
20044608,89,53,67,85,5,299,不合格
20044609,1,97,72,20,40,230,不合格
20044610,96,84,9,6,11,206,不合格
20044611,43,28,23,18,44,156,不合格
20044612,82,69,69,1,47,268,不合格
20044613,37,33,73,65,93,301,合格
20044614,29,64,59,36,40,228,不合格
20044615,2,59,7,28,52,148,不合格
20044616,14,38,9,96,27,184,不合格
20044617,38,20,57,58,48,221,不合格
20044618,99,69,86,39,44,337,合格
20044619,23,85,53,76,51,288,不合格
20044620,22,92,24,97,72,307,合格
20044621,65,19,56,54,99,293,不合格
20044622,19,34,28,28,39,148,不合格
20044623,12,32,92,84,48,268,不合格
20044624,99,61,17,3,30,210,不合格
20044625,73,30,3,73,69,248,不合格
20044626,6,17,46,23,30,122,不合格
20044627,14,42,19,38,55,168,不合格
20044628,36,4,3,48,49,140,不合格
20044629,95,66,16,12,39,228,不合格
20044630,42,63,35,13,13,166,不合格
20044631,34,27,33,27,54,175,不合格
20044632,37,10,51,97,67,262,不合格
20044633,67,73,98,69,28,335,合格
20044634,75,66,56,37,39,273,不合格
20044635,47,22,57,27,52,205,不合格
20044636,27,8,66,72,25,198,不合格
20044637,95,53,63,30,50,291,不合格
20044638,94,22,97,3,13,229,不合格
20044639,52,36,53,42,50,233,不合格
20044640,99,85,82,55,99,420,合格
20044641,92,11,67,60,84,314,合格
20044642,58,17,33,30,30,168,不合格
20044643,82,97,93,74,36,382,合格
20044644,74,28,79,33,34,248,不合格
20044645,67,9,93,30,97,296,不合格
20044646,84,10,69,15,12,190,不合格
20044647,22,19,47,86,80,254,不合格
20044648,97,83,60,1,94,335,合格
20044649,51,91,89,32,35,298,不合格
20044650,73,7,53,57,75,265,不合格
20044651,32,9,22,95,43,201,不合格
20044652,71,17,66,14,26,194,不合格
20044653,3,37,58,22,38,158,不合格
20044654,27,26,84,42,44,223,不合格
20044655,80,21,50,99,20,270,不合格
20044656,42,15,7,70,82,216,不合格
20044657,88,19,91,28,32,258,不合格
20044658,16,65,58,33,47,219,不合格
20044659,62,31,40,99,69,301,合格
20044660,57,47,91,53,98,346,合格
20044661,34,78,22,16,18,168,不合格
20044662,55,83,96,40,74,348,合格
20044663,96,57,87,90,54,384,合格
20044664,26,16,17,16,23,98,不合格
20044665,81,94,18,57,2,252,不合格
20044666,23,62,50,43,23,201,不合格
20044667,37,62,63,44,42,248,不合格
20044668,49,36,47,43,28,203,不合格
20044669,30,59,69,51,31,240,不合格
20044670,0,61,75,8,79,223,不合格
20044671,40,50,82,39,25,236,不合格
20044672,81,27,88,5,44,245,不合格
20044673,39,6,13,28,93,179,不合格
20044674,31,73,54,51,46,255,不合格
20044675,47,30,68,95,30,270,不合格
20044676,22,93,5,63,96,279,不合格
20044677,46,98,32,3,75,254,不合格
20044678,80,52,45,35,24,236,不合格
20044679,6,15,19,41,22,103,不合格
20044680,38,9,39,64,82,232,不合格
20044681,49,49,76,22,67,263,不合格
20044682,98,18,94,51,74,335,合格
20044683,43,78,95,94,77,387,合格
20044684,0,66,71,42,61,240,不合格
20044685,73,50,44,76,74,317,合格
20044686,22,55,52,8,29,166,不合格
20044687,44,57,72,51,20,244,不合格
20044688,99,7,77,35,50,268,不合格
20044689,93,88,13,40,17,251,不合格
20044690,32,73,77,39,94,315,合格
20044691,92,54,37,45,16,244,不合格
20044692,24,98,49,90,72,333,合格
20044693,99,26,98,62,87,372,合格
20044694,99,22,14,36,51,222,不合格
20044695,31,2,64,84,61,242,不合格
20044696,26,46,5,25,39,141,不合格
20044697,56,56,47,63,23,245,不合格
20044698,21,36,38,16,10,121,不合格
20044699,93,35,16,74,34,252,不合格
20044700,16,16,62,34,69,197,不合格
20044701,53,74,74,21,23,245,不合格
20044702,31,69,24,77,76,277,不合格
20044703,38,74,92,24,17,245,不合格
20044704,48,90,3,25,5,171,不合格
20044705,83,84,9,78,44,298,不合格
20044706,46,36,53,35,17,187,不合格
20044707,65,38,63,29,97,292,不合格
20044708,64,87,22,95,96,364,合格
20044709,11,77,97,97,40,322,合格
20044710,81,62,15,84,71,313,合格
20044711,1,95,3,13,27,139,不合格
20044712,80,7,52,20,39,198,不合格
20044713,76,76,89,50,22,313,合格
20044714,12,87,18,35,42,194,不合格
20044715,86,19,84,6,83,278,不合格
20044716,30,33,74,72,10,219,不合格
20044717,32,90,45,59,8,234,不合格
20044718,24,72,69,67,95,327,合格
20044719,83,92,94,47,55,371,合格
20044720,16,67,83,35,3,204,不合格
20044721,35,42,18,83,52,230,不合格
20044722,50,44,62,91,83,330,合格
20044723,73,22,6,98,62,261,不合格
20044724,4,93,37,16,53,203,不合格
20044725,9,60,12,54,12,147,不合格
20044726,71,64,98,77,38,348,合格
20044727,70,41,46,38,75,270,不合格
20044728,6,10,72,67,8,163,不合格
20044729,34,37,33,38,20,162,不合格
20044730,90,84,95,62,6,337,合格
20044731,24,98,15,45,67,249,不合格
20044732,28,13,70,0,53,164,不合格
20044733,59,4,69,95,31,258,不合格
20044734,51,46,39,98,53,287,不合格
20044735,88,38,5,99,72,302,合格
20044736,60,97,95,10,5,267,不合格
20044737,53,97,66,26,81,323,合格
20044738,7,88,78,81,14,268,不合格
20044739,32,39,23,43,33,170,不合格
20044740,8,18,18,13,38,95,不合格
20044741,25,55,92,98,2,272,不合格
20044742,92,55,60,85,64,356,合格
20044743,23,3,78,24,71,199,不合格
20044744,5,82,76,86,89,338,合格
20044745,76,80,49,56,44,305,合格
20044746,68,10,87,92,10,267,不合格
20044747,24,11,65,8,30,138,不合格
20044748,25,60,42,58,6,191,不合格
20044749,82,37,97,6,59,281,不合格
20044750,72,55,75,86,31,319,合格
20044751,15,70,73,34,33,225,不合格
20044752,36,79,29,6,17,167,不合格
20044753,74,14,16,9,20,133,不合格
20044754,77,58,35,24,58,252,不合格
20044755,33,42,58,2,83,218,不合格
20044756,10,22,86,13,25,156,不合格
20044757,88,64,52,54,42,300,合格
20044758,60,67,10,44,77,258,不合格
20044759,44,63,39,45,38,229,不合格
20044760,30,7,64,5,90,196,不合格
20044761,73,1,44,77,31,226,不合格
20044762,15,75,72,3,0,165,不合格
20044763,6,78,99,38,33,254,不合格
20044764,89,10,24,99,9,231,不合格
20044765,54,19,63,84,35,255,不合格
20044766,90,30,60,44,29,253,不合格
20044767,38,98,89,54,36,315,合格
20044768,1,90,99,3,23,216,不合格
20044769,73,34,2,57,49,215,不合格
20044770,99,6,51,4,85,245,不合格
20044771,68,28,76,56,41,269,不合格
20044772,83,8,45,74,84,294,不合格
20044773,51,57,40,5,84,237,不合格
20044774,16,71,73,10,98,268,不合格
20044775,47,28,36,88,43,242,不合格
20044776,35,87,35,49,94,300,合格
20044777,46,50,58,43,32,229,不合格
20044778,87,53,31,8,42,221,不合格
20044779,48,71,61,89,5,274,不合格
20044780,27,28,43,33,47,178,不合格
20044781,95,74,80,37,74,360,合格
20044782,97,58,2,43,96,296,不合格
20044783,47,57,54,38,62,258,不合格
20044784,68,57,57,42,26,250,不合格
20044785,67,49,46,53,2,217,不合格
20044786,94,31,58,64,30,277,不合格
20044787,4,29,69,7,20,129,不合格
20044788,54,23,37,75,95,284,不合格
20044789,91,44,59,28,44,266,不合格
20044790,56,55,42,64,33,250,不合格
20044791,14,36,55,89,69,263,不合格
20044792,73,6,36,15,78,208,不合格
20044793,85,45,78,62,77,347,合格
20044794,65,88,98,46,2,299,不合格
20044795,69,41,20,99,28,257,不合格
20044796,34,72,64,20,46,236,不合格
20044797,46,10,50,91,25,222,不合格
20044798,45,24,11,11,61,152,不合格
20044799,18,5,94,98,3,218,不合格
20044800,35,48,28,92,31,234,不合格
20044801,66,67,20,91,82,326,合格
20044802,16,25,63,22,59,185,不合格
20044803,75,93,57,69,82,376,合格
20044804,97,87,53,45,66,348,合格
20044805,99,34,47,98,89,367,合格
20044806,90,8,91,16,34,239,不合格
20044807,59,73,75,93,73,373,合格
20044808,24,28,14,9,67,142,不合格
20044809,77,91,48,16,19,251,不合格
20044810,88,95,26,55,51,315,合格
20044811,41,99,76,30,54,300,合格
20044812,85,14,66,42,30,237,不合格
20044813,57,82,62,21,9,231,不合格
20044814,28,13,91,26,90,248,不合格
20044815,18,38,66,52,24,198,不合格
20044816,21,20,51,72,75,239,不合格
20044817,34,89,69,25,38,255,不合格
20044818,86,85,17,81,86,355,合格
20044819,62,73,3,71,98,307,合格
20044820,57,23,36,49,84,249,不合格
20044821,10,19,1,79,70,179,不合格
20044822,47,69,65,0,22,203,不合格
20044823,86,85,77,57,12,317,合格
20044824,60,9,18,55,74,216,不合格
20044825,12,83,53,24,35,207,不合格
20044826,65,76,55,52,56,304,合格
20044827,81,83,33,35,93,325,合格
20044828,89,86,61,61,62,359,合格
20044829,81,79,54,89,29,332,合格
20044830,86,99,74,81,34,374,合格
20044831,26,44,33,64,79,246,不合格
20044832,95,1,81,52,94,323,合格
20044833,19,9,63,90,17,198,不合格
20044834,37,36,17,53,31,174,不合格
20044835,75,17,47,58,72,269,不合格
20044836,39,43,45,97,38,262,不合格
20044837,88,35,38,42,45,248,不合格
20044838,4,97,55,36,25,217,不合格
20044839,26,79,17,31,72,225,不合格
20044840,6,18,22,28,34,108,不合格
20044841,40,34,11,37,36,158,不合格
20044842,54,68,55,1,45,223,不合格
20044843,57,55,95,41,86,334,合格
20044844,56,4,86,22,15,183,不合格
20044845,22,8,30,53,90,203,不合格
20044846,24,35,12,19,48,138,不合格
20044847,23,58,99,33,15,228,不合格
20044848,42,38,73,1,21,175,不合格
20044849,17,64,73,40,9,203,不合格
20044850,7,50,20,11,54,142,不合格
20044851,35,87,56,14,45,237,不合格
20044852,39,3,74,58,76,250,不合格
20044853,45,80,55,3,48,231,不合格
20044854,54,75,20,49,8,206,不合格
20044855,30,98,97,62,9,296,不合格
20044856,74,84,1,8,23,190,不合格
20044857,4,3,4,48,87,146,不合格
20044858,81,91,53,72,58,355,合格
20044859,63,34,41,35,48,221,不合格
20044860,18,68,18,28,50,182,不合格
20044861,58,98,92,27,0,275,不合格
20044862,81,67,2,75,3,228,不合格
20044863,12,97,98,42,47,296,不合格
20044864,33,69,45,90,94,331,合格
20044865,10,44,14,82,13,163,不合格
20044866,97,66,61,49,84,357,合格
20044867,44,70,0,94,12,220,不合格
20044868,69,6,26,81,86,268,不合格
20044869,52,79,25,12,65,233,不合格
20044870,76,96,82,73,43,370,合格
20044871,28,41,11,75,87,242,不合格
20044872,48,26,91,55,9,229,不合格
20044873,67,41,83,69,64,324,合格
20044874,47,27,85,27,45,231,不合格
20044875,71,63,20,59,75,288,不合格
20044876,32,89,59,48,33,261,不合格
20044877,0,76,49,6,1,132,不合格
20044878,33,47,55,14,86,235,不合格
20044879,20,37,57,22,13,149,不合格
20044880,33,61,72,23,89,278,不合格
20044881,24,29,99,40,42,234,不合格
20044882,35,71,24,81,67,278,不合格
20044883,15,67,42,77,50,251,不合格
20044884,61,52,9,17,14,153,不合格
20044885,81,62,91,15,63,312,合格
20044886,6,0,68,32,59,165,不合格
20044887,34,93,77,85,96,385,合格
20044888,33,43,48,50,35,209,不合格
20044889,93,89,29,66,55,332,合格
20044890,17,98,83,88,9,295,不合格
20044891,79,63,19,47,82,290,不合格
20044892,86,94,28,4,4,216,不合格
20044893,43,56,32,67,71,269,不合格
20044894,45,57,19,60,92,273,不合格
20044895,99,61,61,73,94,388,合格
20044896,80,50,17,93,15,255,不合格
20044897,59,27,7,83,42,218,不合格
20044898,9,61,13,13,31,127,不合格
20044899,14,3,31,48,8,104,不合格
20044900,77,82,73,48,89,369,合格
20044901,41,83,5,46,46,221,不合格
20044902,61,35,50,26,77,249,不合格
20044903,3,81,51,69,74,278,不合格
20044904,60,4,87,10,83,244,不合格
20044905,66,74,49,13,62,264,不合格
20044906,72,53,28,63,93,309,合格
20044907,70,81,50,75,53,329,合格
20044908,20,41,59,12,27,159,不合格
20044909,79,67,70,81,60,357,合格
20044910,5,34,26,74,91,230,不合格
20044911,18,36,25,56,24,159,不合格
20044912,21,20,11,31,52,135,不合格
20044913,76,71,15,46,62,270,不合格
20044914,93,18,62,43,53,269,不合格
20044915,88,64,75,20,40,287,不合格
20044916,44,85,34,1,30,194,不合格
20044917,42,25,6,27,57,157,不合格
20044918,31,16,74,76,46,243,不合格
20044919,54,77,89,69,30,319,合格
20044920,42,49,55,98,74,318,合格
20044921,4,37,33,14,56,144,不合格
20044922,25,93,29,14,53,214,不合格
20044923,13,96,67,5,51,232,不合格
20044924,96,46,50,65,38,295,不合格
20044925,4,96,46,71,86,303,合格
20044926,78,51,17,70,43,259,不合格
20044927,64,80,21,45,83,293,不合格
20044928,68,84,95,70,19,336,合格
20044929,26,49,58,39,60,232,不合格
20044930,58,23,41,23,99,244,不合格
20044931,77,72,21,13,3,186,不合格
20044932,49,27,83,96,83,338,合格
20044933,93,11,2,70,2,178,不合格
20044934,44,99,88,12,95,338,合格
20044935,17,83,28,81,76,285,不合格
20044936,42,84,69,19,75,289,不合格
20044937,17,15,24,25,84,165,不合格
20044938,55,70,26,33,99,283,不合格
20044939,98,53,16,70,78,315,合格
20044940,42,13,46,67,80,248,不合格
20044941,7,64,93,31,98,293,不合格
20044942,45,54,94,42,98,333,合格
20044943,89,96,41,84,37,347,合格
20044944,34,88,54,48,57,281,不合格
20044945,61,64,83,51,24,283,不合格
20044946,25,62,71,79,3,240,不合格
20044947,8,36,10,17,28,99,不合格
20044948,50,24,43,2,70,189,不合格
20044949,96,73,20,90,84,363,合格
20044950,53,80,3,93,85,314,合格
20044951,14,70,59,44,37,224,不合格
20044952,56,36,85,55,88,320,合格
20044953,71,5,39,10,29,154,不合格
20044954,21,78,15,43,91,248,不合格
20044955,59,57,21,85,29,251,不合格
20044956,18,31,96,29,98,272,不合格
20044957,31,75,79,60,88,333,合格
20044958,42,42,11,24,48,167,不合格
20044959,1,81,79,65,96,322,合格
20044960,77,82,64,56,9,288,不合格
20044961,18,8,12,77,94,209,不合格
20044962,92,62,83,80,44,361,合格
20044963,80,2,65,62,99,308,合格
20044964,61,74,44,58,31,268,不合格
20044965,29,62,22,26,60,199,不合格
20044966,47,27,94,40,22,230,不合格
20044967,19,66,58,16,5,164,不合格
20044968,50,43,49,91,50,283,不合格
20044969,99,69,81,13,11,273,不合格
20044970,6,14,7,29,50,106,不合格
20044971,98,84,28,81,32,323,合格
20044972,19,21,14,30,82,166,不合格
20044973,47,98,73,98,78,394,合格
20044974,85,44,33,19,52,233,不合格
20044975,65,71,54,15,45,250,不合格
20044976,45,5,11,20,97,178,不合格
20044977,53,26,98,6,3,186,不合格
20044978,7,76,62,37,47,229,不合格
20044979,71,53,54,95,82,355,合格
20044980,49,85,65,45,18,262,不合格
20044981,77,52,30,87,28,274,不合格
20044982,11,22,96,94,97,320,合格
20044983,75,70,20,0,5,170,不合格
20044984,87,44,5,33,53,222,不合格
20044985,86,83,2,17,96,284,不合格
20044986,90,14,98,10,38,250,不合格
20044987,67,86,13,3,18,187,不合格
20044988,32,57,58,7,94,248,不合格
20044989,46,50,89,60,97,342,合格
20044990,64,27,81,3,63,238,不合格
20044991,57,64,9,56,37,223,不合格
20044992,4,66,57,33,20,180,不合格
20044993,32,66,33,0,66,197,不合格
20044994,45,79,34,24,42,224,不合格
20044995,86,24,10,76,64,260,不合格
20044996,21,84,74,99,77,355,合格
20044997,88,91,32,90,47,348,合格
20044998,97,94,26,19,42,278,不合格
20044999,12,43,42,43,37,177,不合格
20045000,47,96,24,22,76,265,不合格
20045001,37,69,94,8,24,232,不合格
20045002,82,35,33,42,28,220,不合格
20045003,86,88,88,28,16,306,合格
20045004,88,91,32,0,46,257,不合格
20045005,37,49,93,20,87,286,不合格
20045006,22,14,98,55,84,273,不合格
20045007,93,73,10,18,2,196,不合格
20045008,87,27,54,78,24,270,不合格
20045009,72,20,22,75,43,232,不合格
20045010,88,67,37,75,25,292,不合格
20045011,59,48,51,64,4,226,不合格
20045012,68,89,39,29,40,265,不合格
20045013,42,63,69,79,17,270,不合格
20045014,23,1,69,63,54,210,不合格
20045015,55,81,26,31,48,241,不合格
20045016,60,65,94,5,83,307,合格
20045017,5,0,75,55,45,180,不合格
20045018,13,23,39,78,67,220,不合格
20045019,97,42,96,84,22,341,合格
20045020,91,5,70,24,0,190,不合格
20045021,2,13,72,7,94,188,不合格
20045022,53,30,87,74,86,330,合格
20045023,53,81,11,9,70,224,不合格
20045024,91,15,44,81,16,247,不合格
20045025,73,51,69,9,0,202,不合格
20045026,70,59,83,67,71,350,合格
20045027,43,66,45,38,71,263,不合格
20045028,7,46,4,16,71,144,不合格
20045029,82,91,78,0,39,290,不合格
20045030,64,87,94,82,33,360,合格
20045031,53,29,51,85,74,292,不合格
20045032,76,81,43,90,10,300,合格
20045033,11,26,5,6,37,85,不合格
20045034,15,24,36,57,88,220,不合格
20045035,87,71,82,45,56,341,合格
20045036,94,34,47,19,78,272,不合格
20045037,11,2,95,88,15,211,不合格
20045038,9,3,76,42,20,150,不合格
20045039,56,76,31,2,92,257,不合格
20045040,2,29,15,4,8,58,不合格
20045041,61,16,93,70,40,280,不合格
20045042,41,57,39,91,64,292,不合格
20045043,36,78,65,60,16,255,不合格
20045044,48,3,63,14,55,183,不合格
20045045,35,8,54,51,71,219,不合格
20045046,12,89,58,89,6,254,不合格
20045047,63,5,94,85,78,325,合格
20045048,52,74,97,28,42,293,不合格
20045049,56,98,99,53,31,337,合格
20045050,42,8,87,55,85,277,不合格
20045051,62,99,23,38,45,267,不合格
20045052,78,91,67,48,77,361,合格
20045053,74,31,35,57,20,217,不合格
20045054,40,99,81,50,26,296,不合格
20045055,75,6,64,29,14,188,不合格
20045056,18,94,21,57,53,243,不合格
20045057,23,73,1,41,88,226,不合格
20045058,86,34,1,68,96,285,不合格
20045059,60,46,65,88,13,272,不合格
20045060,37,56,7,27,13,140,不合格
20045061,56,22,85,34,84,281,不合格
20045062,94,15,22,9,57,197,不合格
20045063,94,20,51,2,39,206,不合格
20045064,68,10,39,2,7,126,不合格
20045065,85,71,40,40,83,319,合格
20045066,3,62,36,91,52,244,不合格
20045067,23,8,89,45,54,219,不合格
20045068,72,39,33,1,80,225,不合格
20045069,43,66,18,77,64,268,不合格
20045070,0,53,56,38,95,242,不合格
20045071,31,11,35,44,53,174,不合格
20045072,83,92,2,43,58,278,不合格
20045073,47,55,18,81,91,292,不合格
20045074,66,32,36,74,8,216,不合格
20045075,38,71,27,17,10,163,不合格
20045076,20,18,46,86,33,203,不合格
20045077,73,50,80,99,73,375,合格
20045078,34,44,65,15,16,174,不合格
20045079,10,56,15,51,86,218,不合格
20045080,27,54,39,83,71,274,不合格
20045081,45,25,71,13,46,200,不合格
20045082,59,77,56,93,0,285,不合格
20045083,73,46,4,5,76,204,不合格
20045084,15,76,38,83,66,278,不合格
20045085,10,20,54,96,64,244,不合格
20045086,91,93,13,75,2,274,不合格
20045087,46,64,4,17,40,171,不合格
20045088,96,0,3,52,40,191,不合格
20045089,25,63,82,37,40,247,不合格
20045090,66,49,34,9,38,196,不合格
20045091,27,75,23,31,40,196,不合格
20045092,44,22,43,75,58,242,不合格
20045093,90,70,68,71,33,332,合格
20045094,75,25,39,83,27,249,不合格
20045095,78,84,22,35,62,281,不合格
20045096,13,82,87,3,67,252,不合格
20045097,64,18,37,96,79,294,不合格
20045098,87,33,94,65,12,291,不合格
20045099,12,37,12,23,80,164,不合格
20045100,57,93,57,48,83,338,合格
20045101,50,74,32,90,0,246,不合格
20045102,3,11,59,64,77,214,不合格
20045103,84,73,39,16,6,218,不合格
20045104,27,75,87,38,83,310,合格
20045105,71,81,85,69,65,371,合格
20045106,24,48,69,94,73,308,合格
20045107,70,44,99,47,96,356,合格
20045108,78,22,4,2,4,110,不合格
20045109,94,74,33,76,87,364,合格
20045110,27,84,71,17,4,203,不合格
20045111,59,34,27,74,35,229,不合格
20045112,30,58,60,92,20,260,不合格
20045113,62,96,0,75,34,267,不合格
20045114,33,89,35,65,36,258,不合格
20045115,25,70,3,89,62,249,不合格
20045116,80,45,16,76,8,225,不合格
20045117,48,38,7,76,9,178,不合格
20045118,8,18,48,99,2,175,不合格
20045119,4,98,9,11,35,157,不合格
20045120,77,72,53,74,38,314,合格
20045121,77,54,78,93,80,382,合格
20045122,69,92,0,28,98,287,不合格
20045123,11,82,23,96,15,227,不合格
20045124,74,11,57,0,76,218,不合格
20045125,94,80,38,13,67,292,不合格
20045126,14,56,68,82,39,259,不合格
20045127,13,51,79,27,72,242,不合格
20045128,8,82,72,93,61,316,合格
20045129,22,57,75,66,92,312,合格
20045130,43,18,83,49,15,208,不合格
20045131,6,9,97,58,63,233,不合格
20045132,62,27,8,29,5,131,不合格
20045133,42,91,92,73,41,339,合格
20045134,52,76,64,26,36,254,不合格
20045135,72,4,12,8,8,104,不合格
20045136,74,79,61,76,20,310,合格
20045137,7,62,96,93,4,262,不合格
20045138,3,27,0,3,17,50,不合格
20045139,66,31,20,10,78,205,不合格
20045140,55,70,25,33,19,202,不合格
20045141,17,19,38,44,79,197,不合格
20045142,32,12,95,86,48,273,不合格
20045143,55,53,13,66,83,270,不合格
20045144,51,58,74,85,23,291,不合格
20045145,32,59,14,68,9,182,不合格
20045146,29,88,73,99,89,378,合格
20045147,28,84,38,6,43,199,不合格
20045148,6,25,58,54,36,179,不合格
20045149,53,92,69,35,79,328,合格
20045150,94,66,69,81,47,357,合格
20045151,7,35,3,52,19,116,不合格
20045152,35,62,7,46,78,228,不合格
20045153,42,19,82,47,11,201,不合格
20045154,6,86,50,82,16,240,不合格
20045155,93,69,52,78,15,307,合格
20045156,14,65,97,30,60,266,不合格
20045157,70,76,82,11,25,264,不合格
20045158,5,17,19,47,55,143,不合格
20045159,17,43,80,83,21,244,不合格
20045160,15,28,26,11,14,94,不合格
20045161,28,66,75,16,96,281,不合格
20045162,58,22,60,41,82,263,不合格
20045163,16,90,26,30,30,192,不合格
20045164,49,88,1,32,1,171,不合格
20045165,84,54,60,4,64,266,不合格
20045166,4,11,13,3,22,53,不合格
20045167,26,35,74,65,85,285,不合格
20045168,82,47,73,64,31,297,不合格
20045169,87,56,0,98,29,270,不合格
20045170,81,32,97,33,84,327,合格
20045171,28,57,51,34,63,233,不合格
20045172,79,63,15,17,40,214,不合格
20045173,96,34,32,75,98,335,合格
20045174,62,73,38,52,14,239,不合格
20045175,71,36,7,55,96,265,不合格
20045176,2,51,7,10,88,158,不合格
20045177,71,32,88,89,88,368,合格
20045178,37,38,5,96,84,260,不合格
20045179,22,57,38,4,68,189,不合格
20045180,93,25,74,36,43,271,不合格
20045181,12,0,86,41,34,173,不合格
20045182,63,41,91,9,95,299,不合格
20045183,90,96,64,14,67,331,合格
20045184,16,77,13,62,5,173,不合格
20045185,89,79,6,17,75,266,不合格
20045186,3,19,7,67,60,156,不合格
20045187,97,99,97,13,50,356,合格
20045188,48,84,52,69,64,317,合格
20045189,38,99,48,23,35,243,不合格
20045190,56,84,98,34,85,357,合格
20045191,52,40,95,95,69,351,合格
20045192,84,71,98,86,89,428,合格
20045193,34,36,19,57,88,234,不合格
20045194,64,13,30,75,98,280,不合格
20045195,7,31,9,95,23,165,不合格
20045196,7,78,9,30,31,155,不合格
20045197,80,80,13,82,67,322,合格
20045198,77,3,84,21,6,191,不合格
20045199,53,33,26,32,11,155,不合格
20045200,10,5,26,92,91,224,不合格
20045201,75,35,94,96,21,321,合格
20045202,17,27,88,84,55,271,不合格
20045203,60,89,41,76,74,340,合格
20045204,53,83,23,84,88,331,合格
20045205,86,62,30,58,7,243,不合格
20045206,9,14,26,88,80,217,不合格
20045207,25,60,41,81,36,243,不合格
20045208,41,31,21,40,61,194,不合格
20045209,29,38,97,92,87,343,合格
20045210,42,81,95,11,1,230,不合格
20045211,62,37,60,78,3,240,不合格
20045212,23,80,89,64,0,256,不合格
20045213,73,41,76,1,81,272,不合格
20045214,5,34,95,78,65,277,不合格
20045215,66,76,39,24,40,245,不合格
20045216,41,78,13,43,32,207,不合格
20045217,41,5,22,78,7,153,不合格
20045218,59,52,76,5,89,281,不合格
20045219,76,35,65,73,56,305,合格
20045220,49,18,93,72,82,314,合格
20045221,56,7,48,37,27,175,不合格
20045222,21,43,92,14,63,233,不合格
20045223,21,7,39,0,31,98,不合格
20045224,55,59,75,48,60,297,不合格
20045225,38,97,46,29,46,256,不合格
20045226,31,50,44,75,83,283,不合格
20045227,23,64,79,93,63,322,合格
20045228,20,96,43,84,55,298,不合格
20045229,73,53,49,9,64,248,不合格
20045230,40,52,7,82,35,216,不合格
20045231,32,39,71,26,34,202,不合格
20045232,32,84,46,53,85,300,合格
20045233,70,76,65,61,65,337,合格
20045234,42,25,42,32,68,209,不合格
20045235,61,35,3,30,41,170,不合格
20045236,74,39,38,45,5,201,不合格
20045237,26,21,62,1,75,185,不合格
20045238,2,12,92,13,36,155,不合格
20045239,2,80,17,35,1,135,不合格
20045240,1,37,24,29,72,163,不合格
20045241,81,22,42,15,64,224,不合格
20045242,14,29,21,59,38,161,不合格
20045243,44,66,17,4,25,156,不合格
20045244,64,7,94,87,64,316,合格
20045245,31,66,19,3,50,169,不合格
20045246,28,18,7,63,88,204,不合格
20045247,53,3,8,44,66,174,不合格
20045248,47,72,39,59,15,232,不合格
20045249,20,96,72,23,81,292,不合格
20045250,73,43,85,58,54,313,合格
20045251,31,13,57,83,53,237,不合格
20045252,1,39,90,50,31,211,不合格
20045253,81,20,62,9,4,176,不合格
20045254,61,11,89,43,71,275,不合格
20045255,32,43,87,83,27,272,不合格
20045256,94,3,60,78,22,257,不合格
20045257,43,32,66,91,65,297,不合格
20045258,14,25,57,51,98,245,不合格
20045259,48,88,35,18,85,274,不合格
20045260,87,94,35,99,66,381,合格
20045261,99,82,58,6,24,269,不合格
20045262,16,40,24,56,0,136,不合格
20045263,83,5,40,95,26,249,不合格
20045264,59,74,35,83,72,323,合格
20045265,24,9,90,81,30,234,不合格
20045266,51,89,10,1,96,247,不合格
20045267,95,11,43,92,16,257,不合格
20045268,73,67,98,52,29,319,合格
20045269,45,27,90,2,59,223,不合格
20045270,48,66,44,31,81,270,不合格
20045271,20,52,58,75,21,226,不合格
20045272,78,87,22,68,97,352,合格
20045273,63,21,92,20,49,245,不合格
20045274,4,14,75,14,87,194,不合格
20045275,6,69,13,78,20,186,不合格
20045276,25,7,83,80,48,243,不合格
20045277,7,71,9,73,96,256,不合格
20045278,16,3,65,72,45,201,不合格
20045279,0,81,79,54,73,287,不合格
20045280,12,5,91,76,47,231,不合格
20045281,47,77,23,3,95,245,不合格
20045282,52,41,38,27,58,216,不合格
20045283,95,72,53,30,8,258,不合格
20045284,17,87,24,45,83,256,不合格
20045285,45,83,94,68,25,315,合格
20045286,66,87,76,94,87,410,合格
20045287,47,83,82,89,3,304,合格
20045288,91,20,53,62,33,259,不合格
20045289,31,38,42,92,59,262,不合格
20045290,28,87,26,62,78,281,不合格
20045291,35,80,63,35,22,235,不合格
20045292,69,52,94,74,86,375,合格
20045293,44,56,52,12,85,249,不合格
20045294,96,99,56,19,9,279,不合格
20045295,35,17,7,10,81,150,不合格
20045296,44,48,97,14,20,223,不合格
20045297,8,81,34,69,69,261,不合格
20045298,22,0,92,4,16,134,不合格
20045299,83,29,50,90,2,254,不合格
20045300,86,27,52,0,60,225,不合格
20045301,0,28,87,23,3,141,不合格
20045302,19,87,52,5,38,201,不合格
20045303,17,36,79,43,55,230,不合格
20045304,70,42,66,74,86,338,合格
20045305,24,64,11,62,63,224,不合格
20045306,63,30,30,97,18,238,不合格
20045307,98,28,35,84,21,266,不合格
20045308,7,93,89,89,96,374,合格
20045309,28,73,39,38,25,203,不合格
20045310,81,79,83,99,13,355,合格
20045311,90,30,6,90,98,314,合格
20045312,62,3,93,79,15,252,不合格
20045313,64,29,4,55,74,226,不合格
20045314,11,95,22,88,47,263,不合格
20045315,47,47,73,39,90,296,不合格
20045316,99,77,88,81,91,436,合格
20045317,70,46,80,41,92,329,合格
20045318,98,9,12,79,46,244,不合格
20045319,35,51,93,67,54,300,合格
20045320,12,24,39,8,4,87,不合格
20045321,17,47,71,35,92,262,不合格
20045322,48,88,37,54,91,318,合格
20045323,66,15,79,83,87,330,合格
20045324,42,77,2,36,78,235,不合格
20045325,29,42,14,66,5,156,不合格
20045326,48,64,2,5,22,141,不合格
20045327,74,81,82,56,20,313,合格
20045328,94,25,30,70,21,240,不合格
20045329,76,42,0,78,18,214,不合格
20045330,31,22,1,51,25,130,不合格
20045331,1,87,78,2,22,190,不合格
20045332,89,61,24,5,11,190,不合格
20045333,63,41,44,51,21,220,不合格
20045334,15,55,33,53,79,235,不合格
20045335,53,13,17,6,7,96,不合格
20045336,14,42,97,32,27,212,不合格
20045337,3,53,22,22,20,120,不合格
20045338,78,89,30,32,38,267,不合格
20045339,71,56,93,12,54,286,不合格
20045340,2,34,57,3,67,163,不合格
20045341,68,72,18,11,93,262,不合格
20045342,0,3,49,34,56,142,不合格
20045343,44,3,40,19,51,157,不合格
20045344,97,90,57,77,59,380,合格
20045345,24,69,54,66,19,232,不合格
20045346,62,88,3,81,91,325,合格
20045347,49,7,48,39,93,236,不合格
20045348,66,79,36,82,70,333,合格
20045349,46,87,94,64,24,315,合格
20045350,81,49,91,19,84,324,合格
20045351,77,73,0,7,19,176,不合格
20045352,89,95,89,20,0,293,不合格
20045353,48,43,26,49,9,175,不合格
20045354,94,43,65,48,42,292,不合格
20045355,42,40,10,89,80,261,不合格
20045356,28,13,61,32,29,163,不合格
20045357,14,11,84,80,8,197,不合格
20045358,88,30,62,5,74,259,不合格
20045359,70,75,51,7,93,296,不合格
20045360,31,42,7,28,69,177,不合格
20045361,47,82,63,27,13,232,不合格
20045362,23,85,28,84,1,221,不合格
20045363,6,3,73,85,13,180,不合格
20045364,48,61,75,46,71,301,合格
20045365,99,2,40,13,39,193,不合格
20045366,29,98,77,83,23,310,合格
20045367,99,92,28,3,37,259,不合格
20045368,16,60,42,97,38,253,不合格
20045369,0,36,40,48,3,127,不合格
20045370,30,77,99,75,31,312,合格
20045371,2,38,11,3,49,103,不合格
20045372,32,44,37,42,81,236,不合格
20045373,56,20,8,98,56,238,不合格
20045374,27,61,95,19,23,225,不合格
20045375,29,32,48,3,77,189,不合格
20045376,90,48,49,13,69,269,不合格
20045377,87,61,65,69,86,368,合格
20045378,39,34,67,3,38,181,不合格
20045379,45,1,41,4,68,159,不合格
20045380,71,76,45,46,38,276,不合格
20045381,66,85,9,85,83,328,合格
20045382,83,20,36,19,13,171,不合格
20045383,67,45,3,18,56,189,不合格
20045384,38,4,30,92,6,170,不合格
20045385,77,3,75,23,17,195,不合格
20045386,64,81,71,88,44,348,合格
20045387,49,9,69,56,94,277,不合格
20045388,15,44,96,30,94,279,不合格
20045389,13,16,44,77,12,162,不合格
20045390,66,77,10,31,49,233,不合格
20045391,76,60,57,78,99,370,合格
20045392,87,54,52,66,77,336,合格
20045393,8,82,10,85,44,229,不合格
20045394,24,34,55,26,10,149,不合格
20045395,4,11,15,79,98,207,不合格
20045396,86,10,9,7,9,121,不合格
20045397,50,59,7,56,52,224,不合格
20045398,57,64,21,0,41,183,不合格
20045399,87,90,60,87,23,347,合格
20045400,25,85,38,91,61,300,合格
20045401,44,60,88,91,10,293,不合格
20045402,61,58,6,32,1,158,不合格
20045403,40,67,97,17,20,241,不合格
20045404,66,44,56,82,93,341,合格
20045405,31,69,61,0,74,235,不合格
20045406,3,1,43,63,61,171,不合格
20045407,52,76,99,7,16,250,不合格
20045408,92,35,87,53,51,318,合格
20045409,74,90,80,40,88,372,合格
20045410,58,18,84,27,87,274,不合格
20045411,81,68,20,16,40,225,不合格
20045412,97,45,88,1,3,234,不合格
20045413,35,83,18,92,58,286,不合格
20045414,24,89,77,54,7,251,不合格
20045415,10,29,14,90,68,211,不合格
20045416,24,29,81,29,11,174,不合格
20045417,35,32,32,55,77,231,不合格
20045418,35,79,13,21,65,213,不合格
20045419,5,16,51,47,92,211,不合格
20045420,28,58,93,7,23,209,不合格
20045421,73,87,25,50,91,326,合格
20045422,96,68,60,73,41,338,合格
20045423,25,47,50,40,6,168,不合格
20045424,56,18,12,45,98,229,不合格
20045425,13,49,75,96,19,252,不合格
20045426,96,43,73,68,10,290,不合格
20045427,66,9,65,83,11,234,不合格
20045428,99,38,55,78,30,300,合格
20045429,27,83,86,15,6,217,不合格
20045430,89,25,10,4,72,200,不合格
20045431,35,71,99,55,19,279,不合格
20045432,88,30,12,81,39,250,不合格
20045433,80,80,88,56,97,401,合格
20045434,9,93,93,69,47,311,合格
20045435,18,67,53,2,17,157,不合格
20045436,19,13,95,24,59,210,不合格
20045437,62,97,87,14,1,261,不合格
20045438,87,82,1,74,18,262,不合格
20045439,57,65,13,8,67,210,不合格
20045440,96,69,34,41,54,294,不合格
20045441,85,80,1,82,33,281,不合格
20045442,94,18,26,81,9,228,不合格
20045443,93,17,68,31,17,226,不合格
20045444,87,69,92,45,42,335,合格
20045445,73,74,33,83,12,275,不合格
20045446,22,27,77,22,82,230,不合格
20045447,34,64,98,21,27,244,不合格
20045448,34,22,76,68,26,226,不合格
20045449,97,87,52,82,13,331,合格
20045450,57,5,57,24,17,160,不合格
20045451,37,70,59,35,46,247,不合格
20045452,26,47,63,38,91,265,不合格
20045453,69,49,12,5,46,181,不合格
20045454,5,0,9,36,23,73,不合格
20045455,51,57,34,8,54,204,不合格
20045456,49,29,50,38,13,179,不合格
20045457,51,0,63,7,20,141,不合格
20045458,2,55,27,60,64,208,不合格
20045459,79,63,40,62,18,262,不合格
20045460,89,10,86,58,26,269,不合格
20045461,96,28,20,79,74,297,不合格
20045462,37,86,68,1,5,197,不合格
20045463,76,20,61,70,54,281,不合格
20045464,34,22,29,42,82,209,不合格
20045465,48,8,96,45,72,269,不合格
20045466,47,8,93,51,9,208,不合格
20045467,40,42,75,45,36,238,不合格
20045468,55,24,75,49,69,272,不合格
20045469,77,84,65,15,72,313,合格
20045470,82,85,62,2,2,233,不合格
20045471,27,52,81,62,48,270,不合格
20045472,81,91,23,65,77,337,合格
20045473,96,3,14,75,37,225,不合格
20045474,23,50,51,79,88,291,不合格
20045475,52,9,50,45,61,217,不合格
20045476,85,55,39,50,46,275,不合格
20045477,74,96,26,9,40,245,不合格
20045478,7,48,55,18,65,193,不合格
20045479,50,97,73,65,66,351,合格
20045480,42,75,97,97,20,331,合格
20045481,98,35,62,33,36,264,不合格
20045482,82,15,46,92,68,303,合格
20045483,88,99,92,85,14,378,合格
20045484,10,87,65,45,50,257,不合格
20045485,81,68,44,96,88,377,合格
20045486,53,87,12,51,4,207,不合格
20045487,85,35,0,81,57,258,不合格
20045488,67,24,19,18,6,134,不合格
20045489,2,69,41,18,78,208,不合格
20045490,98,2,95,51,5,251,不合格
20045491,72,86,79,61,65,363,合格
20045492,68,78,82,1,72,301,合格
20045493,13,32,3,72,19,139,不合格
20045494,57,37,49,43,10,196,不合格
20045495,55,35,85,81,49,305,合格
20045496,74,5,67,77,14,237,不合格
20045497,18,4,50,34,6,112,不合格
20045498,64,13,57,99,63,296,不合格
20045499,54,30,30,50,8,172,不合格
20045500,10,48,35,4,25,122,不合格
