ID,国語,数学,英語,理科,社会,合計,判定
20050001,41,4,22,34,8,109,不合格
20050002,82,29,29,30,75,245,不合格
20050003,1,21,0,7,43,72,不合格
20050004,17,63,84,70,1,235,不合格
20050005,86,70,87,59,81,383,合格
20050006,84,5,84,30,48,251,不合格
20050007,79,61,85,77,23,325,合格
20050008,84,94,23,74,65,340,合格
20050009,96,99,38,49,9,291,不合格
20050010,62,51,42,41,30,226,不合格
20050011,5,98,21,25,11,160,不合格
20050012,7,37,36,47,29,156,不合格
20050013,25,95,24,54,94,292,不合格
20050014,35,49,22,51,9,166,不合格
20050015,75,13,74,65,13,240,不合格
20050016,49,79,1,21,27,177,不合格
20050017,13,28,58,42,17,158,不合格
20050018,98,47,89,9,64,307,合格
20050019,14,66,53,99,92,324,合格
20050020,84,50,17,37,55,243,不合格
20050021,62,97,90,65,22,336,合格
20050022,44,89,19,9,14,175,不合格
20050023,84,87,70,32,36,309,合格
20050024,33,29,28,98,14,202,不合格
20050025,65,70,45,3,98,281,不合格
20050026,29,51,51,63,33,227,不合格
20050027,85,78,89,97,32,381,合格
20050028,54,97,50,39,46,286,不合格
20050029,36,44,22,32,32,166,不合格
20050030,56,92,35,75,79,337,合格
20050031,74,14,96,23,1,208,不合格
20050032,76,80,20,40,89,305,合格
20050033,48,36,4,52,19,159,不合格
20050034,59,3,48,1,35,146,不合格
20050035,92,78,74,94,44,382,合格
20050036,93,0,92,8,26,219,不合格
20050037,6,63,36,89,33,227,不合格
20050038,39,91,20,6,54,210,不合格
20050039,78,74,44,42,22,260,不合格
20050040,50,63,7,15,98,233,不合格
20050041,70,69,93,58,55,345,合格
20050042,56,39,36,19,8,158,不合格
20050043,59,83,53,36,1,232,不合格
20050044,73,99,21,2,12,207,不合格
20050045,62,82,79,27,22,272,不合格
20050046,36,77,22,91,83,309,合格
20050047,7,10,39,72,57,185,不合格
20050048,70,37,66,30,43,246,不合格
20050049,69,7,49,69,32,226,不合格
20050050,76,37,33,76,8,230,不合格
20050051,68,16,10,72,80,246,不合格
20050052,61,32,99,92,76,360,合格
20050053,7,65,83,26,71,252,不合格
20050054,11,56,3,60,65,195,不合格
20050055,23,38,38,72,67,238,不合格
20050056,45,72,72,68,59,316,合格
20050057,64,43,88,96,62,353,合格
20050058,53,92,97,25,90,357,合格
20050059,79,81,88,44,34,326,合格
20050060,16,49,76,95,81,317,合格
20050061,5,53,50,16,94,218,不合格
20050062,68,26,72,27,4,197,不合格
20050063,84,31,2,28,14,159,不合格
20050064,7,92,80,69,17,265,不合格
20050065,59,38,53,86,75,311,合格
20050066,43,20,15,34,38,150,不合格
20050067,7,4,90,10,20,131,不合格
20050068,61,49,47,97,79,333,合格
20050069,72,52,3,13,48,188,不合格
20050070,21,72,81,14,7,195,不合格
20050071,96,39,84,10,47,276,不合格
20050072,13,51,76,59,87,286,不合格
20050073,46,19,3,89,28,185,不合格
20050074,76,23,73,28,43,243,不合格
20050075,75,12,36,93,94,310,合格
20050076,94,96,92,7,49,338,合格
20050077,29,60,67,13,91,260,不合格
20050078,14,22,49,32,60,177,不合格
20050079,55,43,21,80,46,245,不合格
20050080,40,76,90,71,61,338,合格
20050081,36,62,44,23,14,179,不合格
20050082,95,93,11,80,47,326,合格
20050083,23,47,71,10,55,206,不合格
20050084,42,57,7,50,19,175,不合格
20050085,50,37,91,46,2,226,不合格
20050086,43,83,58,96,93,373,合格
20050087,0,2,62,16,7,87,不合格
20050088,17,59,18,93,75,262,不合格
20050089,24,61,13,98,20,216,不合格
20050090,23,79,23,88,72,285,不合格
20050091,56,26,67,95,17,261,不合格
20050092,65,17,95,89,63,329,合格
20050093,37,34,52,19,11,153,不合格
20050094,34,76,16,4,97,227,不合格
20050095,89,5,84,79,39,296,不合格
20050096,77,99,13,15,62,266,不合格
20050097,61,28,82,73,69,313,合格
20050098,59,13,61,87,94,314,合格
20050099,49,99,11,58,79,296,不合格
20050100,32,40,51,7,37,167,不合格
20050101,56,35,14,46,70,221,不合格
20050102,28,55,70,96,68,317,合格
20050103,9,87,88,16,57,257,不合格
20050104,28,80,83,98,76,365,合格
20050105,73,86,64,12,94,329,合格
20050106,38,64,49,54,10,215,不合格
20050107,87,47,18,8,73,233,不合格
20050108,59,53,52,53,88,305,合格
20050109,11,21,43,66,43,184,不合格
20050110,71,70,47,54,62,304,合格
20050111,22,74,17,5,72,190,不合格
20050112,7,25,13,13,26,84,不合格
20050113,3,65,39,28,64,199,不合格
20050114,50,24,24,46,69,213,不合格
20050115,82,6,13,91,68,260,不合格
20050116,52,93,18,2,84,249,不合格
20050117,64,82,93,89,32,360,合格
20050118,49,76,22,77,18,242,不合格
20050119,18,88,92,93,21,312,合格
20050120,61,89,5,40,36,231,不合格
20050121,17,55,82,86,82,322,合格
20050122,87,13,47,34,50,231,不合格
20050123,13,64,66,54,18,215,不合格
20050124,47,80,52,68,66,313,合格
20050125,39,38,66,36,11,190,不合格
20050126,91,11,62,69,22,255,不合格
20050127,33,56,42,87,10,228,不合格
20050128,80,44,89,20,15,248,不合格
20050129,43,12,96,1,22,174,不合格
20050130,92,14,76,64,51,297,不合格
20050131,2,74,79,20,34,209,不合格
20050132,37,5,1,10,9,62,不合格
20050133,49,33,75,28,49,234,不合格
20050134,69,61,7,42,71,250,不合格
20050135,54,5,22,94,87,262,不合格
20050136,23,99,72,2,54,250,不合格
20050137,45,73,16,5,24,163,不合格
20050138,59,36,15,15,21,146,不合格
20050139,11,37,35,94,48,225,不合格
20050140,9,32,37,57,40,175,不合格
20050141,88,17,33,67,34,239,不合格
20050142,6,50,16,36,58,166,不合格
20050143,14,24,59,2,79,178,不合格
20050144,78,29,57,91,35,290,不合格
20050145,27,28,77,38,61,231,不合格
20050146,94,66,60,37,31,288,不合格
20050147,83,65,87,72,57,364,合格
20050148,79,5,98,73,77,332,合格
20050149,97,81,72,66,24,340,合格
20050150,43,59,34,18,92,246,不合格
20050151,74,99,96,23,93,385,合格
20050152,13,42,10,7,19,91,不合格
20050153,5,49,89,47,70,260,不合格
20050154,86,6,55,62,7,216,不合格
20050155,23,5,4,77,28,137,不合格
20050156,3,40,3,7,10,63,不合格
20050157,12,42,36,27,45,162,不合格
20050158,10,87,89,5,19,210,不合格
20050159,91,37,44,51,87,310,合格
20050160,87,53,31,10,25,206,不合格
20050161,90,7,56,99,60,312,合格
20050162,15,68,22,53,44,202,不合格
20050163,14,16,22,77,74,203,不合格
20050164,27,64,82,12,78,263,不合格
20050165,6,83,3,56,30,178,不合格
20050166,80,85,28,62,86,341,合格
20050167,3,99,49,8,16,175,不合格
20050168,63,38,71,60,38,270,不合格
20050169,30,79,57,49,71,286,不合格
20050170,16,72,68,47,91,294,不合格
20050171,90,19,81,46,76,312,合格
20050172,30,37,80,63,78,288,不合格
20050173,34,15,59,87,89,284,不合格
20050174,24,91,5,29,67,216,不合格
20050175,18,48,6,8,70,150,不合格
20050176,73,37,32,25,10,177,不合格
20050177,32,8,59,28,15,142,不合格
20050178,20,10,2,92,61,185,不合格
20050179,33,85,97,79,0,294,不合格
20050180,34,29,32,61,46,202,不合格
20050181,6,33,41,30,26,136,不合格
20050182,81,46,32,48,36,243,不合格
20050183,69,18,90,13,56,246,不合格
20050184,15,72,43,67,95,292,不合格
20050185,58,23,62,67,48,258,不合格
20050186,46,22,0,88,63,219,不合格
20050187,29,68,88,7,29,221,不合格
20050188,33,68,55,46,8,210,不合格
20050189,83,11,87,27,40,248,不合格
20050190,15,6,80,31,82,214,不合格
20050191,42,61,72,75,59,309,合格
20050192,36,56,81,66,68,307,合格
20050193,60,79,65,64,76,344,合格
20050194,49,88,92,10,50,289,不合格
20050195,57,91,80,7,22,257,不合格
20050196,66,43,80,60,54,303,合格
20050197,65,69,20,0,64,218,不合格
20050198,79,17,37,57,80,270,不合格
20050199,93,45,85,60,27,310,合格
20050200,87,47,38,58,19,249,不合格
20050201,71,28,35,60,68,262,不合格
20050202,28,79,63,48,19,237,不合格
20050203,49,40,44,91,11,235,不合格
20050204,71,29,67,62,52,281,不合格
20050205,91,0,93,74,7,265,不合格
20050206,34,10,67,48,92,251,不合格
20050207,92,92,82,29,83,378,合格
20050208,91,0,84,56,31,262,不合格
20050209,84,82,18,46,58,288,不合格
20050210,57,87,26,70,4,244,不合格
20050211,52,84,92,93,93,414,合格
20050212,38,13,76,18,20,165,不合格
20050213,11,32,0,90,98,231,不合格
20050214,7,46,86,75,60,274,不合格
20050215,94,21,33,50,40,238,不合格
20050216,69,80,64,5,68,286,不合格
20050217,40,83,48,33,86,290,不合格
20050218,30,69,89,67,2,257,不合格
20050219,50,0,33,32,56,171,不合格
20050220,6,84,29,4,73,196,不合格
20050221,69,35,7,94,82,287,不合格
20050222,54,33,61,58,43,249,不合格
20050223,30,90,85,3,35,243,不合格
20050224,75,22,2,77,93,269,不合格
20050225,13,5,14,94,20,146,不合格
20050226,50,70,37,5,81,243,不合格
20050227,32,72,43,65,36,248,不合格
20050228,79,23,70,19,30,221,不合格
20050229,59,36,7,95,21,218,不合格
20050230,27,69,11,0,28,135,不合格
20050231,24,96,37,47,47,251,不合格
20050232,70,49,11,50,89,269,不合格
20050233,16,66,8,40,17,147,不合格
20050234,36,59,24,42,64,225,不合格
20050235,96,55,73,40,84,348,合格
20050236,42,27,42,75,32,218,不合格
20050237,16,75,26,47,5,169,不合格
20050238,55,6,26,10,74,171,不合格
20050239,64,73,78,56,13,284,不合格
20050240,12,97,37,32,35,213,不合格
20050241,72,0,68,63,59,262,不合格
20050242,23,12,4,72,49,160,不合格
20050243,19,4,56,90,81,250,不合格
20050244,4,6,35,54,9,108,不合格
20050245,55,27,14,83,73,252,不合格
20050246,39,71,72,51,41,274,不合格
20050247,50,4,23,79,70,226,不合格
20050248,10,44,17,21,27,119,不合格
20050249,71,63,78,49,58,319,合格
20050250,83,16,73,46,22,240,不合格
20050251,27,15,82,47,71,242,不合格
20050252,14,53,13,92,51,223,不合格
20050253,8,90,11,10,35,154,不合格
20050254,21,28,40,53,31,173,不合格
20050255,42,84,69,30,19,244,不合格
20050256,81,67,63,45,2,258,不合格
20050257,40,83,74,70,83,350,合格
20050258,88,18,32,45,26,209,不合格
20050259,30,70,96,0,45,241,不合格
20050260,11,25,48,17,22,123,不合格
20050261,41,9,46,20,6,122,不合格
20050262,28,98,1,55,55,237,不合格
20050263,24,1,54,98,82,259,不合格
20050264,64,68,19,94,27,272,不合格
20050265,58,79,40,20,10,207,不合格
20050266,8,90,99,96,72,365,合格
20050267,8,21,51,69,96,245,不合格
20050268,15,57,33,98,96,299,不合格
20050269,79,92,16,48,72,307,合格
20050270,88,2,33,94,49,266,不合格
20050271,66,34,20,95,9,224,不合格
20050272,5,70,43,25,67,210,不合格
20050273,19,78,54,64,20,235,不合格
20050274,65,54,86,72,4,281,不合格
20050275,47,36,64,21,28,196,不合格
20050276,27,40,83,2,8,160,不合格
20050277,36,13,69,31,41,190,不合格
20050278,2,2,56,38,58,156,不合格
20050279,5,18,77,17,4,121,不合格
20050280,96,16,0,15,41,168,不合格
20050281,5,38,98,25,99,265,不合格
20050282,62,48,12,22,27,171,不合格
20050283,65,51,36,78,93,323,合格
20050284,32,91,39,22,55,239,不合格
20050285,45,4,0,11,34,94,不合格
20050286,65,85,87,90,88,415,合格
20050287,90,14,98,53,93,348,合格
20050288,61,12,61,91,20,245,不合格
20050289,88,69,43,8,40,248,不合格
20050290,18,57,40,75,97,287,不合格
20050291,59,6,38,84,33,220,不合格
20050292,65,40,54,17,87,263,不合格
20050293,82,25,8,37,47,199,不合格
20050294,46,35,49,83,12,225,不合格
20050295,21,33,1,13,50,118,不合格
20050296,49,29,43,25,28,174,不合格
20050297,45,1,6,10,19,81,不合格
20050298,14,38,21,13,54,140,不合格
20050299,40,53,98,56,30,277,不合格
20050300,35,59,72,31,49,246,不合格
20050301,85,89,39,98,14,325,合格
20050302,35,38,26,54,88,241,不合格
20050303,20,40,77,92,98,327,合格
20050304,13,11,29,37,36,126,不合格
20050305,37,25,59,45,82,248,不合格
20050306,52,45,86,89,19,291,不合格
20050307,29,61,87,15,70,262,不合格
20050308,91,97,51,32,98,369,合格
20050309,81,63,38,93,36,311,合格
20050310,37,90,64,7,65,263,不合格
20050311,10,69,69,33,41,222,不合格
20050312,1,33,63,40,91,228,不合格
20050313,36,21,84,70,69,280,不合格
20050314,97,39,17,69,82,304,合格
20050315,40,74,96,89,94,393,合格
20050316,83,7,55,15,79,239,不合格
20050317,33,53,69,63,52,270,不合格
20050318,41,97,55,8,45,246,不合格
20050319,88,80,72,42,77,359,合格
20050320,87,4,62,49,5,207,不合格
20050321,20,38,28,40,11,137,不合格
20050322,37,61,27,38,76,239,不合格
20050323,50,48,30,87,5,220,不合格
20050324,80,83,7,93,16,279,不合格
20050325,51,56,56,73,22,258,不合格
20050326,29,14,42,51,98,234,不合格
20050327,57,12,16,68,69,222,不合格
20050328,1,13,47,26,66,153,不合格
20050329,57,58,82,34,84,315,合格
20050330,0,35,26,94,77,232,不合格
20050331,59,32,48,7,25,171,不合格
20050332,66,66,9,76,1,218,不合格
20050333,82,43,73,12,59,269,不合格
20050334,32,64,13,53,5,167,不合格
20050335,41,27,12,53,10,143,不合格
20050336,41,8,84,17,21,171,不合格
20050337,97,93,94,81,69,434,合格
20050338,84,59,95,40,93,371,合格
20050339,55,19,94,52,93,313,合格
20050340,88,98,47,58,81,372,合格
20050341,24,34,96,27,49,230,不合格
20050342,39,45,18,66,54,222,不合格
20050343,47,57,19,79,93,295,不合格
20050344,96,93,71,88,22,370,合格
20050345,80,25,31,83,63,282,不合格
20050346,38,75,97,81,36,327,合格
20050347,48,48,48,99,54,297,不合格
20050348,46,44,94,28,90,302,合格
20050349,0,45,13,81,91,230,不合格
20050350,2,7,47,82,88,226,不合格
20050351,21,81,64,70,52,288,不合格
20050352,21,52,37,51,73,234,不合格
20050353,7,53,57,64,49,230,不合格
20050354,5,71,50,82,80,288,不合格
20050355,69,1,37,31,68,206,不合格
20050356,79,66,18,52,39,254,不合格
20050357,16,65,36,81,83,281,不合格
20050358,10,91,74,15,87,277,不合格
20050359,48,95,34,90,48,315,合格
20050360,92,72,53,88,54,359,合格
20050361,49,16,38,13,99,215,不合格
20050362,91,93,52,42,0,278,不合格
20050363,68,17,1,64,36,186,不合格
20050364,84,44,85,93,77,383,合格
20050365,58,31,17,45,47,198,不合格
20050366,72,16,18,30,58,194,不合格
20050367,38,12,92,61,16,219,不合格
20050368,13,3,41,75,16,148,不合格
20050369,22,99,6,86,73,286,不合格
20050370,45,37,30,20,83,215,不合格
20050371,71,22,14,68,80,255,不合格
20050372,16,11,93,77,56,253,不合格
20050373,73,66,51,82,3,275,不合格
20050374,59,49,78,49,35,270,不合格
20050375,32,70,10,25,24,161,不合格
20050376,35,8,16,94,27,180,不合格
20050377,82,14,12,93,64,265,不合格
20050378,55,13,70,66,37,241,不合格
20050379,59,50,8,34,99,250,不合格
20050380,1,2,60,82,86,231,不合格
20050381,45,10,74,38,14,181,不合格
20050382,63,64,68,52,89,336,合格
20050383,32,53,99,16,67,267,不合格
20050384,96,37,19,1,41,194,不合格
20050385,53,66,48,63,2,232,不合格
20050386,2,72,44,99,6,223,不合格
20050387,3,41,4,23,23,94,不合格
20050388,36,5,50,74,74,239,不合格
20050389,18,65,77,50,48,258,不合格
20050390,91,28,54,94,27,294,不合格
20050391,51,96,31,0,65,243,不合格
20050392,73,98,63,30,44,308,合格
20050393,93,4,63,92,72,324,合格
20050394,68,12,27,30,9,146,不合格
20050395,15,89,6,17,94,221,不合格
20050396,0,65,96,7,79,247,不合格
20050397,17,41,75,94,61,288,不合格
20050398,52,10,90,7,62,221,不合格
20050399,38,54,20,36,48,196,不合格
20050400,71,6,14,91,89,271,不合格
20050401,42,92,99,34,40,307,合格
20050402,59,21,8,41,55,184,不合格
20050403,27,64,87,95,49,322,合格
20050404,82,52,95,84,7,320,合格
20050405,10,40,43,18,11,122,不合格
20050406,21,88,90,16,32,247,不合格
20050407,85,15,9,33,1,143,不合格
20050408,29,82,58,7,77,253,不合格
20050409,9,44,17,86,30,186,不合格
20050410,63,58,52,91,55,319,合格
20050411,89,98,79,84,63,413,合格
20050412,35,96,41,27,59,258,不合格
20050413,7,68,81,54,47,257,不合格
20050414,56,89,32,55,72,304,合格
20050415,38,23,99,64,95,319,合格
20050416,50,32,18,63,76,239,不合格
20050417,89,81,67,59,83,379,合格
20050418,69,95,26,78,98,366,合格
20050419,28,7,12,87,34,168,不合格
20050420,99,49,57,39,7,251,不合格
20050421,43,85,52,81,90,351,合格
20050422,78,37,51,28,75,269,不合格
20050423,54,26,32,84,87,283,不合格
20050424,4,84,55,49,96,288,不合格
20050425,88,97,10,8,44,247,不合格
20050426,77,39,24,54,43,237,不合格
20050427,97,25,94,76,55,347,合格
20050428,48,95,25,47,16,231,不合格
20050429,90,43,1,20,0,154,不合格
20050430,75,10,52,60,55,252,不合格
20050431,65,91,77,23,65,321,合格
20050432,83,54,22,54,37,250,不合格
20050433,57,12,9,19,16,113,不合格
20050434,25,43,48,54,82,252,不合格
20050435,83,70,75,26,14,268,不合格
20050436,68,10,27,20,59,184,不合格
20050437,53,3,99,40,24,219,不合格
20050438,17,12,28,0,7,64,不合格
20050439,20,23,75,10,26,154,不合格
20050440,84,84,1,73,91,333,合格
20050441,55,41,61,68,31,256,不合格
20050442,29,5,26,62,59,181,不合格
20050443,99,98,22,55,82,356,合格
20050444,11,5,23,48,24,111,不合格
20050445,96,67,32,45,33,273,不合格
20050446,30,58,89,15,19,211,不合格
20050447,60,76,19,71,78,304,合格
20050448,34,99,98,41,70,342,合格
20050449,39,58,6,43,64,210,不合格
20050450,56,45,72,90,37,300,合格
20050451,94,47,18,73,46,278,不合格
20050452,35,36,53,86,21,231,不合格
20050453,47,9,11,32,54,153,不合格
20050454,20,65,72,81,77,315,合格
20050455,83,46,43,76,50,298,不合格
20050456,11,27,74,27,37,176,不合格
20050457,17,4,22,48,36,127,不合格
20050458,15,13,82,78,93,281,不合格
20050459,41,17,76,54,60,248,不合格
20050460,45,89,30,91,93,348,合格
20050461,28,74,66,77,68,313,合格
20050462,21,30,44,52,36,183,不合格
20050463,35,69,25,82,77,288,不合格
20050464,17,57,77,77,89,317,合格
20050465,67,46,28,50,76,267,不合格
20050466,75,88,69,93,66,391,合格
20050467,29,65,13,82,25,214,不合格
20050468,65,88,7,26,55,241,不合格
20050469,3,87,46,23,65,224,不合格
20050470,49,92,61,78,37,317,合格
20050471,0,45,76,88,24,233,不合格
20050472,22,50,46,35,27,180,不合格
20050473,58,31,77,58,23,247,不合格
20050474,59,42,96,13,59,269,不合格
20050475,5,96,81,75,1,258,不合格
20050476,5,34,98,55,18,210,不合格
20050477,34,81,8,45,68,236,不合格
20050478,42,32,24,6,61,165,不合格
20050479,86,83,68,44,21,302,合格
20050480,66,68,67,68,93,362,合格
20050481,29,90,34,45,50,248,不合格
20050482,81,78,76,15,37,287,不合格
20050483,52,52,21,55,40,220,不合格
20050484,50,95,95,46,89,375,合格
20050485,20,51,31,58,85,245,不合格
20050486,26,91,73,72,30,292,不合格
20050487,15,46,35,14,91,201,不合格
20050488,61,23,63,49,49,245,不合格
20050489,70,98,55,78,61,362,合格
20050490,54,93,36,12,72,267,不合格
20050491,22,32,23,76,55,208,不合格
20050492,93,59,22,65,50,289,不合格
20050493,78,6,12,79,77,252,不合格
20050494,1,41,9,72,34,157,不合格
20050495,34,6,3,57,63,163,不合格
20050496,8,18,80,78,88,272,不合格
20050497,61,15,13,14,11,114,不合格
20050498,79,37,25,46,29,216,不合格
20050499,8,18,52,15,93,186,不合格
20050500,3,43,35,58,70,209,不合格
20050501,10,3,25,99,10,147,不合格
20050502,45,58,16,96,40,255,不合格
20050503,31,64,64,14,76,249,不合格
20050504,57,22,69,41,48,237,不合格
20050505,43,70,17,25,17,172,不合格
20050506,9,62,96,49,87,303,合格
20050507,44,80,59,33,59,275,不合格
20050508,64,20,11,24,69,188,不合格
20050509,94,49,37,9,40,229,不合格
20050510,26,22,83,3,50,184,不合格
20050511,86,40,36,21,30,213,不合格
20050512,40,29,83,4,48,204,不合格
20050513,80,27,45,21,49,222,不合格
20050514,80,88,32,40,31,271,不合格
20050515,16,91,98,17,77,299,不合格
20050516,84,68,93,4,14,263,不合格
20050517,43,98,62,49,55,307,合格
20050518,66,23,12,64,31,196,不合格
20050519,85,43,5,28,90,251,不合格
20050520,91,88,25,32,89,325,合格
20050521,9,51,65,58,89,272,不合格
20050522,13,67,8,79,96,263,不合格
20050523,48,93,94,35,61,331,合格
20050524,67,71,73,76,90,377,合格
20050525,12,63,56,40,5,176,不合格
20050526,62,5,72,17,3,159,不合格
20050527,68,25,32,81,69,275,不合格
20050528,31,96,0,1,4,132,不合格
20050529,93,50,15,97,40,295,不合格
20050530,90,26,76,67,38,297,不合格
20050531,19,48,36,56,5,164,不合格
20050532,14,23,35,10,58,140,不合格
20050533,93,21,28,93,31,266,不合格
20050534,69,72,64,53,33,291,不合格
20050535,88,38,86,88,34,334,合格
20050536,17,64,44,24,17,166,不合格
20050537,76,74,79,95,31,355,合格
20050538,72,68,49,96,15,300,合格
20050539,75,6,40,33,32,186,不合格
20050540,61,76,34,37,34,242,不合格
20050541,8,93,62,59,3,225,不合格
20050542,14,14,91,91,49,259,不合格
20050543,47,79,30,29,10,195,不合格
20050544,16,97,11,22,41,187,不合格
20050545,93,94,20,3,66,276,不合格
20050546,89,52,74,21,30,266,不合格
20050547,57,38,34,18,99,246,不合格
20050548,70,40,11,94,53,268,不合格
20050549,50,44,54,73,92,313,合格
20050550,65,79,80,97,92,413,合格
20050551,89,74,54,31,47,295,不合格
20050552,11,71,46,82,60,270,不合格
20050553,73,73,93,81,28,348,合格
20050554,89,71,94,89,16,359,合格
20050555,99,30,51,6,58,244,不合格
20050556,26,59,72,70,77,304,合格
20050557,23,78,13,5,46,165,不合格
20050558,22,87,55,27,21,212,不合格
20050559,12,25,70,61,2,170,不合格
20050560,67,83,17,72,98,337,合格
20050561,81,5,62,12,18,178,不合格
20050562,83,34,13,63,72,265,不合格
20050563,60,17,90,0,2,169,不合格
20050564,86,77,20,64,89,336,合格
20050565,67,92,94,36,22,311,合格
20050566,24,21,25,53,68,191,不合格
20050567,86,68,19,5,29,207,不合格
20050568,88,19,89,64,55,315,合格
20050569,27,92,82,6,63,270,不合格
20050570,29,55,37,71,43,235,不合格
20050571,57,24,57,5,51,194,不合格
20050572,29,35,44,93,24,225,不合格
20050573,44,68,20,66,2,200,不合格
20050574,19,34,1,38,99,191,不合格
20050575,33,17,13,8,15,86,不合格
20050576,26,76,22,61,88,273,不合格
20050577,62,31,15,92,8,208,不合格
20050578,64,62,58,40,65,289,不合格
20050579,39,37,77,30,86,269,不合格
20050580,10,61,20,19,23,133,不合格
20050581,85,47,3,95,26,256,不合格
20050582,77,70,62,56,90,355,合格
20050583,40,34,12,44,3,133,不合格
20050584,24,36,29,66,60,215,不合格
20050585,82,73,6,30,90,281,不合格
20050586,24,30,71,33,37,195,不合格
20050587,13,51,63,13,20,160,不合格
20050588,56,92,86,95,47,376,合格
20050589,62,29,26,19,14,150,不合格
20050590,89,12,55,44,82,282,不合格
20050591,99,28,68,10,87,292,不合格
20050592,68,26,48,27,51,220,不合格
20050593,22,97,57,13,28,217,不合格
20050594,54,69,56,62,57,298,不合格
20050595,80,19,69,46,98,312,合格
20050596,47,63,98,1,73,282,不合格
20050597,1,19,11,89,40,160,不合格
20050598,82,31,26,12,61,212,不合格
20050599,76,75,16,30,45,242,不合格
20050600,67,25,16,90,21,219,不合格
20050601,60,33,9,46,16,164,不合格
20050602,23,11,9,8,16,67,不合格
20050603,90,7,35,48,43,223,不合格
20050604,19,89,96,55,28,287,不合格
20050605,30,57,53,5,98,243,不合格
20050606,80,3,43,75,65,266,不合格
20050607,59,46,9,9,80,203,不合格
20050608,88,61,57,61,73,340,合格
20050609,9,48,21,35,80,193,不合格
20050610,30,49,69,22,46,216,不合格
20050611,69,36,3,58,38,204,不合格
20050612,91,94,85,51,46,367,合格
20050613,71,26,6,74,6,183,不合格
20050614,49,60,24,56,36,225,不合格
20050615,96,6,45,75,46,268,不合格
20050616,92,16,96,22,70,296,不合格
20050617,1,51,20,97,21,190,不合格
20050618,63,59,20,63,25,230,不合格
20050619,46,74,77,72,29,298,不合格
20050620,1,42,49,81,39,212,不合格
20050621,45,15,36,58,19,173,不合格
20050622,36,48,69,13,61,227,不合格
20050623,62,18,47,78,20,225,不合格
20050624,52,36,35,80,5,208,不合格
20050625,20,35,75,43,49,222,不合格
20050626,30,96,72,68,2,268,不合格
20050627,75,52,59,64,30,280,不合格
20050628,43,76,86,58,29,292,不合格
20050629,65,23,67,77,26,258,不合格
20050630,48,78,70,67,30,293,不合格
20050631,56,88,55,50,51,300,合格
20050632,29,5,59,70,11,174,不合格
20050633,38,42,24,93,13,210,不合格
20050634,3,25,16,94,76,214,不合格
20050635,67,37,73,35,54,266,不合格
20050636,79,31,4,68,40,222,不合格
20050637,79,66,28,53,33,259,不合格
20050638,85,8,96,89,20,298,不合格
20050639,0,7,97,40,51,195,不合格
20050640,19,60,39,25,83,226,不合格
20050641,51,97,70,32,5,255,不合格
20050642,89,70,98,23,28,308,合格
20050643,49,39,13,87,76,264,不合格
20050644,56,1,94,18,5,174,不合格
20050645,45,92,23,17,11,188,不合格
20050646,33,24,66,86,94,303,合格
20050647,91,9,62,71,58,291,不合格
20050648,61,58,29,78,13,239,不合格
20050649,47,17,49,26,23,162,不合格
20050650,58,40,27,46,53,224,不合格
20050651,13,55,55,94,24,241,不合格
20050652,83,53,45,61,74,316,合格
20050653,20,31,37,14,73,175,不合格
20050654,96,13,82,49,88,328,合格
20050655,24,85,61,56,70,296,不合格
20050656,48,80,33,4,31,196,不合格
20050657,89,61,50,68,81,349,合格
20050658,27,40,36,43,56,202,不合格
20050659,38,93,86,17,92,326,合格
20050660,80,33,74,82,85,354,合格
20050661,67,4,98,64,56,289,不合格
20050662,2,0,31,3,99,135,不合格
20050663,87,10,7,64,44,212,不合格
20050664,20,90,1,81,65,257,不合格
20050665,89,68,21,83,21,282,不合格
20050666,20,5,63,51,69,208,不合格
20050667,61,37,59,76,33,266,不合格
20050668,89,31,70,66,57,313,合格
20050669,89,71,3,75,29,267,不合格
20050670,57,26,85,99,16,283,不合格
20050671,31,31,13,68,12,155,不合格
20050672,92,29,90,18,86,315,合格
20050673,54,90,71,13,75,303,合格
20050674,91,52,26,79,90,338,合格
20050675,80,55,97,85,52,369,合格
20050676,12,56,54,87,90,299,不合格
20050677,72,4,91,96,14,277,不合格
20050678,44,32,37,17,9,139,不合格
20050679,88,47,6,72,32,245,不合格
20050680,81,73,54,20,50,278,不合格
20050681,75,30,40,38,29,212,不合格
20050682,11,94,74,55,40,274,不合格
20050683,43,74,92,66,98,373,合格
20050684,85,19,96,72,85,357,合格
20050685,41,35,54,29,39,198,不合格
20050686,21,8,85,71,45,230,不合格
20050687,92,71,17,20,29,229,不合格
20050688,62,87,43,63,88,343,合格
20050689,47,74,96,94,99,410,合格
20050690,39,68,89,95,68,359,合格
20050691,6,22,59,82,37,206,不合格
20050692,58,11,61,20,39,189,不合格
20050693,91,99,58,93,85,426,合格
20050694,57,13,44,54,44,212,不合格
20050695,2,85,72,84,56,299,不合格
20050696,8,84,42,31,92,257,不合格
20050697,72,8,9,16,9,114,不合格
20050698,6,25,3,87,63,184,不合格
20050699,59,70,92,0,32,253,不合格
20050700,65,58,62,51,56,292,不合格
20050701,82,10,85,38,7,222,不合格
20050702,52,90,44,20,3,209,不合格
20050703,78,41,28,91,62,300,合格
20050704,78,26,59,48,85,296,不合格
20050705,53,54,71,48,68,294,不合格
20050706,93,29,1,97,7,227,不合格
20050707,66,44,41,17,62,230,不合格
20050708,68,46,49,96,22,281,不合格
20050709,77,61,18,52,51,259,不合格
20050710,49,66,5,28,10,158,不合格
20050711,2,59,19,52,92,224,不合格
20050712,52,99,83,2,37,273,不合格
20050713,56,48,90,65,27,286,不合格
20050714,82,4,68,24,17,195,不合格
20050715,86,20,15,37,46,204,不合格
20050716,67,98,60,4,60,289,不合格
20050717,12,66,88,84,53,303,合格
20050718,14,43,38,13,90,198,不合格
20050719,1,16,90,65,82,254,不合格
20050720,56,65,41,93,8,263,不合格
20050721,97,64,71,22,90,344,合格
20050722,20,6,25,24,59,134,不合格
20050723,87,50,46,85,62,330,合格
20050724,64,41,55,59,18,237,不合格
20050725,44,20,43,3,29,139,不合格
20050726,8,58,26,63,21,176,不合格
20050727,11,49,2,53,81,196,不合格
20050728,18,71,39,87,84,299,不合格
20050729,43,7,1,61,47,159,不合格
20050730,75,57,85,61,80,358,合格
20050731,98,16,23,29,40,206,不合格
20050732,93,60,28,99,40,320,合格
20050733,15,85,30,93,78,301,合格
20050734,33,25,83,56,17,214,不合格
20050735,52,26,31,26,4,139,不合格
20050736,88,96,87,72,22,365,合格
20050737,35,93,32,72,92,324,合格
20050738,93,88,78,71,50,380,合格
20050739,83,72,69,16,86,326,合格
20050740,86,37,59,71,35,288,不合格
20050741,27,2,23,72,50,174,不合格
20050742,10,18,28,13,11,80,不合格
20050743,98,75,38,12,45,268,不合格
20050744,46,22,90,75,61,294,不合格
20050745,56,36,43,34,97,266,不合格
20050746,18,48,59,11,72,208,不合格
20050747,31,93,52,14,11,201,不合格
20050748,42,65,59,7,77,250,不合格
20050749,44,97,68,55,3,267,不合格
20050750,42,3,12,93,10,160,不合格
20050751,16,1,95,2,77,191,不合格
20050752,27,9,27,25,97,185,不合格
20050753,36,62,30,82,69,279,不合格
20050754,91,40,94,90,80,395,合格
20050755,66,61,96,9,12,244,不合格
20050756,2,77,0,93,3,175,不合格
20050757,93,83,27,13,26,242,不合格
20050758,24,19,50,90,27,210,不合格
20050759,1,65,73,57,32,228,不合格
20050760,83,46,62,2,99,292,不合格
20050761,83,0,8,96,73,260,不合格
20050762,39,20,93,36,99,287,不合格
20050763,12,22,17,82,27,160,不合格
20050764,1,43,87,89,77,297,不合格
20050765,44,84,6,96,93,323,合格
20050766,14,0,35,65,33,147,不合格
20050767,15,44,91,45,9,204,不合格
20050768,8,66,38,41,55,208,不合格
20050769,62,45,23,90,82,302,合格
20050770,11,66,93,80,85,335,合格
20050771,10,92,12,97,50,261,不合格
20050772,13,49,32,63,60,217,不合格
20050773,41,13,19,45,51,169,不合格
20050774,78,29,30,13,5,155,不合格
20050775,30,76,31,80,4,221,不合格
20050776,75,4,14,32,54,179,不合格
20050777,53,63,0,50,38,204,不合格
20050778,95,21,95,37,57,305,合格
20050779,58,68,91,19,7,243,不合格
20050780,36,14,82,79,45,256,不合格
20050781,58,71,7,23,38,197,不合格
20050782,78,73,52,45,19,267,不合格
20050783,21,94,82,73,63,333,合格
20050784,26,75,99,88,8,296,不合格
20050785,67,33,59,69,16,244,不合格
20050786,26,26,59,3,41,155,不合格
20050787,37,65,24,46,77,249,不合格
20050788,89,34,79,33,23,258,不合格
20050789,28,30,84,24,60,226,不合格
20050790,34,54,3,28,74,193,不合格
20050791,15,93,1,23,26,158,不合格
20050792,28,0,34,35,62,159,不合格
20050793,25,4,33,86,23,171,不合格
20050794,12,81,39,63,4,199,不合格
20050795,90,88,63,98,77,416,合格
20050796,30,18,95,65,90,298,不合格
20050797,38,91,46,7,96,278,不合格
20050798,46,4,38,43,60,191,不合格
20050799,75,82,99,80,18,354,合格
20050800,64,27,66,90,23,270,不合格
20050801,17,1,57,61,84,220,不合格
20050802,26,88,87,85,55,341,合格
20050803,95,36,29,55,55,270,不合格
20050804,35,75,99,25,61,295,不合格
20050805,48,57,64,7,78,254,不合格
20050806,38,2,55,95,32,222,不合格
20050807,65,66,44,96,84,355,合格
20050808,66,54,20,63,54,257,不合格
20050809,51,64,28,79,4,226,不合格
20050810,73,84,94,8,10,269,不合格
20050811,91,76,89,49,87,392,合格
20050812,58,86,11,60,60,275,不合格
20050813,5,37,93,95,40,270,不合格
20050814,35,24,41,53,9,162,不合格
20050815,89,29,99,74,62,353,合格
20050816,22,90,5,16,8,141,不合格
20050817,5,72,19,22,76,194,不合格
20050818,60,28,46,91,29,254,不合格
20050819,48,74,16,18,58,214,不合格
20050820,94,99,79,81,67,420,合格
20050821,72,14,45,58,18,207,不合格
20050822,48,44,61,81,85,319,合格
20050823,11,4,84,94,87,280,不合格
20050824,71,89,66,72,21,319,合格
20050825,14,10,71,1,96,192,不合格
20050826,1,14,13,79,72,179,不合格
20050827,82,22,24,23,24,175,不合格
20050828,80,71,29,51,51,282,不合格
20050829,51,67,65,99,68,350,合格
20050830,80,34,55,60,80,309,合格
20050831,74,46,93,43,61,317,合格
20050832,63,32,89,81,14,279,不合格
20050833,18,8,10,17,26,79,不合格
20050834,49,34,63,71,58,275,不合格
20050835,98,26,98,56,27,305,合格
20050836,56,22,72,64,33,247,不合格
20050837,43,70,74,41,51,279,不合格
20050838,24,14,5,94,31,168,不合格
20050839,14,47,37,2,90,190,不合格
20050840,49,34,95,24,18,220,不合格
20050841,78,64,14,92,31,279,不合格
20050842,53,48,79,73,97,350,合格
20050843,68,34,72,88,31,293,不合格
20050844,82,60,49,3,50,244,不合格
20050845,14,81,51,94,8,248,不合格
20050846,54,45,4,98,74,275,不合格
20050847,8,51,5,99,49,212,不合格
20050848,38,48,14,5,60,165,不合格
20050849,75,32,83,88,55,333,合格
20050850,10,49,7,95,4,165,不合格
20050851,88,77,96,2,31,294,不合格
20050852,65,53,75,44,49,286,不合格
20050853,25,90,14,64,40,233,不合格
20050854,2,11,22,26,22,83,不合格
20050855,1,2,28,83,78,192,不合格
20050856,95,72,45,81,60,353,合格
20050857,4,50,32,58,88,232,不合格
20050858,92,19,4,60,31,206,不合格
20050859,15,27,41,48,65,196,不合格
20050860,5,5,86,36,21,153,不合格
20050861,1,0,54,3,93,151,不合格
20050862,27,84,37,82,72,302,合格
20050863,54,91,45,23,27,240,不合格
20050864,85,4,32,1,22,144,不合格
20050865,75,30,73,70,57,305,合格
20050866,7,29,74,80,44,234,不合格
20050867,19,72,5,55,33,184,不合格
20050868,29,48,8,62,58,205,不合格
20050869,56,53,35,63,25,232,不合格
20050870,29,4,94,29,15,171,不合格
20050871,13,57,15,10,27,122,不合格
20050872,68,59,70,36,72,305,合格
20050873,31,57,99,69,22,278,不合格
20050874,51,12,21,7,0,91,不合格
20050875,90,50,50,79,51,320,合格
20050876,73,86,40,46,68,313,合格
20050877,89,95,60,42,43,329,合格
20050878,43,52,67,59,20,241,不合格
20050879,56,92,39,13,97,297,不合格
20050880,63,65,66,71,92,357,合格
20050881,56,88,22,29,26,221,不合格
20050882,64,74,38,89,80,345,合格
20050883,0,60,13,14,34,121,不合格
20050884,58,95,54,1,31,239,不合格
20050885,89,77,72,63,92,393,合格
20050886,82,78,61,19,89,329,合格
20050887,78,59,45,7,77,266,不合格
20050888,48,43,36,48,77,252,不合格
20050889,72,14,65,14,17,182,不合格
20050890,88,11,1,27,52,179,不合格
20050891,7,64,26,69,27,193,不合格
20050892,32,37,61,39,25,194,不合格
20050893,70,51,94,52,27,294,不合格
20050894,99,0,96,13,93,301,合格
20050895,27,67,91,10,89,284,不合格
20050896,31,41,12,79,74,237,不合格
20050897,37,5,56,23,26,147,不合格
20050898,50,49,39,83,88,309,合格
20050899,29,49,95,68,40,281,不合格
20050900,8,22,41,3,48,122,不合格
20050901,37,11,77,21,4,150,不合格
20050902,41,11,24,30,94,200,不合格
20050903,86,75,12,77,95,345,合格
20050904,76,99,20,15,83,293,不合格
20050905,28,68,87,92,22,297,不合格
20050906,73,6,62,77,18,236,不合格
20050907,5,38,90,54,10,197,不合格
20050908,14,91,49,62,57,273,不合格
20050909,75,65,83,7,21,251,不合格
20050910,20,15,67,74,61,237,不合格
20050911,26,20,41,90,82,259,不合格
20050912,6,5,43,71,68,193,不合格
20050913,73,29,34,57,74,267,不合格
20050914,42,4,98,25,30,199,不合格
20050915,24,50,51,45,60,230,不合格
20050916,20,15,27,0,46,108,不合格
20050917,64,9,22,60,57,212,不合格
20050918,87,77,23,70,49,306,合格
20050919,1,48,15,31,34,129,不合格
20050920,98,88,59,61,56,362,合格
20050921,22,77,16,66,81,262,不合格
20050922,70,20,35,40,69,234,不合格
20050923,12,5,38,3,92,150,不合格
20050924,7,90,70,70,59,296,不合格
20050925,93,48,78,50,65,334,合格
20050926,55,25,0,23,95,198,不合格
20050927,54,53,85,25,10,227,不合格
20050928,64,65,52,63,73,317,合格
20050929,99,75,75,20,28,297,不合格
20050930,89,67,46,11,66,279,不合格
20050931,49,62,8,70,1,190,不合格
20050932,21,85,98,1,21,226,不合格
20050933,0,82,23,97,1,203,不合格
20050934,71,85,32,84,94,366,合格
20050935,84,73,59,4,61,281,不合格
20050936,99,41,31,36,97,304,合格
20050937,54,30,84,42,13,223,不合格
20050938,20,33,21,65,21,160,不合格
20050939,9,14,82,58,59,222,不合格
20050940,41,94,52,63,20,270,不合格
20050941,26,98,95,31,81,331,合格
20050942,94,45,6,10,50,205,不合格
20050943,16,91,48,33,70,258,不合格
20050944,83,87,95,28,20,313,合格
20050945,8,5,19,6,72,110,不合格
20050946,75,60,76,0,31,242,不合格
20050947,94,64,68,46,66,338,合格
20050948,43,64,13,72,19,211,不合格
20050949,36,75,6,81,86,284,不合格
20050950,10,0,54,71,21,156,不合格
20050951,54,75,97,8,57,291,不合格
20050952,36,70,87,31,65,289,不合格
20050953,95,24,54,32,97,302,合格
20050954,66,28,3,31,63,191,不合格
20050955,16,58,3,54,0,131,不合格
20050956,49,8,49,93,60,259,不合格
20050957,53,84,66,97,84,384,合格
20050958,11,14,20,27,61,133,不合格
20050959,48,85,47,63,66,309,合格
20050960,26,55,43,92,21,237,不合格
20050961,2,48,24,7,40,121,不合格
20050962,97,80,10,24,74,285,不合格
20050963,11,16,58,96,61,242,不合格
20050964,43,46,43,36,80,248,不合格
20050965,41,23,48,91,91,294,不合格
20050966,54,36,5,72,73,240,不合格
20050967,33,53,39,51,40,216,不合格
20050968,78,49,24,66,58,275,不合格
20050969,19,51,29,96,59,254,不合格
20050970,59,3,65,16,53,196,不合格
20050971,93,56,15,86,91,341,合格
20050972,30,46,9,60,71,216,不合格
20050973,23,69,40,3,15,150,不合格
20050974,17,91,86,94,88,376,合格
20050975,9,51,77,64,13,214,不合格
20050976,73,13,3,24,70,183,不合格
20050977,68,93,24,69,30,284,不合格
20050978,23,19,14,96,28,180,不合格
20050979,39,21,0,22,21,103,不合格
20050980,72,67,59,63,7,268,不合格
20050981,48,14,43,2,58,165,不合格
20050982,9,36,32,78,4,159,不合格
20050983,54,97,82,9,32,274,不合格
20050984,64,21,40,1,8,134,不合格
20050985,43,43,57,99,21,263,不合格
20050986,3,13,94,25,15,150,不合格
20050987,55,39,53,75,43,265,不合格
20050988,42,77,10,26,13,168,不合格
20050989,67,0,65,57,75,264,不合格
20050990,20,61,65,33,80,259,不合格
20050991,92,13,54,46,34,239,不合格
20050992,31,98,35,4,31,199,不合格
20050993,34,84,75,78,72,343,合格
20050994,93,33,10,3,29,168,不合格
20050995,67,95,92,10,34,298,不合格
20050996,18,12,15,25,69,139,不合格
20050997,90,5,71,43,27,236,不合格
20050998,95,57,43,67,12,274,不合格
20050999,44,51,2,66,32,195,不合格
20051000,71,78,11,5,30,195,不合格
20051001,69,26,91,26,0,212,不合格
20051002,53,36,60,16,51,216,不合格
20051003,69,66,65,86,41,327,合格
20051004,63,31,41,22,75,232,不合格
20051005,94,7,58,15,78,252,不合格
20051006,69,97,71,11,6,254,不合格
20051007,33,87,45,32,41,238,不合格
20051008,4,24,26,16,60,130,不合格
20051009,60,38,84,78,89,349,合格
20051010,76,78,52,5,85,296,不合格
20051011,16,30,97,15,56,214,不合格
20051012,87,41,74,33,98,333,合格
20051013,64,62,87,75,81,369,合格
20051014,93,67,28,68,80,336,合格
20051015,12,13,89,52,97,263,不合格
20051016,73,85,36,44,20,258,不合格
20051017,91,63,84,2,26,266,不合格
20051018,60,50,48,26,24,208,不合格
20051019,6,47,7,33,40,133,不合格
20051020,66,85,77,16,50,294,不合格
20051021,25,38,63,74,38,238,不合格
20051022,67,3,93,20,3,186,不合格
20051023,99,48,76,90,87,400,合格
20051024,11,13,38,70,26,158,不合格
20051025,50,74,58,73,62,317,合格
20051026,55,78,11,63,7,214,不合格
20051027,60,29,43,73,69,274,不合格
20051028,25,48,43,78,56,250,不合格
20051029,78,0,99,27,83,287,不合格
20051030,22,61,25,56,9,173,不合格
20051031,1,38,67,15,15,136,不合格
20051032,17,18,21,73,78,207,不合格
20051033,15,83,56,10,70,234,不合格
20051034,59,54,17,13,88,231,不合格
20051035,63,83,85,67,31,329,合格
20051036,2,72,8,56,24,162,不合格
20051037,73,5,92,59,70,299,不合格
20051038,53,97,78,33,88,349,合格
20051039,79,56,96,35,99,365,合格
20051040,36,68,32,6,96,238,不合格
20051041,81,1,76,48,74,280,不合格
20051042,62,13,76,71,5,227,不合格
20051043,69,4,22,1,30,126,不合格
20051044,1,13,66,5,17,102,不合格
20051045,90,58,13,80,3,244,不合格
20051046,8,24,98,50,44,224,不合格
20051047,97,72,52,74,49,344,合格
20051048,11,69,84,1,57,222,不合格
20051049,20,63,29,64,32,208,不合格
20051050,93,25,86,78,83,365,合格
20051051,12,92,28,8,20,160,不合格
20051052,63,60,42,47,91,303,合格
20051053,76,6,61,71,52,266,不合格
20051054,85,57,69,99,46,356,合格
20051055,84,76,34,71,65,330,合格
20051056,74,48,44,45,0,211,不合格
20051057,79,83,0,84,99,345,合格
20051058,13,53,21,9,65,161,不合格
20051059,52,16,91,66,46,271,不合格
20051060,45,35,81,37,5,203,不合格
20051061,32,23,42,50,38,185,不合格
20051062,15,77,94,38,45,269,不合格
20051063,24,89,75,39,22,249,不合格
20051064,56,41,62,58,6,223,不合格
20051065,76,57,86,46,19,284,不合格
20051066,25,22,46,63,20,176,不合格
20051067,20,78,81,33,39,251,不合格
20051068,73,42,90,91,30,326,合格
20051069,79,87,69,28,57,320,合格
20051070,89,12,24,55,48,228,不合格
20051071,69,94,70,99,74,406,合格
20051072,46,92,42,77,61,318,合格
20051073,99,69,23,83,53,327,合格
20051074,91,97,2,44,20,254,不合格
20051075,37,53,81,7,0,178,不合格
20051076,17,66,50,62,96,291,不合格
20051077,43,98,90,95,65,391,合格
20051078,28,62,2,91,50,233,不合格
20051079,76,82,43,59,39,299,不合格
20051080,48,95,97,48,76,364,合格
20051081,25,66,11,32,23,157,不合格
20051082,70,10,40,51,90,261,不合格
20051083,49,7,47,88,83,274,不合格
20051084,34,95,58,24,58,269,不合格
20051085,18,30,44,24,77,193,不合格
20051086,84,50,73,35,63,305,合格
20051087,25,85,68,15,76,269,不合格
20051088,31,66,24,45,92,258,不合格
20051089,93,60,12,4,34,203,不合格
20051090,26,67,75,5,56,229,不合格
20051091,97,97,46,13,75,328,合格
20051092,90,98,34,71,19,312,合格
20051093,22,50,40,30,94,236,不合格
20051094,34,77,10,67,61,249,不合格
20051095,38,13,5,40,37,133,不合格
20051096,6,5,31,66,21,129,不合格
20051097,57,48,33,8,55,201,不合格
20051098,31,95,52,57,88,323,合格
20051099,95,98,85,21,64,363,合格
20051100,93,28,93,38,82,334,合格
20051101,46,67,56,66,58,293,不合格
20051102,46,20,51,98,14,229,不合格
20051103,88,12,96,12,93,301,合格
20051104,29,49,26,75,89,268,不合格
20051105,57,67,59,78,8,269,不合格
20051106,50,19,36,96,35,236,不合格
20051107,2,54,6,48,81,191,不合格
20051108,52,94,49,0,74,269,不合格
20051109,96,45,17,92,6,256,不合格
20051110,8,68,60,65,93,294,不合格
20051111,96,95,58,81,1,331,合格
20051112,0,17,20,14,69,120,不合格
20051113,33,32,69,73,40,247,不合格
20051114,1,52,68,57,42,220,不合格
20051115,26,56,95,32,16,225,不合格
20051116,91,87,16,23,34,251,不合格
20051117,72,77,41,82,88,360,合格
20051118,10,13,40,56,40,159,不合格
20051119,70,41,27,82,49,269,不合格
20051120,43,31,52,19,29,174,不合格
20051121,14,29,85,22,12,162,不合格
20051122,79,4,40,96,25,244,不合格
20051123,13,14,94,59,58,238,不合格
20051124,43,60,10,39,24,176,不合格
20051125,9,63,76,83,13,244,不合格
20051126,64,67,96,80,13,320,合格
20051127,4,44,1,14,42,105,不合格
20051128,79,27,38,90,52,286,不合格
20051129,35,46,18,58,71,228,不合格
20051130,61,72,54,64,30,281,不合格
20051131,2,14,28,34,66,144,不合格
20051132,51,92,62,59,35,299,不合格
20051133,92,69,46,43,47,297,不合格
20051134,31,58,84,18,31,222,不合格
20051135,41,64,99,30,27,261,不合格
20051136,17,20,68,52,92,249,不合格
20051137,95,83,3,69,29,279,不合格
20051138,48,51,3,33,42,177,不合格
20051139,33,67,79,42,45,266,不合格
20051140,11,87,56,83,82,319,合格
20051141,29,75,32,21,26,183,不合格
20051142,51,58,73,79,82,343,合格
20051143,41,79,5,19,38,182,不合格
20051144,64,31,70,92,9,266,不合格
20051145,61,62,7,50,62,242,不合格
20051146,75,28,82,81,48,314,合格
20051147,75,66,52,55,60,308,合格
20051148,22,68,69,22,93,274,不合格
20051149,94,44,12,93,3,246,不合格
20051150,93,17,73,38,31,252,不合格
20051151,75,75,1,27,24,202,不合格
20051152,65,18,73,68,4,228,不合格
20051153,81,84,62,84,29,340,合格
20051154,72,64,47,46,91,320,合格
20051155,83,17,4,96,37,237,不合格
20051156,13,35,2,23,41,114,不合格
20051157,50,94,78,59,87,368,合格
20051158,77,47,83,78,43,328,合格
20051159,61,57,75,15,97,305,合格
20051160,47,15,84,34,55,235,不合格
20051161,7,41,77,96,5,226,不合格
20051162,58,55,96,34,96,339,合格
20051163,64,66,67,21,27,245,不合格
20051164,69,90,7,49,44,259,不合格
20051165,60,78,40,79,40,297,不合格
20051166,67,84,87,79,0,317,合格
20051167,7,53,6,75,45,186,不合格
20051168,59,25,91,93,66,334,合格
20051169,63,6,63,74,15,221,不合格
20051170,37,16,66,65,64,248,不合格
20051171,45,90,18,46,82,281,不合格
20051172,71,69,59,37,41,277,不合格
20051173,78,72,91,36,42,319,合格
20051174,6,31,70,82,38,227,不合格
20051175,98,70,47,62,99,376,合格
20051176,17,29,56,84,56,242,不合格
20051177,48,68,66,66,11,259,不合格
20051178,74,78,87,20,69,328,合格
20051179,7,19,65,53,73,217,不合格
20051180,21,63,51,82,87,304,合格
20051181,55,66,1,41,48,211,不合格
20051182,60,83,14,25,68,250,不合格
20051183,75,76,2,83,11,247,不合格
20051184,41,17,12,65,98,233,不合格
20051185,98,21,69,25,27,240,不合格
20051186,64,74,99,33,37,307,合格
20051187,59,34,16,94,23,226,不合格
20051188,3,47,16,71,60,197,不合格
20051189,12,54,18,58,58,200,不合格
20051190,76,99,74,38,90,377,合格
20051191,32,29,35,4,71,171,不合格
20051192,64,69,57,79,7,276,不合格
20051193,95,59,57,23,81,315,合格
20051194,25,27,75,66,6,199,不合格
20051195,89,26,69,31,73,288,不合格
20051196,32,90,32,21,31,206,不合格
20051197,94,34,1,5,99,233,不合格
20051198,53,31,48,38,21,191,不合格
20051199,34,18,96,12,20,180,不合格
20051200,23,52,62,17,10,164,不合格
20051201,9,51,52,9,87,208,不合格
20051202,21,92,87,29,63,292,不合格
20051203,15,45,56,79,74,269,不合格
20051204,45,49,33,87,57,271,不合格
20051205,47,66,0,33,18,164,不合格
20051206,64,60,40,29,85,278,不合格
20051207,14,34,2,24,43,117,不合格
20051208,86,69,20,40,99,314,合格
20051209,23,27,18,89,54,211,不合格
20051210,21,16,59,40,51,187,不合格
20051211,34,63,80,85,91,353,合格
20051212,79,27,30,86,50,272,不合格
20051213,30,8,15,16,65,134,不合格
20051214,21,14,29,17,2,83,不合格
20051215,70,47,56,64,36,273,不合格
20051216,24,35,57,51,7,174,不合格
20051217,86,85,46,59,6,282,不合格
20051218,42,1,50,43,3,139,不合格
20051219,72,46,54,96,67,335,合格
20051220,82,62,16,57,48,265,不合格
20051221,75,32,26,62,34,229,不合格
20051222,99,75,83,66,66,389,合格
20051223,47,43,14,22,53,179,不合格
20051224,83,88,61,4,64,300,合格
20051225,61,70,76,24,80,311,合格
20051226,64,21,33,69,72,259,不合格
20051227,74,17,54,65,28,238,不合格
20051228,44,38,99,1,59,241,不合格
20051229,66,35,93,21,64,279,不合格
20051230,44,93,88,90,25,340,合格
20051231,46,92,43,14,37,232,不合格
20051232,11,7,42,85,86,231,不合格
20051233,73,77,78,37,49,314,合格
20051234,95,22,17,23,35,192,不合格
20051235,37,15,25,23,87,187,不合格
20051236,41,17,47,11,83,199,不合格
20051237,96,6,25,34,46,207,不合格
20051238,5,2,1,29,6,43,不合格
20051239,50,57,69,0,12,188,不合格
20051240,86,87,53,93,80,399,合格
20051241,19,22,19,92,67,219,不合格
20051242,29,85,71,39,63,287,不合格
20051243,66,99,50,22,95,332,合格
20051244,49,8,66,14,27,164,不合格
20051245,38,93,86,66,73,356,合格
20051246,89,30,3,88,9,219,不合格
20051247,43,5,16,35,64,163,不合格
20051248,46,96,77,69,27,315,合格
20051249,82,31,2,55,73,243,不合格
20051250,74,82,62,10,54,282,不合格
20051251,82,0,17,55,53,207,不合格
20051252,96,28,38,92,77,331,合格
20051253,36,50,63,12,74,235,不合格
20051254,22,16,84,48,28,198,不合格
20051255,99,21,34,91,39,284,不合格
20051256,13,95,61,66,72,307,合格
20051257,6,83,51,85,66,291,不合格
20051258,52,24,41,72,38,227,不合格
20051259,12,5,10,3,56,86,不合格
20051260,33,55,9,59,94,250,不合格
20051261,95,88,74,61,59,377,合格
20051262,56,70,36,79,67,308,合格
20051263,75,96,84,21,94,370,合格
20051264,4,8,14,3,24,53,不合格
20051265,21,82,82,42,24,251,不合格
20051266,75,17,94,76,84,346,合格
20051267,82,57,91,30,32,292,不合格
20051268,16,35,76,0,27,154,不合格
20051269,29,94,96,3,50,272,不合格
20051270,55,12,62,4,25,158,不合格
20051271,27,17,95,97,44,280,不合格
20051272,73,3,80,65,96,317,合格
20051273,37,91,0,6,98,232,不合格
20051274,15,79,35,85,11,225,不合格
20051275,37,32,27,12,62,170,不合格
20051276,9,22,67,61,78,237,不合格
20051277,70,77,85,78,39,349,合格
20051278,80,94,19,79,27,299,不合格
20051279,81,81,79,25,81,347,合格
20051280,39,41,65,18,0,163,不合格
20051281,35,8,55,3,33,134,不合格
20051282,56,8,45,76,80,265,不合格
20051283,66,16,60,56,46,244,不合格
20051284,27,75,26,65,34,227,不合格
20051285,59,86,82,8,48,283,不合格
20051286,36,94,1,72,10,213,不合格
20051287,19,62,67,5,74,227,不合格
20051288,7,63,43,22,51,186,不合格
20051289,99,15,32,79,81,306,合格
20051290,79,55,4,12,81,231,不合格
20051291,70,19,49,55,15,208,不合格
20051292,41,5,78,69,38,231,不合格
20051293,11,37,61,46,21,176,不合格
20051294,22,91,31,92,31,267,不合格
20051295,95,67,64,30,7,263,不合格
20051296,16,23,5,82,65,191,不合格
20051297,89,61,13,89,9,261,不合格
20051298,20,48,40,96,20,224,不合格
20051299,89,96,53,91,19,348,合格
20051300,16,65,5,15,82,183,不合格
20051301,84,8,74,7,16,189,不合格
20051302,96,72,14,85,75,342,合格
20051303,50,2,40,39,0,131,不合格
20051304,9,47,90,44,97,287,不合格
20051305,80,86,45,38,3,252,不合格
20051306,51,49,62,29,95,286,不合格
20051307,42,65,48,69,50,274,不合格
20051308,33,28,57,22,69,209,不合格
20051309,91,58,52,39,36,276,不合格
20051310,9,90,51,79,88,317,合格
20051311,14,86,6,12,71,189,不合格
20051312,55,96,95,9,48,303,合格
20051313,5,85,65,36,14,205,不合格
20051314,4,90,3,35,60,192,不合格
20051315,92,51,40,65,49,297,不合格
20051316,79,62,10,22,14,187,不合格
20051317,93,10,59,25,90,277,不合格
20051318,22,63,28,76,16,205,不合格
20051319,9,67,85,92,93,346,合格
20051320,56,37,75,76,92,336,合格
20051321,61,11,87,89,29,277,不合格
20051322,17,79,34,55,75,260,不合格
20051323,87,28,10,5,78,208,不合格
20051324,7,47,25,5,73,157,不合格
20051325,8,18,75,25,40,166,不合格
20051326,88,0,33,25,42,188,不合格
20051327,89,65,25,0,69,248,不合格
20051328,90,0,57,85,82,314,合格
20051329,59,71,82,32,83,327,合格
20051330,13,79,1,34,2,129,不合格
20051331,48,6,48,49,64,215,不合格
20051332,4,94,51,54,98,301,合格
20051333,39,10,45,96,56,246,不合格
20051334,15,84,57,43,45,244,不合格
20051335,94,49,61,80,40,324,合格
20051336,52,15,60,19,70,216,不合格
20051337,40,28,83,97,66,314,合格
20051338,12,35,28,0,49,124,不合格
20051339,68,48,94,78,89,377,合格
20051340,22,9,48,62,0,141,不合格
20051341,73,34,5,80,75,267,不合格
20051342,60,1,44,39,73,217,不合格
20051343,24,28,39,59,0,150,不合格
20051344,96,73,78,37,0,284,不合格
20051345,87,78,18,29,13,225,不合格
20051346,55,16,69,91,97,328,合格
20051347,87,82,73,88,99,429,合格
20051348,33,46,52,49,91,271,不合格
20051349,55,44,99,70,53,321,合格
20051350,63,10,84,98,71,326,合格
20051351,34,5,32,74,53,198,不合格
20051352,27,65,5,46,92,235,不合格
20051353,6,91,27,19,38,181,不合格
20051354,94,58,39,94,27,312,合格
20051355,52,15,75,78,89,309,合格
20051356,73,76,15,74,49,287,不合格
20051357,18,55,15,13,89,190,不合格
20051358,71,59,5,3,78,216,不合格
20051359,93,97,46,55,62,353,合格
20051360,30,27,60,71,26,214,不合格
20051361,32,29,50,17,97,225,不合格
20051362,30,95,10,44,11,190,不合格
20051363,40,66,3,52,83,244,不合格
20051364,2,83,73,51,60,269,不合格
20051365,64,66,57,12,70,269,不合格
20051366,72,68,48,29,91,308,合格
20051367,65,14,43,33,81,236,不合格
20051368,18,52,80,45,4,199,不合格
20051369,29,72,82,2,26,211,不合格
20051370,39,59,72,70,54,294,不合格
20051371,60,4,11,76,9,160,不合格
20051372,24,81,13,61,67,246,不合格
20051373,74,31,72,99,90,366,合格
20051374,75,63,61,48,14,261,不合格
20051375,40,40,73,54,44,251,不合格
20051376,37,48,32,57,15,189,不合格
20051377,22,39,72,34,82,249,不合格
20051378,40,66,32,27,99,264,不合格
20051379,72,55,42,40,50,259,不合格
20051380,54,72,72,45,13,256,不合格
20051381,41,40,35,45,28,189,不合格
20051382,59,31,13,94,16,213,不合格
20051383,48,96,89,66,6,305,合格
20051384,83,86,63,61,5,298,不合格
20051385,26,99,22,2,25,174,不合格
20051386,61,40,73,98,42,314,合格
20051387,44,35,74,71,9,233,不合格
20051388,35,72,48,56,5,216,不合格
20051389,35,95,74,14,23,241,不合格
20051390,83,20,89,28,97,317,合格
20051391,9,6,46,28,84,173,不合格
20051392,24,7,81,72,44,228,不合格
20051393,23,87,60,22,45,237,不合格
20051394,17,77,37,71,75,277,不合格
20051395,57,70,81,98,1,307,合格
20051396,26,7,52,10,94,189,不合格
20051397,57,53,79,64,18,271,不合格
20051398,13,81,10,93,43,240,不合格
20051399,51,49,10,5,7,122,不合格
20051400,71,79,60,13,80,303,合格
20051401,45,0,3,30,25,103,不合格
20051402,60,30,61,30,30,211,不合格
20051403,11,46,48,21,55,181,不合格
20051404,47,78,19,33,7,184,不合格
20051405,79,51,56,9,41,236,不合格
20051406,2,6,73,96,94,271,不合格
20051407,14,78,42,27,60,221,不合格
20051408,46,54,72,30,84,286,不合格
20051409,62,43,25,1,35,166,不合格
20051410,7,35,75,23,76,216,不合格
20051411,22,30,28,64,28,172,不合格
20051412,26,52,2,75,31,186,不合格
20051413,55,7,94,76,95,327,合格
20051414,13,76,19,0,74,182,不合格
20051415,41,47,57,41,62,248,不合格
20051416,5,97,22,76,18,218,不合格
20051417,28,98,11,45,48,230,不合格
20051418,9,57,17,79,13,175,不合格
20051419,89,44,85,47,91,356,合格
20051420,36,17,66,62,48,229,不合格
20051421,27,94,58,56,80,315,合格
20051422,94,5,21,59,23,202,不合格
20051423,19,94,62,71,55,301,合格
20051424,48,92,9,57,89,295,不合格
20051425,59,27,74,25,33,218,不合格
20051426,72,34,67,45,76,294,不合格
20051427,6,48,0,74,56,184,不合格
20051428,35,86,70,86,77,354,合格
20051429,73,43,20,24,77,237,不合格
20051430,85,44,20,89,85,323,合格
20051431,11,47,90,8,69,225,不合格
20051432,31,36,77,87,89,320,合格
20051433,62,16,38,96,55,267,不合格
20051434,2,19,32,90,32,175,不合格
20051435,52,10,17,80,32,191,不合格
20051436,67,43,89,27,97,323,合格
20051437,18,72,41,43,0,174,不合格
20051438,2,89,59,10,17,177,不合格
20051439,56,51,34,26,18,185,不合格
20051440,23,23,40,5,66,157,不合格
20051441,86,30,62,15,77,270,不合格
20051442,54,41,76,49,90,310,合格
20051443,79,60,46,62,38,285,不合格
20051444,80,54,83,36,64,317,合格
20051445,73,42,62,0,69,246,不合格
20051446,80,74,32,27,24,237,不合格
20051447,92,24,37,82,77,312,合格
20051448,65,62,86,70,94,377,合格
20051449,12,70,67,54,61,264,不合格
20051450,33,48,37,30,86,234,不合格
20051451,80,78,12,58,86,314,合格
20051452,17,77,94,43,66,297,不合格
20051453,87,12,96,71,18,284,不合格
20051454,68,0,67,86,72,293,不合格
20051455,99,73,77,81,36,366,合格
20051456,46,10,58,32,58,204,不合格
20051457,11,47,13,49,36,156,不合格
20051458,32,21,81,91,76,301,合格
20051459,56,65,94,37,48,300,合格
20051460,92,68,65,24,61,310,合格
20051461,58,94,60,87,67,366,合格
20051462,84,9,54,74,6,227,不合格
20051463,43,80,11,57,11,202,不合格
20051464,43,38,20,13,78,192,不合格
20051465,92,47,77,48,44,308,合格
20051466,78,96,53,58,52,337,合格
20051467,80,81,67,87,5,320,合格
20051468,49,72,93,62,59,335,合格
20051469,70,9,67,67,28,241,不合格
20051470,10,37,15,50,26,138,不合格
20051471,64,54,39,99,82,338,合格
20051472,49,31,8,7,0,95,不合格
20051473,62,79,45,61,43,290,不合格
20051474,49,77,18,90,21,255,不合格
20051475,38,51,33,81,22,225,不合格
20051476,95,31,64,28,16,234,不合格
20051477,18,45,57,9,25,154,不合格
20051478,14,64,8,22,43,151,不合格
20051479,74,24,81,39,28,246,不合格
20051480,71,57,19,68,18,233,不合格
20051481,63,12,83,30,84,272,不合格
20051482,13,28,20,17,57,135,不合格
20051483,45,37,50,57,36,225,不合格
20051484,76,84,81,65,53,359,合格
20051485,69,9,20,5,66,169,不合格
20051486,54,16,31,83,96,280,不合格
20051487,34,37,60,49,83,263,不合格
20051488,55,87,50,20,34,246,不合格
20051489,75,23,22,11,91,222,不合格
20051490,73,67,98,69,61,368,合格
20051491,81,39,9,83,61,273,不合格
20051492,26,62,48,40,67,243,不合格
20051493,54,16,78,58,82,288,不合格
20051494,73,40,96,25,75,309,合格
20051495,69,59,3,55,50,236,不合格
20051496,32,36,36,42,46,192,不合格
20051497,15,37,44,69,53,218,不合格
20051498,98,53,87,24,70,332,合格
20051499,28,58,44,46,21,197,不合格
20051500,58,50,81,54,82,325,合格
20051501,53,68,34,97,59,311,合格
20051502,76,52,10,52,62,252,不合格
20051503,49,99,53,23,14,238,不合格
20051504,20,74,47,32,16,189,不合格
20051505,36,34,34,48,47,199,不合格
20051506,32,59,5,57,46,199,不合格
20051507,37,31,94,91,3,256,不合格
20051508,63,10,8,6,87,174,不合格
20051509,89,84,96,37,24,330,合格
20051510,11,82,8,78,23,202,不合格
20051511,15,40,42,21,13,131,不合格
20051512,95,7,33,73,27,235,不合格
20051513,76,15,81,84,4,260,不合格
20051514,36,64,49,60,20,229,不合格
20051515,24,15,99,3,75,216,不合格
20051516,21,43,93,70,24,251,不合格
20051517,67,19,11,8,34,139,不合格
20051518,75,86,1,8,75,245,不合格
20051519,34,95,11,35,47,222,不合格
20051520,66,70,54,57,89,336,合格
20051521,14,64,45,89,51,263,不合格
20051522,20,64,5,72,15,176,不合格
20051523,6,77,64,16,81,244,不合格
20051524,23,69,46,10,20,168,不合格
20051525,13,2,21,65,25,126,不合格
20051526,68,11,13,35,61,188,不合格
20051527,64,94,53,80,68,359,合格
20051528,1,5,77,47,70,200,不合格
20051529,14,4,93,94,28,233,不合格
20051530,6,64,90,4,77,241,不合格
20051531,1,89,69,33,63,255,不合格
20051532,0,94,73,41,71,279,不合格
20051533,85,30,60,95,89,359,合格
20051534,31,68,83,9,36,227,不合格
20051535,50,1,62,84,32,229,不合格
20051536,34,19,64,17,44,178,不合格
20051537,72,85,66,56,56,335,合格
20051538,9,87,74,90,48,308,合格
20051539,18,12,9,70,35,144,不合格
20051540,93,99,65,94,81,432,合格
20051541,86,7,30,57,47,227,不合格
20051542,67,43,50,6,66,232,不合格
20051543,33,91,61,19,46,250,不合格
20051544,25,86,48,17,92,268,不合格
20051545,46,68,63,22,65,264,不合格
20051546,33,16,84,59,26,218,不合格
20051547,10,66,64,52,66,258,不合格
20051548,2,98,51,68,38,257,不合格
20051549,22,76,84,45,36,263,不合格
20051550,84,15,60,87,57,303,合格
20051551,95,66,33,98,61,353,合格
20051552,23,14,73,28,75,213,不合格
20051553,31,97,65,9,37,239,不合格
20051554,76,77,60,98,96,407,合格
20051555,30,57,83,81,5,256,不合格
20051556,67,53,38,49,42,249,不合格
20051557,16,81,11,86,71,265,不合格
20051558,38,15,43,71,89,256,不合格
20051559,33,7,37,10,57,144,不合格
20051560,83,96,45,51,76,351,合格
20051561,89,19,83,89,85,365,合格
20051562,27,67,57,17,67,235,不合格
20051563,72,68,52,11,46,249,不合格
20051564,75,64,30,46,13,228,不合格
20051565,93,45,12,69,0,219,不合格
20051566,68,36,63,42,20,229,不合格
20051567,39,97,17,45,88,286,不合格
20051568,13,82,62,71,39,267,不合格
20051569,97,11,60,11,25,204,不合格
20051570,10,99,63,73,63,308,合格
20051571,75,46,12,30,85,248,不合格
20051572,45,1,84,53,13,196,不合格
20051573,61,98,0,9,71,239,不合格
20051574,28,93,13,46,6,186,不合格
20051575,91,11,96,11,27,236,不合格
20051576,27,29,57,68,56,237,不合格
20051577,19,81,38,89,90,317,合格
20051578,53,34,15,28,42,172,不合格
20051579,74,37,7,64,23,205,不合格
20051580,3,12,83,90,32,220,不合格
20051581,66,68,58,41,63,296,不合格
20051582,20,97,7,52,78,254,不合格
20051583,85,62,33,58,26,264,不合格
20051584,40,57,21,50,0,168,不合格
20051585,46,91,97,22,67,323,合格
20051586,45,81,28,54,16,224,不合格
20051587,89,64,34,88,26,301,合格
20051588,92,41,67,37,98,335,合格
20051589,92,38,8,43,0,181,不合格
20051590,90,31,16,7,96,240,不合格
20051591,50,75,38,1,49,213,不合格
20051592,11,70,90,31,19,221,不合格
20051593,77,58,13,40,44,232,不合格
20051594,85,17,49,87,89,327,合格
20051595,97,86,57,58,23,321,合格
20051596,25,86,36,43,89,279,不合格
20051597,65,44,95,71,3,278,不合格
20051598,71,64,64,39,46,284,不合格
20051599,92,17,30,77,92,308,合格
20051600,68,89,22,71,86,336,合格
20051601,54,36,4,62,77,233,不合格
20051602,67,41,53,66,47,274,不合格
20051603,67,47,52,81,19,266,不合格
20051604,76,44,44,65,64,293,不合格
20051605,34,16,80,84,2,216,不合格
20051606,23,84,79,50,27,263,不合格
20051607,55,69,32,89,83,328,合格
20051608,10,52,20,91,43,216,不合格
20051609,97,35,21,47,22,222,不合格
20051610,80,11,84,90,41,306,合格
20051611,88,55,8,99,5,255,不合格
20051612,42,15,19,76,14,166,不合格
20051613,33,23,83,12,48,199,不合格
20051614,49,1,93,20,55,218,不合格
20051615,65,67,56,45,73,306,合格
20051616,25,36,98,60,98,317,合格
20051617,64,74,0,22,32,192,不合格
20051618,40,86,80,85,55,346,合格
20051619,35,90,65,90,53,333,合格
20051620,47,40,87,32,94,300,合格
20051621,19,29,98,76,70,292,不合格
20051622,4,2,28,72,9,115,不合格
20051623,21,18,71,98,56,264,不合格
20051624,87,32,76,3,45,243,不合格
20051625,54,23,21,8,91,197,不合格
20051626,97,14,81,24,50,266,不合格
20051627,85,61,39,77,30,292,不合格
20051628,13,42,9,58,73,195,不合格
20051629,21,26,53,7,45,152,不合格
20051630,89,65,83,24,18,279,不合格
20051631,35,71,35,76,55,272,不合格
20051632,74,4,14,54,84,230,不合格
20051633,70,17,73,3,90,253,不合格
20051634,31,47,0,82,79,239,不合格
20051635,30,56,50,66,96,298,不合格
20051636,30,82,17,32,14,175,不合格
20051637,42,70,98,75,85,370,合格
20051638,1,24,78,61,63,227,不合格
20051639,81,5,92,59,50,287,不合格
20051640,73,41,26,21,72,233,不合格
20051641,94,57,42,30,27,250,不合格
20051642,55,83,33,82,23,276,不合格
20051643,69,63,3,34,95,264,不合格
20051644,77,82,98,77,71,405,合格
20051645,68,61,92,26,15,262,不合格
20051646,55,74,48,75,48,300,合格
20051647,78,40,11,56,43,228,不合格
20051648,89,81,53,67,48,338,合格
20051649,95,24,74,46,84,323,合格
20051650,43,58,41,74,26,242,不合格
20051651,58,80,17,11,0,166,不合格
20051652,10,99,34,26,67,236,不合格
20051653,71,97,43,76,10,297,不合格
20051654,85,47,83,85,95,395,合格
20051655,28,44,2,52,95,221,不合格
20051656,57,90,24,73,18,262,不合格
20051657,30,29,28,41,5,133,不合格
20051658,93,28,49,37,71,278,不合格
20051659,11,87,41,44,47,230,不合格
20051660,71,65,88,58,18,300,合格
20051661,30,90,15,78,86,299,不合格
20051662,3,87,24,22,61,197,不合格
20051663,91,53,67,84,69,364,合格
20051664,4,97,13,28,56,198,不合格
20051665,25,18,98,89,19,249,不合格
20051666,67,37,53,83,78,318,合格
20051667,94,45,77,36,45,297,不合格
20051668,40,81,33,70,65,289,不合格
20051669,46,2,60,11,17,136,不合格
20051670,23,75,21,86,23,228,不合格
20051671,35,26,93,21,35,210,不合格
20051672,35,99,61,86,75,356,合格
20051673,85,76,56,36,4,257,不合格
20051674,39,30,72,42,49,232,不合格
20051675,10,83,64,75,5,237,不合格
20051676,86,62,98,50,86,382,合格
20051677,24,2,99,62,55,242,不合格
20051678,80,0,32,47,88,247,不合格
20051679,66,99,26,71,83,345,合格
20051680,7,71,62,27,50,217,不合格
20051681,78,10,90,56,67,301,合格
20051682,63,68,69,65,47,312,合格
20051683,24,78,8,2,11,123,不合格
20051684,56,46,77,67,83,329,合格
20051685,42,33,56,73,91,295,不合格
20051686,76,95,65,76,87,399,合格
20051687,33,12,47,39,88,219,不合格
20051688,21,47,1,77,79,225,不合格
20051689,9,13,3,67,69,161,不合格
20051690,58,57,30,9,41,195,不合格
20051691,64,57,77,31,11,240,不合格
20051692,33,91,10,9,4,147,不合格
20051693,85,52,87,78,4,306,合格
20051694,77,2,25,10,87,201,不合格
20051695,44,56,5,98,80,283,不合格
20051696,23,82,54,71,55,285,不合格
20051697,98,14,22,48,71,253,不合格
20051698,83,98,26,79,98,384,合格
20051699,38,67,50,58,80,293,不合格
20051700,88,14,10,96,75,283,不合格
20051701,3,38,18,54,22,135,不合格
20051702,73,84,47,50,88,342,合格
20051703,48,40,32,38,98,256,不合格
20051704,35,30,18,82,67,232,不合格
20051705,12,65,40,92,15,224,不合格
20051706,91,68,21,84,5,269,不合格
20051707,46,93,76,96,2,313,合格
20051708,1,9,73,18,22,123,不合格
20051709,99,96,20,88,22,325,合格
20051710,92,81,8,69,7,257,不合格
20051711,44,79,19,14,19,175,不合格
20051712,54,38,48,43,1,184,不合格
20051713,47,53,70,14,25,209,不合格
20051714,49,87,5,43,50,234,不合格
20051715,25,76,96,66,58,321,合格
20051716,52,3,29,70,38,192,不合格
20051717,24,53,65,59,79,280,不合格
20051718,57,10,1,44,32,144,不合格
20051719,9,42,35,20,97,203,不合格
20051720,63,67,45,96,20,291,不合格
20051721,19,40,67,8,7,141,不合格
20051722,19,5,37,85,19,165,不合格
20051723,58,63,35,28,32,216,不合格
20051724,35,44,53,85,54,271,不合格
20051725,35,34,43,8,20,140,不合格
20051726,61,43,87,49,66,306,合格
20051727,33,86,82,92,92,385,合格
20051728,99,62,3,6,25,195,不合格
20051729,49,68,5,99,34,255,不合格
20051730,86,20,37,62,70,275,不合格
20051731,3,4,5,60,79,151,不合格
20051732,5,77,2,50,50,184,不合格
20051733,72,16,36,75,32,231,不合格
20051734,11,39,72,44,73,239,不合格
20051735,47,46,77,89,54,313,合格
20051736,12,96,82,84,57,331,合格
20051737,11,0,87,72,8,178,不合格
20051738,97,55,49,87,22,310,合格
20051739,30,82,42,0,12,166,不合格
20051740,37,29,22,46,26,160,不合格
20051741,57,44,92,26,25,244,不合格
20051742,39,63,15,42,63,222,不合格
20051743,59,2,14,37,68,180,不合格
20051744,3,22,49,92,69,235,不合格
20051745,76,31,67,64,6,244,不合格
20051746,79,86,73,75,74,387,合格
20051747,62,71,1,31,58,223,不合格
20051748,84,68,57,22,44,275,不合格
20051749,20,39,19,17,46,141,不合格
20051750,22,63,61,48,14,208,不合格
20051751,33,14,32,7,75,161,不合格
20051752,6,32,82,42,61,223,不合格
20051753,91,99,51,92,54,387,合格
20051754,24,17,92,89,11,233,不合格
20051755,23,91,82,47,83,326,合格
20051756,26,43,58,22,74,223,不合格
20051757,85,66,47,28,69,295,不合格
20051758,2,82,73,9,73,239,不合格
20051759,56,60,75,77,91,359,合格
20051760,4,12,63,14,30,123,不合格
20051761,26,73,51,46,39,235,不合格
20051762,81,3,33,32,5,154,不合格
20051763,9,15,17,84,81,206,不合格
20051764,86,55,90,65,47,343,合格
20051765,10,68,23,75,78,254,不合格
20051766,30,74,45,86,11,246,不合格
20051767,92,95,16,34,25,262,不合格
20051768,44,91,34,77,59,305,合格
20051769,35,5,46,72,48,206,不合格
20051770,85,55,88,98,93,419,合格
20051771,92,84,46,10,66,298,不合格
20051772,7,81,92,91,63,334,合格
20051773,47,59,85,32,73,296,不合格
20051774,73,87,8,68,43,279,不合格
20051775,94,61,85,98,89,427,合格
20051776,63,43,44,57,70,277,不合格
20051777,73,23,84,81,3,264,不合格
20051778,23,40,64,96,39,262,不合格
20051779,12,82,56,28,35,213,不合格
20051780,31,9,24,72,4,140,不合格
20051781,79,39,14,87,79,298,不合格
20051782,81,1,23,14,27,146,不合格
20051783,34,78,30,93,38,273,不合格
20051784,54,49,28,87,68,286,不合格
20051785,15,3,31,85,32,166,不合格
20051786,46,32,31,41,92,242,不合格
20051787,58,39,19,20,3,139,不合格
20051788,29,23,12,82,79,225,不合格
20051789,22,54,15,18,34,143,不合格
20051790,27,56,16,84,3,186,不合格
20051791,37,11,96,15,40,199,不合格
20051792,69,97,72,61,90,389,合格
20051793,11,76,51,99,81,318,合格
20051794,67,69,6,64,84,290,不合格
20051795,35,28,53,98,68,282,不合格
20051796,25,5,62,14,52,158,不合格
20051797,77,12,29,74,97,289,不合格
20051798,17,54,70,1,45,187,不合格
20051799,91,32,58,52,28,261,不合格
20051800,99,44,87,23,24,277,不合格
20051801,76,33,21,55,59,244,不合格
20051802,86,47,82,23,54,292,不合格
20051803,43,23,65,29,19,179,不合格
20051804,84,41,68,54,86,333,合格
20051805,81,58,37,46,72,294,不合格
20051806,96,74,63,4,75,312,合格
20051807,27,58,93,20,90,288,不合格
20051808,54,92,12,78,33,269,不合格
20051809,93,33,69,23,66,284,不合格
20051810,87,54,32,8,58,239,不合格
20051811,22,95,1,44,10,172,不合格
20051812,2,1,14,3,31,51,不合格
20051813,59,62,99,17,42,279,不合格
20051814,69,9,62,78,80,298,不合格
20051815,2,28,26,82,85,223,不合格
20051816,10,85,92,39,72,298,不合格
20051817,1,48,86,77,98,310,合格
20051818,61,95,35,31,13,235,不合格
20051819,22,46,78,98,26,270,不合格
20051820,85,65,98,95,38,381,合格
20051821,30,98,14,32,12,186,不合格
20051822,83,5,41,96,91,316,合格
20051823,68,0,88,99,85,340,合格
20051824,85,45,3,2,70,205,不合格
20051825,77,11,97,19,65,269,不合格
20051826,32,59,82,70,69,312,合格
20051827,5,41,11,55,76,188,不合格
20051828,74,40,31,84,59,288,不合格
20051829,40,83,74,55,62,314,合格
20051830,96,92,82,55,40,365,合格
20051831,65,37,67,12,76,257,不合格
20051832,27,53,93,49,10,232,不合格
20051833,3,4,19,81,37,144,不合格
20051834,0,22,53,6,70,151,不合格
20051835,66,10,72,49,43,240,不合格
20051836,10,58,15,27,21,131,不合格
20051837,67,57,92,16,24,256,不合格
20051838,82,97,16,93,15,303,合格
20051839,29,67,65,19,37,217,不合格
20051840,75,65,94,74,8,316,合格
20051841,90,41,33,9,49,222,不合格
20051842,81,60,62,67,92,362,合格
20051843,80,83,11,92,73,339,合格
20051844,5,63,49,39,73,229,不合格
20051845,37,61,57,30,58,243,不合格
20051846,24,71,73,41,77,286,不合格
20051847,95,39,68,72,81,355,合格
20051848,95,40,20,49,33,237,不合格
20051849,23,57,11,57,25,173,不合格
20051850,69,39,90,47,12,257,不合格
20051851,35,37,0,8,5,85,不合格
20051852,49,94,18,73,73,307,合格
20051853,95,35,30,74,36,270,不合格
20051854,86,79,84,49,36,334,合格
20051855,28,99,7,45,52,231,不合格
20051856,39,29,33,94,69,264,不合格
20051857,91,95,35,37,86,344,合格
20051858,1,32,60,94,4,191,不合格
20051859,38,69,62,14,95,278,不合格
20051860,44,3,40,15,77,179,不合格
20051861,95,70,88,97,20,370,合格
20051862,34,66,71,74,70,315,合格
20051863,3,29,9,84,61,186,不合格
20051864,44,80,2,80,19,225,不合格
20051865,7,70,84,28,92,281,不合格
20051866,8,59,17,88,13,185,不合格
20051867,50,46,60,84,42,282,不合格
20051868,9,22,68,76,88,263,不合格
20051869,54,15,40,94,90,293,不合格
20051870,18,41,24,86,72,241,不合格
20051871,18,36,46,58,47,205,不合格
20051872,25,61,13,70,38,207,不合格
20051873,66,63,48,15,37,229,不合格
20051874,1,79,17,13,47,157,不合格
20051875,80,29,52,63,85,309,合格
20051876,87,58,1,37,54,237,不合格
20051877,66,30,85,55,81,317,合格
20051878,87,3,44,69,23,226,不合格
20051879,10,43,15,6,88,162,不合格
20051880,61,87,6,36,41,231,不合格
20051881,89,19,94,29,62,293,不合格
20051882,63,69,54,5,62,253,不合格
20051883,32,46,44,34,7,163,不合格
20051884,23,19,93,78,70,283,不合格
20051885,72,42,75,34,27,250,不合格
20051886,39,86,39,21,89,274,不合格
20051887,96,2,57,25,62,242,不合格
20051888,64,21,59,75,34,253,不合格
20051889,8,24,17,26,60,135,不合格
20051890,28,55,14,24,7,128,不合格
20051891,39,24,13,31,65,172,不合格
20051892,63,63,25,57,41,249,不合格
20051893,7,84,60,85,86,322,合格
20051894,28,80,42,82,41,273,不合格
20051895,48,0,40,19,70,177,不合格
20051896,54,16,97,13,84,264,不合格
20051897,32,64,30,47,41,214,不合格
20051898,1,41,81,59,25,207,不合格
20051899,5,75,79,70,32,261,不合格
20051900,80,43,6,43,88,260,不合格
20051901,50,97,46,32,70,295,不合格
20051902,12,42,90,22,17,183,不合格
20051903,47,69,71,34,52,273,不合格
20051904,52,78,34,60,20,244,不合格
20051905,87,35,56,30,86,294,不合格
20051906,44,99,21,64,81,309,合格
20051907,6,97,42,67,73,285,不合格
20051908,8,60,39,71,50,228,不合格
20051909,35,45,24,69,92,265,不合格
20051910,72,8,16,76,92,264,不合格
20051911,63,48,73,96,91,371,合格
20051912,29,28,48,62,13,180,不合格
20051913,28,91,62,28,62,271,不合格
20051914,28,11,3,58,16,116,不合格
20051915,17,53,75,52,74,271,不合格
20051916,24,0,22,64,43,153,不合格
20051917,3,18,77,99,13,210,不合格
20051918,32,4,22,53,65,176,不合格
20051919,61,76,67,62,52,318,合格
20051920,33,83,94,61,87,358,合格
20051921,51,56,91,32,21,251,不合格
20051922,4,21,45,18,44,132,不合格
20051923,69,33,96,94,70,362,合格
20051924,74,67,70,59,64,334,合格
20051925,41,91,77,51,8,268,不合格
20051926,18,2,95,96,91,302,合格
20051927,72,55,27,44,1,199,不合格
20051928,40,7,9,41,39,136,不合格
20051929,51,25,99,32,54,261,不合格
20051930,33,50,35,9,36,163,不合格
20051931,80,69,84,29,33,295,不合格
20051932,81,27,79,77,94,358,合格
20051933,16,10,76,43,65,210,不合格
20051934,86,44,41,76,91,338,合格
20051935,15,44,92,37,55,243,不合格
20051936,12,83,55,49,10,209,不合格
20051937,80,64,15,90,48,297,不合格
20051938,22,69,1,74,78,244,不合格
20051939,71,87,88,15,73,334,合格
20051940,12,32,63,45,58,210,不合格
20051941,34,34,2,25,11,106,不合格
20051942,89,7,71,50,69,286,不合格
20051943,93,62,88,47,74,364,合格
20051944,32,91,45,95,66,329,合格
20051945,34,38,18,65,91,246,不合格
20051946,72,92,38,8,84,294,不合格
20051947,97,13,27,35,10,182,不合格
20051948,2,28,8,1,18,57,不合格
20051949,19,18,17,15,12,81,不合格
20051950,25,88,11,6,77,207,不合格
20051951,94,1,47,16,54,212,不合格
20051952,83,71,11,46,19,230,不合格
20051953,31,5,73,87,72,268,不合格
20051954,62,73,64,86,81,366,合格
20051955,20,37,87,48,67,259,不合格
20051956,40,66,45,15,65,231,不合格
20051957,65,37,63,75,58,298,不合格
20051958,12,32,70,42,28,184,不合格
20051959,77,92,30,36,28,263,不合格
20051960,92,75,71,87,97,422,合格
20051961,66,15,36,69,81,267,不合格
20051962,66,1,31,87,31,216,不合格
20051963,96,3,68,87,63,317,合格
20051964,36,45,69,27,89,266,不合格
20051965,10,42,44,58,81,235,不合格
20051966,90,21,8,48,33,200,不合格
20051967,79,54,39,55,35,262,不合格
20051968,78,50,98,28,23,277,不合格
20051969,38,24,31,16,3,112,不合格
20051970,96,83,77,34,68,358,合格
20051971,92,61,84,66,13,316,合格
20051972,59,93,86,10,72,320,合格
20051973,53,47,47,17,85,249,不合格
20051974,51,94,89,40,22,296,不合格
20051975,28,72,8,62,91,261,不合格
20051976,86,74,76,68,88,392,合格
20051977,96,4,24,71,96,291,不合格
20051978,29,62,25,2,28,146,不合格
20051979,78,35,56,14,81,264,不合格
20051980,57,1,81,89,65,293,不合格
20051981,44,92,57,83,81,357,合格
20051982,35,44,93,4,51,227,不合格
20051983,69,99,32,70,58,328,合格
20051984,51,5,68,52,13,189,不合格
20051985,51,23,92,45,51,262,不合格
20051986,71,72,72,1,66,282,不合格
20051987,90,38,18,56,39,241,不合格
20051988,75,61,50,64,23,273,不合格
20051989,3,98,17,69,40,227,不合格
20051990,49,12,66,61,85,273,不合格
20051991,63,1,5,61,71,201,不合格
20051992,59,44,57,7,16,183,不合格
20051993,63,74,36,56,40,269,不合格
20051994,15,6,83,8,79,191,不合格
20051995,46,40,72,20,95,273,不合格
20051996,1,27,89,49,49,215,不合格
20051997,23,88,90,83,81,365,合格
20051998,26,30,91,51,37,235,不合格
20051999,42,59,93,8,35,237,不合格
20052000,0,61,39,61,33,194,不合格
20052001,42,54,56,29,69,250,不合格
20052002,44,13,25,24,23,129,不合格
20052003,30,16,10,63,51,170,不合格
20052004,94,67,56,15,72,304,合格
20052005,48,71,46,86,16,267,不合格
20052006,47,88,1,19,34,189,不合格
20052007,33,21,70,39,27,190,不合格
20052008,17,3,88,2,62,172,不合格
20052009,23,78,87,71,26,285,不合格
20052010,71,57,22,0,37,187,不合格
20052011,20,77,9,55,0,161,不合格
20052012,92,69,10,31,69,271,不合格
20052013,26,24,79,55,5,189,不合格
20052014,10,21,50,71,71,223,不合格
20052015,77,85,99,51,83,395,合格
20052016,89,34,50,45,24,242,不合格
20052017,59,22,69,66,76,292,不合格
20052018,55,4,4,22,64,149,不合格
20052019,46,76,88,16,93,319,合格
20052020,72,33,88,42,99,334,合格
20052021,66,62,80,34,35,277,不合格
20052022,84,10,55,91,55,295,不合格
20052023,61,18,46,47,54,226,不合格
20052024,49,91,48,53,79,320,合格
20052025,38,65,83,70,49,305,合格
20052026,6,79,67,90,69,311,合格
20052027,9,72,33,47,44,205,不合格
20052028,39,13,87,65,90,294,不合格
20052029,97,12,43,80,83,315,合格
20052030,28,84,81,43,10,246,不合格
20052031,33,58,24,94,24,233,不合格
20052032,43,5,13,56,21,138,不合格
20052033,5,94,47,32,26,204,不合格
20052034,40,79,71,31,95,316,合格
20052035,38,48,14,43,85,228,不合格
20052036,16,19,13,83,79,210,不合格
20052037,20,53,39,58,42,212,不合格
20052038,88,6,85,81,44,304,合格
20052039,58,55,88,21,73,295,不合格
20052040,76,64,13,64,64,281,不合格
20052041,45,47,40,14,32,178,不合格
20052042,78,0,62,91,29,260,不合格
20052043,8,35,0,49,74,166,不合格
20052044,36,57,1,43,85,222,不合格
20052045,5,11,39,34,60,149,不合格
20052046,17,20,49,88,58,232,不合格
20052047,67,81,88,82,84,402,合格
20052048,48,19,79,12,86,244,不合格
20052049,31,98,51,50,72,302,合格
20052050,50,68,95,45,63,321,合格
20052051,35,16,47,87,28,213,不合格
20052052,52,22,64,2,53,193,不合格
20052053,81,44,33,86,51,295,不合格
20052054,82,7,45,3,73,210,不合格
20052055,74,66,30,31,83,284,不合格
20052056,43,68,78,42,68,299,不合格
20052057,98,53,0,64,55,270,不合格
20052058,4,87,5,39,73,208,不合格
20052059,91,21,83,33,64,292,不合格
20052060,64,54,81,47,10,256,不合格
20052061,70,76,83,28,9,266,不合格
20052062,93,43,38,51,53,278,不合格
20052063,65,41,0,6,32,144,不合格
20052064,21,27,95,74,18,235,不合格
20052065,51,14,49,2,71,187,不合格
20052066,6,22,29,66,49,172,不合格
20052067,42,31,8,39,13,133,不合格
20052068,57,59,35,9,68,228,不合格
20052069,89,84,23,12,26,234,不合格
20052070,30,2,68,61,99,260,不合格
20052071,41,60,98,34,24,257,不合格
20052072,75,9,62,57,15,218,不合格
20052073,67,15,87,46,44,259,不合格
20052074,70,23,61,73,88,315,合格
20052075,74,52,40,68,86,320,合格
20052076,47,37,9,81,37,211,不合格
20052077,34,68,92,70,95,359,合格
20052078,63,78,15,9,90,255,不合格
20052079,82,68,56,55,65,326,合格
20052080,70,26,97,47,61,301,合格
20052081,49,43,6,49,73,220,不合格
20052082,61,29,87,12,77,266,不合格
20052083,98,29,10,87,30,254,不合格
20052084,29,29,82,62,76,278,不合格
20052085,39,57,90,31,30,247,不合格
20052086,70,87,79,54,82,372,合格
20052087,53,68,40,4,91,256,不合格
20052088,0,26,98,71,63,258,不合格
20052089,60,23,54,91,79,307,合格
20052090,86,91,56,2,35,270,不合格
20052091,83,19,10,22,18,152,不合格
20052092,75,98,23,9,45,250,不合格
20052093,41,32,98,55,89,315,合格
20052094,42,8,41,91,45,227,不合格
20052095,95,24,35,34,95,283,不合格
20052096,68,37,38,61,39,243,不合格
20052097,35,92,47,34,68,276,不合格
20052098,53,86,1,85,54,279,不合格
20052099,23,65,72,49,23,232,不合格
20052100,39,71,8,71,18,207,不合格
20052101,29,82,6,29,22,168,不合格
20052102,3,5,19,13,94,134,不合格
20052103,79,12,72,34,71,268,不合格
20052104,52,92,28,29,2,203,不合格
20052105,2,56,95,30,35,218,不合格
20052106,23,68,76,6,47,220,不合格
20052107,3,70,14,55,21,163,不合格
20052108,50,72,32,73,1,228,不合格
20052109,43,20,63,53,41,220,不合格
20052110,3,87,16,14,40,160,不合格
20052111,59,41,63,72,2,237,不合格
20052112,48,95,3,97,53,296,不合格
20052113,2,91,63,23,45,224,不合格
20052114,78,15,93,97,25,308,合格
20052115,89,36,4,83,69,281,不合格
20052116,18,2,7,50,5,82,不合格
20052117,17,75,52,94,11,249,不合格
20052118,68,42,64,2,49,225,不合格
20052119,35,25,8,66,99,233,不合格
20052120,62,42,61,14,96,275,不合格
20052121,45,46,28,24,82,225,不合格
20052122,24,84,54,95,82,339,合格
20052123,43,31,60,86,87,307,合格
20052124,27,98,96,44,62,327,合格
20052125,46,58,56,76,0,236,不合格
20052126,15,85,62,5,54,221,不合格
20052127,72,99,9,74,55,309,合格
20052128,45,73,49,95,35,297,不合格
20052129,58,93,97,54,88,390,合格
20052130,72,49,81,44,92,338,合格
20052131,89,87,28,53,93,350,合格
20052132,63,83,86,66,74,372,合格
20052133,94,96,96,70,70,426,合格
20052134,98,49,93,51,25,316,合格
20052135,60,41,15,78,97,291,不合格
20052136,79,73,98,25,67,342,合格
20052137,75,2,55,87,93,312,合格
20052138,40,78,88,67,49,322,合格
20052139,97,89,62,84,67,399,合格
20052140,83,79,75,56,58,351,合格
20052141,69,76,35,82,32,294,不合格
20052142,50,55,37,62,92,296,不合格
20052143,11,92,69,20,17,209,不合格
20052144,63,76,68,18,16,241,不合格
20052145,80,22,81,9,26,218,不合格
20052146,39,94,29,1,46,209,不合格
20052147,6,25,26,46,84,187,不合格
20052148,14,59,99,93,33,298,不合格
20052149,70,62,16,77,57,282,不合格
20052150,71,26,36,20,38,191,不合格
20052151,21,37,64,1,93,216,不合格
20052152,95,20,51,39,19,224,不合格
20052153,99,31,75,94,20,319,合格
20052154,81,93,98,6,98,376,合格
20052155,99,45,75,82,41,342,合格
20052156,39,97,74,68,79,357,合格
20052157,96,35,4,50,39,224,不合格
20052158,20,65,53,4,77,219,不合格
20052159,38,66,34,87,66,291,不合格
20052160,26,14,16,27,67,150,不合格
20052161,1,37,17,78,36,169,不合格
20052162,20,24,66,8,48,166,不合格
20052163,92,15,23,58,77,265,不合格
20052164,16,89,93,39,49,286,不合格
20052165,16,95,78,31,9,229,不合格
20052166,5,82,72,57,66,282,不合格
20052167,66,65,68,28,30,257,不合格
20052168,81,84,94,60,46,365,合格
20052169,68,39,8,94,50,259,不合格
20052170,46,85,84,11,18,244,不合格
20052171,71,29,47,36,6,189,不合格
20052172,8,21,11,80,93,213,不合格
20052173,18,40,83,75,40,256,不合格
20052174,65,40,56,12,42,215,不合格
20052175,6,9,7,39,61,122,不合格
20052176,92,59,90,11,23,275,不合格
20052177,66,34,55,11,8,174,不合格
20052178,89,81,60,63,68,361,合格
20052179,20,38,91,51,38,238,不合格
20052180,9,74,31,82,26,222,不合格
20052181,99,22,4,66,99,290,不合格
20052182,15,84,66,33,41,239,不合格
20052183,11,90,32,99,21,253,不合格
20052184,8,31,54,95,52,240,不合格
20052185,76,71,7,23,75,252,不合格
20052186,64,34,34,77,21,230,不合格
20052187,94,88,92,57,16,347,合格
20052188,74,71,39,37,57,278,不合格
20052189,46,13,6,99,92,256,不合格
20052190,14,51,33,98,36,232,不合格
20052191,44,53,21,40,7,165,不合格
20052192,89,53,43,77,10,272,不合格
20052193,86,72,53,22,51,284,不合格
20052194,7,0,66,22,92,187,不合格
20052195,0,56,62,18,5,141,不合格
20052196,83,80,36,25,68,292,不合格
20052197,29,96,5,94,98,322,合格
20052198,67,88,30,73,45,303,合格
20052199,2,38,28,0,2,70,不合格
20052200,83,10,36,9,68,206,不合格
20052201,67,35,71,39,75,287,不合格
20052202,38,48,75,15,34,210,不合格
20052203,65,76,59,48,94,342,合格
20052204,12,73,14,59,27,185,不合格
20052205,17,42,86,36,74,255,不合格
20052206,65,88,11,45,60,269,不合格
20052207,33,41,65,81,95,315,合格
20052208,36,35,97,38,45,251,不合格
20052209,74,34,25,19,82,234,不合格
20052210,77,58,92,76,68,371,合格
20052211,48,57,75,27,2,209,不合格
20052212,24,42,32,43,25,166,不合格
20052213,12,34,1,19,34,100,不合格
20052214,7,70,77,55,26,235,不合格
20052215,74,73,35,13,50,245,不合格
20052216,48,46,80,17,12,203,不合格
20052217,57,89,37,11,80,274,不合格
20052218,75,0,2,61,0,138,不合格
20052219,74,48,29,43,80,274,不合格
20052220,48,65,42,53,36,244,不合格
20052221,71,16,42,91,41,261,不合格
20052222,36,92,88,26,67,309,合格
20052223,81,82,2,60,32,257,不合格
20052224,4,87,12,10,40,153,不合格
20052225,70,0,37,91,31,229,不合格
20052226,87,99,95,12,29,322,合格
20052227,91,4,45,77,68,285,不合格
20052228,86,27,77,64,36,290,不合格
20052229,30,53,12,47,33,175,不合格
20052230,56,61,57,40,12,226,不合格
20052231,59,83,81,10,50,283,不合格
20052232,29,3,62,51,15,160,不合格
20052233,61,61,32,3,54,211,不合格
20052234,46,27,93,15,76,257,不合格
20052235,53,28,68,23,23,195,不合格
20052236,49,68,73,9,52,251,不合格
20052237,27,47,45,36,56,211,不合格
20052238,54,35,49,14,91,243,不合格
20052239,33,61,5,49,31,179,不合格
20052240,23,62,64,1,53,203,不合格
20052241,84,54,92,50,79,359,合格
20052242,31,4,68,60,0,163,不合格
20052243,72,10,86,93,18,279,不合格
20052244,37,2,75,51,84,249,不合格
20052245,38,78,0,52,9,177,不合格
20052246,23,46,46,73,59,247,不合格
20052247,27,26,18,50,1,122,不合格
20052248,97,23,31,57,6,214,不合格
20052249,54,30,91,86,0,261,不合格
20052250,13,88,36,90,43,270,不合格
20052251,15,63,76,94,80,328,合格
20052252,55,81,4,48,44,232,不合格
20052253,18,5,89,50,87,249,不合格
20052254,27,0,20,89,73,209,不合格
20052255,15,7,46,7,47,122,不合格
20052256,49,89,73,91,99,401,合格
20052257,84,97,5,95,13,294,不合格
20052258,90,49,84,52,78,353,合格
20052259,75,7,43,0,18,143,不合格
20052260,11,16,98,41,13,179,不合格
20052261,50,77,82,67,62,338,合格
20052262,62,62,56,14,99,293,不合格
20052263,30,79,78,79,98,364,合格
20052264,52,98,57,68,20,295,不合格
20052265,25,84,27,32,30,198,不合格
20052266,43,39,97,73,79,331,合格
20052267,45,23,19,58,17,162,不合格
20052268,36,9,98,26,92,261,不合格
20052269,19,13,95,18,83,228,不合格
20052270,46,61,12,6,60,185,不合格
20052271,63,26,85,77,48,299,不合格
20052272,32,74,61,86,11,264,不合格
20052273,21,73,75,42,80,291,不合格
20052274,5,90,96,7,96,294,不合格
20052275,93,94,4,99,57,347,合格
20052276,40,62,19,19,86,226,不合格
20052277,96,77,96,6,96,371,合格
20052278,11,44,6,54,84,199,不合格
20052279,73,27,88,10,76,274,不合格
20052280,59,98,91,76,27,351,合格
20052281,46,19,77,21,54,217,不合格
20052282,59,60,27,47,56,249,不合格
20052283,11,2,9,90,34,146,不合格
20052284,89,66,81,6,32,274,不合格
20052285,66,42,50,26,51,235,不合格
20052286,18,87,9,4,11,129,不合格
20052287,43,53,58,18,9,181,不合格
20052288,68,41,32,46,46,233,不合格
20052289,46,72,77,83,79,357,合格
20052290,37,0,36,19,38,130,不合格
20052291,49,42,93,56,55,295,不合格
20052292,51,85,66,87,70,359,合格
20052293,99,57,89,73,5,323,合格
20052294,78,20,81,37,74,290,不合格
20052295,73,65,11,41,32,222,不合格
20052296,9,83,66,62,23,243,不合格
20052297,54,98,76,2,29,259,不合格
20052298,97,71,36,66,93,363,合格
20052299,35,37,26,89,79,266,不合格
20052300,79,11,12,52,68,222,不合格
20052301,48,39,24,53,45,209,不合格
20052302,22,35,57,18,62,194,不合格
20052303,9,31,3,12,51,106,不合格
20052304,10,34,60,28,71,203,不合格
20052305,35,93,72,67,9,276,不合格
20052306,3,10,7,30,22,72,不合格
20052307,39,38,9,59,75,220,不合格
20052308,45,66,30,57,85,283,不合格
20052309,59,62,39,74,31,265,不合格
20052310,38,48,88,94,28,296,不合格
20052311,94,63,35,24,53,269,不合格
20052312,49,86,62,15,40,252,不合格
20052313,72,15,53,33,43,216,不合格
20052314,69,25,44,22,35,195,不合格
20052315,49,34,86,74,28,271,不合格
20052316,60,9,71,73,49,262,不合格
20052317,42,46,12,7,51,158,不合格
20052318,46,75,69,68,70,328,合格
20052319,73,85,83,13,72,326,合格
20052320,40,64,26,9,72,211,不合格
20052321,76,87,28,38,74,303,合格
20052322,12,56,90,86,78,322,合格
20052323,71,22,0,8,47,148,不合格
20052324,75,90,49,26,86,326,合格
20052325,41,78,78,85,29,311,合格
20052326,14,75,74,20,98,281,不合格
20052327,86,52,55,46,50,289,不合格
20052328,37,41,49,35,96,258,不合格
20052329,67,1,81,21,88,258,不合格
20052330,6,86,16,86,26,220,不合格
20052331,9,16,27,52,25,129,不合格
20052332,13,45,31,56,9,154,不合格
20052333,56,84,23,34,3,200,不合格
20052334,81,67,25,89,8,270,不合格
20052335,18,91,87,16,73,285,不合格
20052336,98,36,93,43,11,281,不合格
20052337,42,22,31,25,20,140,不合格
20052338,38,54,86,27,90,295,不合格
20052339,54,40,69,10,56,229,不合格
20052340,66,69,73,71,76,355,合格
20052341,16,23,99,62,18,218,不合格
20052342,89,82,76,4,27,278,不合格
20052343,29,99,98,85,82,393,合格
20052344,2,50,10,73,23,158,不合格
20052345,1,7,85,51,93,237,不合格
20052346,6,15,18,63,35,137,不合格
20052347,6,91,64,85,68,314,合格
20052348,42,62,22,4,42,172,不合格
20052349,21,40,84,23,3,171,不合格
20052350,53,73,59,5,82,272,不合格
20052351,52,41,90,6,39,228,不合格
20052352,51,70,44,59,65,289,不合格
20052353,38,38,41,27,48,192,不合格
20052354,68,22,22,35,4,151,不合格
20052355,11,51,93,84,36,275,不合格
20052356,65,22,56,99,55,297,不合格
20052357,97,95,26,75,47,340,合格
20052358,22,33,81,7,72,215,不合格
20052359,10,43,58,56,6,173,不合格
20052360,69,69,92,47,85,362,合格
20052361,8,27,36,92,65,228,不合格
20052362,41,86,62,89,35,313,合格
20052363,99,45,86,20,33,283,不合格
20052364,88,83,5,11,0,187,不合格
20052365,50,14,23,76,1,164,不合格
20052366,44,51,45,68,85,293,不合格
20052367,74,25,21,69,27,216,不合格
20052368,33,93,66,38,16,246,不合格
20052369,63,27,41,90,89,310,合格
20052370,53,90,6,52,78,279,不合格
20052371,65,8,93,14,30,210,不合格
20052372,24,49,31,50,15,169,不合格
20052373,83,8,81,88,68,328,合格
20052374,75,82,9,2,68,236,不合格
20052375,80,79,94,77,87,417,合格
20052376,70,56,70,68,96,360,合格
20052377,60,52,92,55,5,264,不合格
20052378,29,89,31,74,80,303,合格
20052379,9,43,18,67,19,156,不合格
20052380,18,16,85,63,48,230,不合格
20052381,92,41,15,65,36,249,不合格
20052382,42,18,70,84,37,251,不合格
20052383,83,56,91,16,34,280,不合格
20052384,16,20,68,18,2,124,不合格
20052385,21,35,80,57,63,256,不合格
20052386,7,97,27,91,10,232,不合格
20052387,72,23,95,58,39,287,不合格
20052388,19,68,85,56,89,317,合格
20052389,34,60,70,24,36,224,不合格
20052390,6,30,29,21,21,107,不合格
20052391,81,82,76,38,41,318,合格
20052392,42,41,57,44,41,225,不合格
20052393,66,94,62,9,15,246,不合格
20052394,41,70,75,31,69,286,不合格
20052395,51,8,66,55,87,267,不合格
20052396,75,75,68,11,47,276,不合格
20052397,70,32,19,73,37,231,不合格
20052398,68,2,0,87,0,157,不合格
20052399,85,25,23,41,15,189,不合格
20052400,45,33,93,11,99,281,不合格
20052401,24,90,85,92,46,337,合格
20052402,55,47,82,38,33,255,不合格
20052403,43,11,95,18,95,262,不合格
20052404,50,84,91,33,60,318,合格
20052405,38,65,12,10,2,127,不合格
20052406,29,25,77,89,22,242,不合格
20052407,45,51,42,18,72,228,不合格
20052408,42,13,64,18,71,208,不合格
20052409,93,80,36,19,94,322,合格
20052410,27,3,82,73,93,278,不合格
20052411,27,8,38,92,37,202,不合格
20052412,25,70,92,81,23,291,不合格
20052413,93,67,79,93,3,335,合格
20052414,34,69,92,21,58,274,不合格
20052415,10,27,89,42,63,231,不合格
20052416,71,90,86,80,51,378,合格
20052417,15,25,9,75,68,192,不合格
20052418,93,51,97,37,31,309,合格
20052419,27,89,47,50,20,233,不合格
20052420,63,98,11,77,53,302,合格
20052421,10,17,83,80,0,190,不合格
20052422,20,7,21,24,36,108,不合格
20052423,33,3,85,26,4,151,不合格
20052424,25,94,86,94,68,367,合格
20052425,88,72,6,11,6,183,不合格
20052426,8,37,62,52,94,253,不合格
20052427,52,70,94,65,6,287,不合格
20052428,81,69,4,84,96,334,合格
20052429,69,98,29,75,25,296,不合格
20052430,27,18,52,33,68,198,不合格
20052431,18,67,34,66,53,238,不合格
20052432,20,74,83,14,56,247,不合格
20052433,22,98,98,91,82,391,合格
20052434,64,34,17,59,27,201,不合格
20052435,7,99,41,20,61,228,不合格
20052436,40,8,15,11,66,140,不合格
20052437,83,43,83,97,50,356,合格
20052438,5,30,2,31,16,84,不合格
20052439,62,37,85,55,31,270,不合格
20052440,79,64,19,3,45,210,不合格
20052441,85,62,50,97,65,359,合格
20052442,32,51,79,90,20,272,不合格
20052443,24,0,78,86,37,225,不合格
20052444,39,55,87,65,56,302,合格
20052445,36,82,75,49,97,339,合格
20052446,4,33,96,58,65,256,不合格
20052447,51,94,23,72,37,277,不合格
20052448,77,6,98,4,64,249,不合格
20052449,50,17,40,64,72,243,不合格
20052450,52,21,55,15,23,166,不合格
20052451,57,60,57,19,43,236,不合格
20052452,87,27,79,65,66,324,合格
20052453,18,63,49,8,61,199,不合格
20052454,87,29,23,28,48,215,不合格
20052455,2,48,33,20,56,159,不合格
20052456,19,17,26,88,96,246,不合格
20052457,32,74,67,76,41,290,不合格
20052458,57,89,78,71,9,304,合格
20052459,78,54,22,25,69,248,不合格
20052460,46,41,59,49,36,231,不合格
20052461,76,42,79,32,95,324,合格
20052462,95,11,38,33,62,239,不合格
20052463,29,51,41,79,13,213,不合格
20052464,14,68,55,0,6,143,不合格
20052465,48,61,30,77,48,264,不合格
20052466,73,54,45,18,75,265,不合格
20052467,84,31,74,44,50,283,不合格
20052468,1,64,68,55,17,205,不合格
20052469,58,35,31,34,23,181,不合格
20052470,7,68,88,67,41,271,不合格
20052471,15,20,55,79,58,227,不合格
20052472,78,57,13,28,58,234,不合格
20052473,83,95,53,85,54,370,合格
20052474,24,15,26,43,15,123,不合格
20052475,15,85,42,74,24,240,不合格
20052476,20,85,37,84,99,325,合格
20052477,86,3,58,43,86,276,不合格
20052478,72,92,6,75,61,306,合格
20052479,91,92,85,85,53,406,合格
20052480,63,22,75,94,43,297,不合格
20052481,30,73,16,95,47,261,不合格
20052482,89,72,55,84,58,358,合格
20052483,52,86,40,27,14,219,不合格
20052484,83,56,93,2,32,266,不合格
20052485,24,66,26,43,68,227,不合格
20052486,86,61,45,45,77,314,合格
20052487,3,81,4,63,30,181,不合格
20052488,59,36,48,61,81,285,不合格
20052489,9,11,29,92,38,179,不合格
20052490,63,71,77,37,4,252,不合格
20052491,71,51,39,2,36,199,不合格
20052492,23,76,66,20,94,279,不合格
20052493,84,97,85,76,30,372,合格
20052494,52,65,23,75,88,303,合格
20052495,74,15,66,25,19,199,不合格
20052496,84,28,4,79,98,293,不合格
20052497,26,47,68,22,95,258,不合格
20052498,65,64,74,69,34,306,合格
20052499,58,88,18,76,8,248,不合格
20052500,8,76,43,33,18,178,不合格
20052501,67,25,65,8,83,248,不合格
20052502,93,56,78,68,41,336,合格
20052503,49,51,89,49,62,300,合格
20052504,31,30,86,36,43,226,不合格
20052505,60,77,88,45,97,367,合格
20052506,83,22,44,4,43,196,不合格
20052507,49,50,20,20,11,150,不合格
20052508,65,10,16,61,14,166,不合格
20052509,80,16,64,25,96,281,不合格
20052510,81,75,26,33,59,274,不合格
20052511,67,33,97,50,78,325,合格
20052512,50,48,75,52,74,299,不合格
20052513,69,11,4,24,83,191,不合格
20052514,8,57,51,65,40,221,不合格
20052515,85,27,39,66,92,309,合格
20052516,9,46,84,36,4,179,不合格
20052517,81,46,98,6,14,245,不合格
20052518,1,81,80,96,35,293,不合格
20052519,84,64,5,33,88,274,不合格
20052520,37,56,56,70,20,239,不合格
20052521,16,67,99,64,46,292,不合格
20052522,68,28,57,87,14,254,不合格
20052523,91,17,60,49,4,221,不合格
20052524,75,45,21,44,95,280,不合格
20052525,84,82,53,96,9,324,合格
20052526,85,43,27,83,63,301,合格
20052527,35,56,0,33,86,210,不合格
20052528,2,20,75,88,41,226,不合格
20052529,1,56,55,0,6,118,不合格
20052530,80,41,19,74,94,308,合格
20052531,46,87,73,7,84,297,不合格
20052532,19,43,0,24,95,181,不合格
20052533,71,2,91,36,22,222,不合格
20052534,16,65,10,17,52,160,不合格
20052535,66,59,58,83,76,342,合格
20052536,34,21,71,61,6,193,不合格
20052537,39,12,81,79,22,233,不合格
20052538,98,75,36,38,84,331,合格
20052539,90,0,14,29,20,153,不合格
20052540,3,98,43,20,49,213,不合格
20052541,71,61,82,3,28,245,不合格
20052542,63,30,17,70,28,208,不合格
20052543,24,57,25,72,45,223,不合格
20052544,51,35,21,87,30,224,不合格
20052545,92,2,54,66,6,220,不合格
20052546,69,11,95,29,22,226,不合格
20052547,95,38,39,40,55,267,不合格
20052548,33,7,85,23,49,197,不合格
20052549,19,42,25,15,98,199,不合格
20052550,99,12,31,9,69,220,不合格
20052551,26,99,28,49,95,297,不合格
20052552,66,64,13,95,32,270,不合格
20052553,2,20,59,82,23,186,不合格
20052554,79,7,73,32,63,254,不合格
20052555,56,63,52,77,76,324,合格
20052556,0,11,66,49,31,157,不合格
20052557,79,98,21,75,47,320,合格
20052558,82,25,81,14,75,277,不合格
20052559,47,57,86,62,77,329,合格
20052560,76,49,65,80,29,299,不合格
20052561,70,7,73,74,35,259,不合格
20052562,34,92,52,45,77,300,合格
20052563,72,75,35,55,13,250,不合格
20052564,73,30,38,57,42,240,不合格
20052565,34,61,38,74,12,219,不合格
20052566,88,50,58,4,42,242,不合格
20052567,69,33,17,31,75,225,不合格
20052568,13,4,4,87,38,146,不合格
20052569,51,61,28,30,51,221,不合格
20052570,34,64,31,8,52,189,不合格
20052571,98,97,8,2,21,226,不合格
20052572,25,15,17,59,46,162,不合格
20052573,50,66,14,55,90,275,不合格
20052574,28,75,36,39,83,261,不合格
20052575,28,92,5,69,35,229,不合格
20052576,34,35,74,55,28,226,不合格
20052577,3,68,67,19,82,239,不合格
20052578,84,55,47,56,72,314,合格
20052579,42,73,48,32,54,249,不合格
20052580,36,80,64,3,23,206,不合格
20052581,51,36,25,12,34,158,不合格
20052582,6,17,29,92,50,194,不合格
20052583,68,88,75,59,79,369,合格
20052584,39,52,96,22,4,213,不合格
20052585,86,96,70,43,79,374,合格
20052586,67,50,21,41,94,273,不合格
20052587,15,19,41,86,44,205,不合格
20052588,1,16,93,59,68,237,不合格
20052589,60,13,53,25,24,175,不合格
20052590,65,15,24,17,24,145,不合格
20052591,71,31,51,56,0,209,不合格
20052592,82,5,25,34,48,194,不合格
20052593,97,38,39,71,4,249,不合格
20052594,53,12,86,57,20,228,不合格
20052595,87,39,57,45,49,277,不合格
20052596,64,80,62,49,1,256,不合格
20052597,91,12,25,38,36,202,不合格
20052598,56,89,7,53,27,232,不合格
20052599,17,0,50,27,99,193,不合格
20052600,32,97,47,63,70,309,合格
20052601,16,17,73,24,5,135,不合格
20052602,66,0,23,12,47,148,不合格
20052603,65,37,81,86,25,294,不合格
20052604,17,65,76,73,0,231,不合格
20052605,82,36,30,50,82,280,不合格
20052606,7,18,17,35,90,167,不合格
20052607,42,28,81,16,14,181,不合格
20052608,68,53,41,96,12,270,不合格
20052609,24,54,48,38,4,168,不合格
20052610,7,11,75,28,71,192,不合格
20052611,76,90,88,52,4,310,合格
20052612,70,99,92,84,65,410,合格
20052613,89,81,90,81,21,362,合格
20052614,66,93,19,52,57,287,不合格
20052615,84,32,19,43,15,193,不合格
20052616,93,3,20,54,14,184,不合格
20052617,80,97,69,61,6,313,合格
20052618,92,52,53,29,51,277,不合格
20052619,72,72,58,98,24,324,合格
20052620,26,86,73,6,59,250,不合格
20052621,65,30,26,53,24,198,不合格
20052622,26,73,84,47,68,298,不合格
20052623,96,85,34,40,33,288,不合格
20052624,2,99,90,95,46,332,合格
20052625,74,1,87,16,5,183,不合格
20052626,37,60,67,94,82,340,合格
20052627,6,67,83,22,34,212,不合格
20052628,0,55,99,67,69,290,不合格
20052629,19,85,35,36,38,213,不合格
20052630,88,69,96,30,46,329,合格
20052631,86,0,30,9,24,149,不合格
20052632,10,82,59,29,37,217,不合格
20052633,67,70,86,53,65,341,合格
20052634,90,47,7,74,23,241,不合格
20052635,41,44,80,33,35,233,不合格
20052636,8,79,48,68,60,263,不合格
20052637,57,39,46,50,88,280,不合格
20052638,94,30,7,13,22,166,不合格
20052639,79,21,32,46,63,241,不合格
20052640,95,43,90,3,81,312,合格
20052641,24,65,20,0,12,121,不合格
20052642,80,48,31,88,59,306,合格
20052643,49,68,14,10,70,211,不合格
20052644,15,45,14,37,80,191,不合格
20052645,35,37,65,90,44,271,不合格
20052646,28,10,41,60,83,222,不合格
20052647,77,47,78,96,49,347,合格
20052648,71,12,70,99,63,315,合格
20052649,79,60,92,43,22,296,不合格
20052650,48,8,82,93,48,279,不合格
20052651,70,23,21,1,49,164,不合格
20052652,68,98,43,71,74,354,合格
20052653,18,50,82,66,77,293,不合格
20052654,61,61,62,55,60,299,不合格
20052655,1,39,18,98,55,211,不合格
20052656,44,77,87,30,99,337,合格
20052657,60,19,52,51,75,257,不合格
20052658,61,11,0,59,76,207,不合格
20052659,48,46,67,31,60,252,不合格
20052660,5,20,29,28,66,148,不合格
20052661,8,37,90,6,2,143,不合格
20052662,40,47,43,36,2,168,不合格
20052663,80,28,80,65,93,346,合格
20052664,47,12,3,92,55,209,不合格
20052665,51,56,12,60,54,233,不合格
20052666,84,51,90,88,34,347,合格
20052667,77,41,42,71,24,255,不合格
20052668,24,95,8,64,89,280,不合格
20052669,87,83,7,51,47,275,不合格
20052670,93,4,26,36,87,246,不合格
20052671,28,89,48,81,17,263,不合格
20052672,1,63,52,64,36,216,不合格
20052673,12,34,22,50,45,163,不合格
20052674,80,46,31,44,67,268,不合格
20052675,36,4,78,88,51,257,不合格
20052676,18,34,28,14,12,106,不合格
20052677,77,6,86,42,95,306,合格
20052678,44,89,45,41,78,297,不合格
20052679,70,71,23,56,67,287,不合格
20052680,97,87,16,73,42,315,合格
20052681,87,71,18,70,17,263,不合格
20052682,30,86,77,48,54,295,不合格
20052683,84,97,7,46,56,290,不合格
20052684,40,69,89,26,40,264,不合格
20052685,41,73,58,85,88,345,合格
20052686,47,63,61,83,18,272,不合格
20052687,64,47,65,35,87,298,不合格
20052688,40,1,79,39,59,218,不合格
20052689,86,14,48,42,0,190,不合格
20052690,7,95,74,73,50,299,不合格
20052691,56,11,14,19,31,131,不合格
20052692,86,45,64,63,5,263,不合格
20052693,95,46,61,73,64,339,合格
20052694,23,90,9,28,14,164,不合格
20052695,82,32,62,20,71,267,不合格
20052696,35,53,72,62,65,287,不合格
20052697,87,15,97,96,90,385,合格
20052698,36,9,50,98,56,249,不合格
20052699,62,16,56,5,77,216,不合格
20052700,2,10,0,35,86,133,不合格
20052701,9,55,37,44,9,154,不合格
20052702,16,73,36,83,14,222,不合格
20052703,14,86,57,55,63,275,不合格
20052704,89,38,26,63,47,263,不合格
20052705,47,58,35,24,29,193,不合格
20052706,32,49,91,36,53,261,不合格
20052707,97,99,44,80,40,360,合格
20052708,58,44,28,91,65,286,不合格
20052709,82,90,43,9,59,283,不合格
20052710,1,69,48,51,60,229,不合格
20052711,64,76,56,12,44,252,不合格
20052712,14,42,27,43,61,187,不合格
20052713,29,96,32,75,34,266,不合格
20052714,18,36,20,16,78,168,不合格
20052715,87,36,63,89,19,294,不合格
20052716,47,75,3,11,87,223,不合格
20052717,7,38,9,19,8,81,不合格
20052718,73,49,60,93,91,366,合格
20052719,80,8,50,93,62,293,不合格
20052720,16,32,63,47,65,223,不合格
20052721,8,82,35,0,19,144,不合格
20052722,2,92,49,84,37,264,不合格
20052723,48,44,78,48,65,283,不合格
20052724,43,65,88,8,95,299,不合格
20052725,79,79,89,0,47,294,不合格
20052726,27,73,10,65,44,219,不合格
20052727,84,26,35,15,44,204,不合格
20052728,79,46,0,55,76,256,不合格
20052729,55,85,89,83,99,411,合格
20052730,90,8,63,50,56,267,不合格
20052731,2,14,25,61,65,167,不合格
20052732,34,46,98,73,59,310,合格
20052733,57,53,63,98,37,308,合格
20052734,33,79,90,16,91,309,合格
20052735,25,92,76,86,26,305,合格
20052736,47,68,61,89,87,352,合格
20052737,15,6,67,13,79,180,不合格
20052738,1,18,38,20,57,134,不合格
20052739,37,16,85,72,99,309,合格
20052740,13,51,83,65,44,256,不合格
20052741,63,94,87,36,9,289,不合格
20052742,97,75,58,67,50,347,合格
20052743,0,60,25,4,13,102,不合格
20052744,8,77,42,50,53,230,不合格
20052745,4,25,88,23,90,230,不合格
20052746,17,21,81,6,74,199,不合格
20052747,89,90,37,67,36,319,合格
20052748,47,11,6,97,58,219,不合格
20052749,47,16,39,70,83,255,不合格
20052750,50,60,69,81,12,272,不合格
20052751,24,53,72,34,15,198,不合格
20052752,50,50,48,95,75,318,合格
20052753,46,14,17,14,89,180,不合格
20052754,54,97,58,84,33,326,合格
20052755,20,75,9,46,78,228,不合格
20052756,96,41,45,72,93,347,合格
20052757,30,51,84,30,0,195,不合格
20052758,79,57,11,92,15,254,不合格
20052759,47,34,41,9,52,183,不合格
20052760,16,61,50,5,72,204,不合格
20052761,4,22,37,77,38,178,不合格
20052762,88,17,7,65,95,272,不合格
20052763,98,8,92,75,42,315,合格
20052764,36,62,64,73,73,308,合格
20052765,46,96,92,92,6,332,合格
20052766,11,14,28,56,11,120,不合格
20052767,22,7,31,27,16,103,不合格
20052768,96,16,8,0,29,149,不合格
20052769,71,6,60,86,7,230,不合格
20052770,59,5,94,84,34,276,不合格
20052771,80,79,47,41,37,284,不合格
20052772,55,73,85,25,81,319,合格
20052773,94,4,11,37,85,231,不合格
20052774,30,0,25,68,19,142,不合格
20052775,17,47,87,8,96,255,不合格
20052776,17,12,43,73,21,166,不合格
20052777,0,74,63,38,62,237,不合格
20052778,69,22,21,67,74,253,不合格
20052779,20,73,86,59,37,275,不合格
20052780,92,77,77,87,73,406,合格
20052781,5,34,92,86,82,299,不合格
20052782,45,34,14,6,98,197,不合格
20052783,56,17,74,41,29,217,不合格
20052784,11,28,32,62,4,137,不合格
20052785,68,12,5,96,49,230,不合格
20052786,26,47,36,71,0,180,不合格
20052787,53,32,62,28,53,228,不合格
20052788,41,74,86,21,11,233,不合格
20052789,11,16,50,8,84,169,不合格
20052790,32,98,18,77,40,265,不合格
20052791,76,53,27,14,41,211,不合格
20052792,26,98,16,42,47,229,不合格
20052793,98,59,61,98,12,328,合格
20052794,56,96,98,46,92,388,合格
20052795,56,77,93,87,27,340,合格
20052796,17,80,78,70,19,264,不合格
20052797,20,57,0,97,46,220,不合格
20052798,89,10,35,10,20,164,不合格
20052799,40,64,65,1,48,218,不合格
20052800,2,79,32,50,62,225,不合格
20052801,9,48,3,79,55,194,不合格
20052802,89,28,81,22,45,265,不合格
20052803,22,63,63,77,42,267,不合格
20052804,56,92,13,19,15,195,不合格
20052805,16,38,45,79,94,272,不合格
20052806,66,8,24,54,29,181,不合格
20052807,35,78,29,15,49,206,不合格
20052808,75,38,3,78,58,252,不合格
20052809,3,85,16,52,22,178,不合格
20052810,62,22,84,41,69,278,不合格
20052811,11,34,42,71,35,193,不合格
20052812,79,53,94,10,44,280,不合格
20052813,47,68,14,28,44,201,不合格
20052814,56,7,81,74,95,313,合格
20052815,34,35,70,96,54,289,不合格
20052816,91,72,71,62,99,395,合格
20052817,76,40,40,11,79,246,不合格
20052818,22,25,6,67,85,205,不合格
20052819,77,39,18,15,42,191,不合格
20052820,48,53,48,16,78,243,不合格
20052821,23,75,80,50,6,234,不合格
20052822,47,1,65,10,46,169,不合格
20052823,1,52,0,57,25,135,不合格
20052824,84,44,2,57,6,193,不合格
20052825,26,7,60,35,99,227,不合格
20052826,33,41,72,74,1,221,不合格
20052827,67,21,96,21,8,213,不合格
20052828,85,83,25,3,12,208,不合格
20052829,85,22,66,72,69,314,合格
20052830,9,49,35,24,76,193,不合格
20052831,83,96,7,16,42,244,不合格
20052832,10,42,99,13,36,200,不合格
20052833,56,29,41,13,30,169,不合格
20052834,77,11,14,8,8,118,不合格
20052835,30,64,9,20,38,161,不合格
20052836,53,53,20,18,49,193,不合格
20052837,20,85,37,94,14,250,不合格
20052838,80,76,46,63,30,295,不合格
20052839,95,54,16,71,72,308,合格
20052840,76,85,3,25,26,215,不合格
20052841,7,46,46,65,11,175,不合格
20052842,38,77,65,96,41,317,合格
20052843,41,81,45,55,85,307,合格
20052844,33,75,16,60,53,237,不合格
20052845,36,42,48,26,55,207,不合格
20052846,33,57,5,26,25,146,不合格
20052847,94,25,0,8,63,190,不合格
20052848,90,64,45,88,38,325,合格
20052849,65,22,44,16,24,171,不合格
20052850,44,45,50,43,67,249,不合格
20052851,63,19,85,45,27,239,不合格
20052852,97,71,47,11,34,260,不合格
20052853,32,27,24,31,51,165,不合格
20052854,88,55,61,84,25,313,合格
20052855,99,61,96,18,36,310,合格
20052856,34,73,64,39,41,251,不合格
20052857,61,37,7,78,62,245,不合格
20052858,87,70,10,48,17,232,不合格
20052859,45,39,64,24,92,264,不合格
20052860,34,23,18,68,54,197,不合格
20052861,5,0,34,20,25,84,不合格
20052862,77,22,22,47,27,195,不合格
20052863,35,3,12,10,96,156,不合格
20052864,56,38,47,61,20,222,不合格
20052865,57,28,96,31,28,240,不合格
20052866,50,70,19,56,14,209,不合格
20052867,1,46,47,51,82,227,不合格
20052868,71,4,43,94,76,288,不合格
20052869,71,36,1,94,76,278,不合格
20052870,47,40,35,54,4,180,不合格
20052871,1,82,27,2,34,146,不合格
20052872,4,21,65,70,4,164,不合格
20052873,20,32,63,81,11,207,不合格
20052874,32,71,89,46,96,334,合格
20052875,64,3,84,82,41,274,不合格
20052876,64,23,37,45,23,192,不合格
20052877,43,93,62,70,89,357,合格
20052878,15,47,92,82,61,297,不合格
20052879,31,30,94,97,32,284,不合格
20052880,47,8,51,75,46,227,不合格
20052881,94,22,8,14,15,153,不合格
20052882,26,5,47,37,74,189,不合格
20052883,74,3,2,75,3,157,不合格
20052884,90,9,92,71,61,323,合格
20052885,12,16,22,9,28,87,不合格
20052886,46,54,52,45,1,198,不合格
20052887,40,88,7,50,26,211,不合格
20052888,26,54,72,87,69,308,合格
20052889,23,6,75,96,46,246,不合格
20052890,44,61,48,75,83,311,合格
20052891,30,42,44,98,18,232,不合格
20052892,43,84,0,96,31,254,不合格
20052893,4,24,58,90,86,262,不合格
20052894,56,90,55,76,44,321,合格
20052895,16,70,72,72,6,236,不合格
20052896,33,31,78,84,82,308,合格
20052897,43,37,37,61,72,250,不合格
20052898,41,77,51,7,93,269,不合格
20052899,21,23,84,20,14,162,不合格
20052900,39,63,82,40,2,226,不合格
20052901,38,36,10,96,84,264,不合格
20052902,82,30,80,4,81,277,不合格
20052903,68,21,24,9,26,148,不合格
20052904,13,58,14,41,31,157,不合格
20052905,40,70,7,37,80,234,不合格
20052906,12,44,80,22,17,175,不合格
20052907,35,23,43,25,0,126,不合格
20052908,22,39,33,53,36,183,不合格
20052909,52,28,35,60,62,237,不合格
20052910,94,80,19,62,52,307,合格
20052911,36,84,3,0,89,212,不合格
20052912,64,5,58,82,54,263,不合格
20052913,2,88,66,60,24,240,不合格
20052914,11,28,78,20,40,177,不合格
20052915,95,80,59,67,42,343,合格
20052916,88,29,58,5,54,234,不合格
20052917,51,22,85,86,56,300,合格
20052918,45,30,33,11,29,148,不合格
20052919,62,48,79,15,15,219,不合格
20052920,85,72,20,2,98,277,不合格
20052921,13,44,96,17,14,184,不合格
20052922,67,84,56,46,55,308,合格
20052923,32,49,48,60,81,270,不合格
20052924,14,75,36,78,18,221,不合格
20052925,44,97,16,12,72,241,不合格
20052926,4,17,31,67,35,154,不合格
20052927,51,18,17,68,54,208,不合格
20052928,66,6,52,28,55,207,不合格
20052929,56,14,65,55,74,264,不合格
20052930,13,41,32,47,70,203,不合格
20052931,24,38,62,74,89,287,不合格
20052932,66,58,82,63,29,298,不合格
20052933,54,66,71,18,67,276,不合格
20052934,28,0,3,66,98,195,不合格
20052935,30,16,98,67,19,230,不合格
20052936,14,5,57,44,44,164,不合格
20052937,3,23,62,93,57,238,不合格
20052938,57,12,53,3,26,151,不合格
20052939,92,52,98,14,25,281,不合格
20052940,68,77,2,4,28,179,不合格
20052941,29,14,24,95,97,259,不合格
20052942,63,24,13,98,92,290,不合格
20052943,53,21,50,71,65,260,不合格
20052944,6,31,65,7,28,137,不合格
20052945,75,91,10,27,36,239,不合格
20052946,52,55,81,85,87,360,合格
20052947,34,7,26,77,57,201,不合格
20052948,99,33,14,11,60,217,不合格
20052949,96,39,39,64,85,323,合格
20052950,44,44,22,40,27,177,不合格
20052951,98,22,54,87,28,289,不合格
20052952,91,28,75,62,17,273,不合格
20052953,38,38,77,66,97,316,合格
20052954,88,47,13,69,81,298,不合格
20052955,30,8,40,51,98,227,不合格
20052956,95,80,93,14,25,307,合格
20052957,11,22,49,19,59,160,不合格
20052958,38,96,13,26,7,180,不合格
20052959,77,24,64,37,35,237,不合格
20052960,41,63,91,72,88,355,合格
20052961,49,47,75,7,36,214,不合格
20052962,21,2,77,5,23,128,不合格
20052963,41,84,3,52,56,236,不合格
20052964,32,85,86,66,1,270,不合格
20052965,47,70,24,56,3,200,不合格
20052966,92,15,9,20,82,218,不合格
20052967,14,94,29,1,20,158,不合格
20052968,56,41,64,14,9,184,不合格
20052969,55,95,31,9,84,274,不合格
20052970,94,6,90,39,83,312,合格
20052971,98,59,33,82,58,330,合格
20052972,4,5,60,15,9,93,不合格
20052973,0,19,12,57,61,149,不合格
20052974,44,68,40,3,58,213,不合格
20052975,25,21,27,48,31,152,不合格
20052976,10,77,92,78,84,341,合格
20052977,9,87,82,22,14,214,不合格
20052978,52,56,7,43,69,227,不合格
20052979,25,26,86,16,28,181,不合格
20052980,93,21,79,46,65,304,合格
20052981,58,93,25,61,20,257,不合格
20052982,7,62,40,43,58,210,不合格
20052983,21,88,54,62,5,230,不合格
20052984,89,2,3,82,21,197,不合格
20052985,57,63,93,74,4,291,不合格
20052986,14,83,49,8,56,210,不合格
20052987,26,65,83,53,5,232,不合格
20052988,46,38,17,16,11,128,不合格
20052989,74,77,92,51,98,392,合格
20052990,72,26,29,24,33,184,不合格
20052991,6,48,88,20,61,223,不合格
20052992,99,25,19,56,4,203,不合格
20052993,3,7,14,27,58,109,不合格
20052994,60,53,2,20,68,203,不合格
20052995,2,37,44,42,30,155,不合格
20052996,65,2,89,42,12,210,不合格
20052997,6,0,60,3,47,116,不合格
20052998,86,2,61,13,85,247,不合格
20052999,38,56,79,95,37,305,合格
20053000,4,42,43,64,7,160,不合格
20053001,52,35,32,5,30,154,不合格
20053002,15,21,44,3,80,163,不合格
20053003,66,82,85,15,59,307,合格
20053004,60,74,0,2,72,208,不合格
20053005,29,42,64,56,51,242,不合格
20053006,32,25,97,97,2,253,不合格
20053007,56,34,19,84,24,217,不合格
20053008,60,17,44,89,55,265,不合格
20053009,53,18,76,27,60,234,不合格
20053010,59,94,33,66,86,338,合格
20053011,28,90,40,75,41,274,不合格
20053012,67,30,33,51,65,246,不合格
20053013,60,74,50,89,16,289,不合格
20053014,71,68,8,79,67,293,不合格
20053015,70,67,78,87,90,392,合格
20053016,47,69,80,72,39,307,合格
20053017,1,5,82,12,83,183,不合格
20053018,51,74,79,48,47,299,不合格
20053019,34,0,66,62,26,188,不合格
20053020,25,99,81,55,9,269,不合格
20053021,46,54,92,25,64,281,不合格
20053022,0,27,97,71,12,207,不合格
20053023,43,17,95,26,41,222,不合格
20053024,80,55,18,72,22,247,不合格
20053025,24,37,18,41,98,218,不合格
20053026,35,40,16,23,72,186,不合格
20053027,73,55,92,54,30,304,合格
20053028,8,30,86,42,65,231,不合格
20053029,74,22,93,90,25,304,合格
20053030,27,34,49,79,7,196,不合格
20053031,42,88,40,71,60,301,合格
20053032,19,47,57,73,22,218,不合格
20053033,88,96,45,5,49,283,不合格
20053034,39,72,90,25,8,234,不合格
20053035,37,65,72,67,60,301,合格
20053036,84,23,20,84,83,294,不合格
20053037,7,76,3,17,42,145,不合格
20053038,11,36,42,74,73,236,不合格
20053039,98,5,61,14,15,193,不合格
20053040,84,47,66,43,84,324,合格
20053041,93,99,71,21,8,292,不合格
20053042,76,30,99,76,26,307,合格
20053043,71,92,61,15,7,246,不合格
20053044,52,57,83,7,18,217,不合格
20053045,69,27,2,23,57,178,不合格
20053046,60,8,7,35,23,133,不合格
20053047,39,0,29,46,6,120,不合格
20053048,41,80,97,17,64,299,不合格
20053049,52,69,47,92,4,264,不合格
20053050,35,94,74,68,3,274,不合格
20053051,36,26,91,99,4,256,不合格
20053052,68,35,16,14,1,134,不合格
20053053,39,60,73,42,51,265,不合格
20053054,69,9,34,37,9,158,不合格
20053055,92,67,46,88,25,318,合格
20053056,17,8,57,8,76,166,不合格
20053057,20,32,10,43,39,144,不合格
20053058,22,15,8,94,80,219,不合格
20053059,82,68,8,30,72,260,不合格
20053060,10,94,94,74,9,281,不合格
20053061,17,61,88,34,60,260,不合格
20053062,27,99,23,27,4,180,不合格
20053063,46,42,13,90,14,205,不合格
20053064,24,78,75,58,35,270,不合格
20053065,85,60,79,68,2,294,不合格
20053066,44,38,19,73,67,241,不合格
20053067,11,19,14,84,29,157,不合格
20053068,3,71,61,38,41,214,不合格
20053069,52,8,76,83,83,302,合格
20053070,44,38,46,8,44,180,不合格
20053071,72,75,92,59,99,397,合格
20053072,37,11,17,81,11,157,不合格
20053073,45,69,57,71,37,279,不合格
20053074,22,1,32,23,63,141,不合格
20053075,0,3,36,71,29,139,不合格
20053076,25,84,3,12,3,127,不合格
20053077,42,78,32,92,62,306,合格
20053078,44,69,48,54,77,292,不合格
20053079,32,82,28,4,63,209,不合格
20053080,95,24,18,96,43,276,不合格
20053081,72,25,20,40,76,233,不合格
20053082,79,67,4,64,66,280,不合格
20053083,44,80,43,12,56,235,不合格
20053084,95,23,75,54,90,337,合格
20053085,41,53,45,45,33,217,不合格
20053086,20,46,82,73,37,258,不合格
20053087,82,73,73,67,39,334,合格
20053088,65,63,46,5,43,222,不合格
20053089,85,12,86,90,64,337,合格
20053090,74,40,35,56,37,242,不合格
20053091,60,36,57,79,96,328,合格
20053092,29,45,2,72,12,160,不合格
20053093,85,50,75,60,16,286,不合格
20053094,90,95,53,15,11,264,不合格
20053095,29,25,75,69,15,213,不合格
20053096,14,3,57,5,59,138,不合格
20053097,14,40,93,30,20,197,不合格
20053098,48,2,46,82,65,243,不合格
20053099,63,66,20,22,85,256,不合格
20053100,81,47,15,70,60,273,不合格
20053101,9,81,15,72,46,223,不合格
20053102,45,87,16,65,51,264,不合格
20053103,98,93,23,3,26,243,不合格
20053104,64,23,69,58,91,305,合格
20053105,46,68,89,8,66,277,不合格
20053106,99,0,93,46,95,333,合格
20053107,36,18,45,71,29,199,不合格
20053108,32,27,96,50,39,244,不合格
20053109,95,74,44,40,7,260,不合格
20053110,39,51,42,28,6,166,不合格
20053111,85,60,30,92,67,334,合格
20053112,69,27,93,4,8,201,不合格
20053113,37,27,62,11,21,158,不合格
20053114,94,8,12,29,39,182,不合格
20053115,34,86,26,85,37,268,不合格
20053116,20,1,39,71,94,225,不合格
20053117,48,68,91,61,93,361,合格
20053118,80,85,19,23,94,301,合格
20053119,75,94,87,55,64,375,合格
20053120,44,2,75,52,87,260,不合格
20053121,24,25,20,55,73,197,不合格
20053122,97,99,64,30,12,302,合格
20053123,10,5,60,51,38,164,不合格
20053124,91,5,46,27,45,214,不合格
20053125,79,73,45,99,29,325,合格
20053126,83,75,33,13,17,221,不合格
20053127,69,24,85,88,36,302,合格
20053128,17,13,71,73,44,218,不合格
20053129,38,87,74,52,12,263,不合格
20053130,23,0,1,18,32,74,不合格
20053131,33,70,48,25,93,269,不合格
20053132,9,86,88,58,96,337,合格
20053133,24,49,21,11,46,151,不合格
20053134,58,85,31,87,28,289,不合格
20053135,56,19,67,59,86,287,不合格
20053136,1,73,12,46,48,180,不合格
20053137,86,30,80,56,99,351,合格
20053138,97,90,48,54,73,362,合格
20053139,78,60,11,68,69,286,不合格
20053140,92,28,14,31,10,175,不合格
20053141,48,36,44,45,70,243,不合格
20053142,38,92,58,39,47,274,不合格
20053143,70,13,44,24,96,247,不合格
20053144,38,21,47,38,19,163,不合格
20053145,31,73,13,48,61,226,不合格
20053146,91,51,94,77,24,337,合格
20053147,0,96,71,89,24,280,不合格
20053148,55,13,67,53,32,220,不合格
20053149,27,80,40,43,54,244,不合格
20053150,81,41,49,30,28,229,不合格
20053151,62,98,89,28,34,311,合格
20053152,33,90,15,21,53,212,不合格
20053153,54,62,15,45,54,230,不合格
20053154,23,75,54,89,67,308,合格
20053155,27,48,66,26,78,245,不合格
20053156,88,32,17,79,73,289,不合格
20053157,62,87,80,20,4,253,不合格
20053158,15,9,88,0,89,201,不合格
20053159,64,95,5,64,11,239,不合格
20053160,34,99,98,72,30,333,合格
20053161,43,86,67,62,38,296,不合格
20053162,11,45,87,71,21,235,不合格
20053163,48,69,71,9,82,279,不合格
20053164,57,76,58,97,74,362,合格
20053165,54,37,9,85,79,264,不合格
20053166,32,55,4,88,8,187,不合格
20053167,81,36,18,79,91,305,合格
20053168,95,98,94,3,74,364,合格
20053169,38,59,97,51,11,256,不合格
20053170,3,35,44,23,39,144,不合格
20053171,87,28,33,61,79,288,不合格
20053172,98,81,16,72,60,327,合格
20053173,35,89,87,85,24,320,合格
20053174,35,27,52,43,39,196,不合格
20053175,62,63,9,35,40,209,不合格
20053176,30,34,38,87,81,270,不合格
20053177,58,8,35,30,26,157,不合格
20053178,55,69,75,4,35,238,不合格
20053179,52,65,66,74,44,301,合格
20053180,99,33,28,29,26,215,不合格
20053181,88,69,85,79,18,339,合格
20053182,20,6,89,72,13,200,不合格
20053183,60,78,28,75,96,337,合格
20053184,61,22,59,29,38,209,不合格
20053185,40,9,37,47,18,151,不合格
20053186,48,31,24,59,85,247,不合格
20053187,33,79,30,37,71,250,不合格
20053188,25,14,15,53,56,163,不合格
20053189,53,47,53,35,17,205,不合格
20053190,95,60,14,64,78,311,合格
20053191,69,67,10,50,97,293,不合格
20053192,97,40,74,8,94,313,合格
20053193,14,5,29,81,56,185,不合格
20053194,71,19,22,77,32,221,不合格
20053195,92,54,98,24,99,367,合格
20053196,85,12,64,25,98,284,不合格
20053197,97,74,83,73,69,396,合格
20053198,94,12,94,69,77,346,合格
20053199,1,86,44,49,99,279,不合格
20053200,90,25,57,80,8,260,不合格
20053201,17,37,38,22,21,135,不合格
20053202,24,41,90,71,51,277,不合格
20053203,61,71,4,7,91,234,不合格
20053204,46,28,53,96,52,275,不合格
20053205,24,47,31,97,81,280,不合格
20053206,11,2,45,90,41,189,不合格
20053207,29,37,57,74,75,272,不合格
20053208,23,76,53,73,65,290,不合格
20053209,32,45,39,72,56,244,不合格
20053210,13,99,22,12,54,200,不合格
20053211,10,32,77,21,65,205,不合格
20053212,96,47,26,63,16,248,不合格
20053213,38,75,22,2,80,217,不合格
20053214,14,0,25,4,35,78,不合格
20053215,78,79,38,40,78,313,合格
20053216,23,34,19,85,18,179,不合格
20053217,73,89,34,6,71,273,不合格
20053218,52,48,11,12,21,144,不合格
20053219,65,9,47,68,57,246,不合格
20053220,29,66,69,90,37,291,不合格
20053221,95,65,99,29,28,316,合格
20053222,97,64,25,90,77,353,合格
20053223,62,61,10,56,44,233,不合格
20053224,63,74,96,72,20,325,合格
20053225,82,0,46,97,55,280,不合格
20053226,82,85,85,46,36,334,合格
20053227,49,78,92,31,56,306,合格
20053228,6,93,74,24,89,286,不合格
20053229,11,52,68,86,71,288,不合格
20053230,46,19,73,18,74,230,不合格
20053231,20,23,58,30,2,133,不合格
20053232,31,19,99,33,53,235,不合格
20053233,86,72,41,6,28,233,不合格
20053234,41,5,72,13,74,205,不合格
20053235,3,65,98,65,72,303,合格
20053236,54,64,39,37,12,206,不合格
20053237,18,68,88,28,63,265,不合格
20053238,21,97,40,51,55,264,不合格
20053239,89,61,10,77,91,328,合格
20053240,61,53,16,12,61,203,不合格
20053241,11,54,92,45,8,210,不合格
20053242,27,82,28,79,77,293,不合格
20053243,70,6,0,86,70,232,不合格
20053244,96,93,58,95,68,410,合格
20053245,40,78,72,4,99,293,不合格
20053246,50,8,82,20,50,210,不合格
20053247,94,58,9,81,95,337,合格
20053248,46,55,37,39,7,184,不合格
20053249,33,22,75,29,12,171,不合格
20053250,12,41,29,49,31,162,不合格
20053251,32,56,42,67,98,295,不合格
20053252,19,37,35,42,4,137,不合格
20053253,42,1,34,30,35,142,不合格
20053254,77,46,8,61,43,235,不合格
20053255,26,13,58,26,76,199,不合格
20053256,61,74,37,76,32,280,不合格
20053257,3,62,81,22,97,265,不合格
20053258,33,74,94,68,0,269,不合格
20053259,50,23,16,45,81,215,不合格
20053260,98,4,92,1,95,290,不合格
20053261,51,11,49,18,72,201,不合格
20053262,52,89,19,83,94,337,合格
20053263,74,68,46,56,35,279,不合格
20053264,5,58,58,64,9,194,不合格
20053265,87,93,0,79,99,358,合格
20053266,89,62,10,98,33,292,不合格
20053267,34,90,22,61,43,250,不合格
20053268,18,12,88,61,78,257,不合格
20053269,74,2,55,10,85,226,不合格
20053270,28,5,20,18,22,93,不合格
20053271,98,84,94,82,45,403,合格
20053272,8,6,43,83,43,183,不合格
20053273,24,46,12,82,99,263,不合格
20053274,86,67,6,71,9,239,不合格
20053275,64,44,27,86,15,236,不合格
20053276,59,50,93,1,10,213,不合格
20053277,49,42,4,71,56,222,不合格
20053278,26,46,41,56,86,255,不合格
20053279,55,78,17,4,13,167,不合格
20053280,82,7,21,53,51,214,不合格
20053281,44,32,82,97,26,281,不合格
20053282,39,94,48,89,11,281,不合格
20053283,18,89,67,7,30,211,不合格
20053284,12,16,53,2,55,138,不合格
20053285,67,61,52,47,73,300,合格
20053286,87,43,53,82,4,269,不合格
20053287,93,6,93,37,39,268,不合格
20053288,41,57,77,59,59,293,不合格
20053289,10,63,7,33,24,137,不合格
20053290,54,1,26,49,53,183,不合格
20053291,84,17,53,84,37,275,不合格
20053292,70,61,11,89,84,315,合格
20053293,45,84,58,81,43,311,合格
20053294,87,82,32,45,32,278,不合格
20053295,51,79,30,72,59,291,不合格
20053296,12,83,6,80,98,279,不合格
20053297,7,9,9,57,88,170,不合格
20053298,1,11,53,87,45,197,不合格
20053299,97,80,24,65,80,346,合格
20053300,20,37,9,57,51,174,不合格
20053301,4,66,78,93,70,311,合格
20053302,76,47,89,67,14,293,不合格
20053303,46,39,60,62,90,297,不合格
20053304,4,82,48,78,97,309,合格
20053305,42,38,46,74,9,209,不合格
20053306,3,81,62,13,28,187,不合格
20053307,37,37,59,91,56,280,不合格
20053308,23,76,56,28,80,263,不合格
20053309,13,43,99,11,92,258,不合格
20053310,95,30,48,77,75,325,合格
20053311,89,23,14,43,26,195,不合格
20053312,45,44,78,65,92,324,合格
20053313,94,33,12,70,57,266,不合格
20053314,64,80,88,24,43,299,不合格
20053315,83,61,95,27,72,338,合格
20053316,55,83,48,84,39,309,合格
20053317,79,26,11,44,30,190,不合格
20053318,74,70,3,24,11,182,不合格
20053319,32,16,99,14,48,209,不合格
20053320,5,36,73,76,53,243,不合格
20053321,89,41,85,34,67,316,合格
20053322,18,16,45,52,31,162,不合格
20053323,51,17,38,65,94,265,不合格
20053324,69,26,57,67,64,283,不合格
20053325,57,79,88,87,20,331,合格
20053326,61,79,4,35,65,244,不合格
20053327,34,19,24,77,9,163,不合格
20053328,87,10,37,39,92,265,不合格
20053329,77,31,13,30,3,154,不合格
20053330,53,14,18,94,15,194,不合格
20053331,2,80,59,20,28,189,不合格
20053332,39,95,67,64,72,337,合格
20053333,45,22,62,56,14,199,不合格
20053334,55,42,87,30,87,301,合格
20053335,87,58,30,1,55,231,不合格
20053336,83,84,14,55,27,263,不合格
20053337,88,10,19,23,81,221,不合格
20053338,37,43,36,69,66,251,不合格
20053339,24,9,47,64,70,214,不合格
20053340,74,61,48,45,62,290,不合格
20053341,81,47,5,35,94,262,不合格
20053342,7,27,73,10,91,208,不合格
20053343,35,25,74,55,61,250,不合格
20053344,47,19,79,73,86,304,合格
20053345,81,84,6,56,9,236,不合格
20053346,23,22,29,73,25,172,不合格
20053347,18,47,55,34,63,217,不合格
20053348,2,95,55,82,84,318,合格
20053349,62,21,95,87,74,339,合格
20053350,95,20,84,90,3,292,不合格
20053351,75,23,78,92,52,320,合格
20053352,86,67,1,93,73,320,合格
20053353,21,31,18,35,98,203,不合格
20053354,67,86,31,21,74,279,不合格
20053355,95,68,23,27,74,287,不合格
20053356,99,58,65,87,12,321,合格
20053357,42,28,28,24,78,200,不合格
20053358,39,45,65,65,96,310,合格
20053359,7,23,6,63,23,122,不合格
20053360,56,29,37,87,46,255,不合格
20053361,21,69,85,43,20,238,不合格
20053362,74,57,46,93,73,343,合格
20053363,6,56,45,86,27,220,不合格
20053364,81,87,68,55,74,365,合格
20053365,62,97,26,44,27,256,不合格
20053366,8,34,36,17,77,172,不合格
20053367,68,43,41,22,24,198,不合格
20053368,28,51,74,85,90,328,合格
20053369,74,90,15,42,20,241,不合格
20053370,52,83,7,67,50,259,不合格
20053371,46,78,44,5,17,190,不合格
20053372,19,26,50,2,25,122,不合格
20053373,1,43,30,55,44,173,不合格
20053374,32,62,28,51,43,216,不合格
20053375,96,47,13,87,35,278,不合格
20053376,87,28,67,72,51,305,合格
20053377,38,31,88,49,34,240,不合格
20053378,50,97,78,80,94,399,合格
20053379,81,46,25,38,6,196,不合格
20053380,58,63,60,96,12,289,不合格
20053381,76,25,8,27,23,159,不合格
20053382,61,43,53,11,40,208,不合格
20053383,8,97,6,39,14,164,不合格
20053384,72,38,27,43,51,231,不合格
20053385,26,56,71,57,33,243,不合格
20053386,23,20,75,99,82,299,不合格
20053387,16,74,69,17,28,204,不合格
20053388,0,77,32,44,30,183,不合格
20053389,38,50,84,69,34,275,不合格
20053390,92,59,8,93,90,342,合格
20053391,76,14,53,34,13,190,不合格
20053392,83,42,25,7,59,216,不合格
20053393,74,72,80,69,52,347,合格
20053394,91,71,23,77,1,263,不合格
20053395,0,3,48,90,10,151,不合格
20053396,21,38,61,81,61,262,不合格
20053397,51,47,11,39,63,211,不合格
20053398,73,55,2,49,9,188,不合格
20053399,38,54,26,55,46,219,不合格
20053400,15,15,19,36,21,106,不合格
20053401,87,94,69,53,47,350,合格
20053402,6,51,64,86,99,306,合格
20053403,7,92,70,65,52,286,不合格
20053404,54,25,59,46,68,252,不合格
20053405,9,86,82,83,49,309,合格
20053406,79,42,75,72,42,310,合格
20053407,13,59,65,52,33,222,不合格
20053408,97,70,28,63,24,282,不合格
20053409,90,38,29,2,27,186,不合格
20053410,6,37,4,14,39,100,不合格
20053411,11,38,72,22,41,184,不合格
20053412,61,83,23,71,37,275,不合格
20053413,18,13,24,64,81,200,不合格
20053414,52,86,0,87,45,270,不合格
20053415,25,19,8,53,52,157,不合格
20053416,11,20,21,49,14,115,不合格
20053417,92,63,48,44,71,318,合格
20053418,34,91,1,96,26,248,不合格
20053419,22,94,30,71,22,239,不合格
20053420,90,90,59,84,95,418,合格
20053421,26,82,48,55,17,228,不合格
20053422,82,39,52,29,31,233,不合格
20053423,44,78,81,88,2,293,不合格
20053424,0,94,46,30,20,190,不合格
20053425,70,48,60,64,93,335,合格
20053426,7,9,29,20,15,80,不合格
20053427,67,79,34,51,96,327,合格
20053428,1,57,93,90,62,303,合格
20053429,22,55,21,54,64,216,不合格
20053430,88,81,20,26,71,286,不合格
20053431,23,69,56,76,29,253,不合格
20053432,82,26,82,4,2,196,不合格
20053433,42,39,68,23,15,187,不合格
20053434,42,4,45,35,15,141,不合格
20053435,77,56,22,81,44,280,不合格
20053436,22,86,20,87,42,257,不合格
20053437,4,29,61,1,88,183,不合格
20053438,76,92,73,40,54,335,合格
20053439,93,23,19,18,81,234,不合格
20053440,41,69,77,42,43,272,不合格
20053441,56,25,80,20,97,278,不合格
20053442,46,77,20,51,84,278,不合格
20053443,33,2,15,76,62,188,不合格
20053444,47,6,25,20,80,178,不合格
20053445,29,37,75,5,98,244,不合格
20053446,43,37,69,71,63,283,不合格
20053447,20,76,32,99,47,274,不合格
20053448,98,99,95,84,60,436,合格
20053449,85,28,18,23,9,163,不合格
20053450,71,97,47,20,32,267,不合格
20053451,79,56,75,2,47,259,不合格
20053452,82,31,78,7,33,231,不合格
20053453,65,63,49,19,94,290,不合格
20053454,1,43,60,4,45,153,不合格
20053455,28,18,59,95,93,293,不合格
20053456,54,73,76,62,65,330,合格
20053457,90,67,30,33,77,297,不合格
20053458,96,21,43,42,95,297,不合格
20053459,34,66,14,67,39,220,不合格
20053460,88,90,39,88,13,318,合格
20053461,77,44,57,46,17,241,不合格
20053462,96,40,21,80,76,313,合格
20053463,59,61,29,59,27,235,不合格
20053464,10,7,99,89,21,226,不合格
20053465,99,87,9,16,6,217,不合格
20053466,58,71,9,38,26,202,不合格
20053467,44,26,68,23,92,253,不合格
20053468,38,82,66,5,3,194,不合格
20053469,72,97,17,35,23,244,不合格
20053470,1,0,29,0,98,128,不合格
20053471,21,7,11,55,54,148,不合格
20053472,62,1,43,92,57,255,不合格
20053473,64,25,13,42,41,185,不合格
20053474,65,40,22,28,65,220,不合格
20053475,40,69,59,14,30,212,不合格
20053476,27,97,99,25,42,290,不合格
20053477,19,39,30,36,92,216,不合格
20053478,49,20,64,12,91,236,不合格
20053479,83,13,94,31,60,281,不合格
20053480,55,59,83,77,68,342,合格
20053481,23,89,18,35,81,246,不合格
20053482,83,91,45,64,89,372,合格
20053483,58,36,82,96,34,306,合格
20053484,88,0,50,64,91,293,不合格
20053485,5,35,23,8,27,98,不合格
20053486,37,34,94,10,24,199,不合格
20053487,84,14,12,46,74,230,不合格
20053488,54,82,54,46,93,329,合格
20053489,57,21,30,67,51,226,不合格
20053490,3,69,65,49,77,263,不合格
20053491,14,56,26,33,67,196,不合格
20053492,11,28,88,66,27,220,不合格
20053493,69,92,87,81,84,413,合格
20053494,11,26,67,66,3,173,不合格
20053495,40,94,73,65,30,302,合格
20053496,14,64,46,62,59,245,不合格
20053497,64,30,87,4,91,276,不合格
20053498,18,0,56,53,86,213,不合格
20053499,31,44,47,54,85,261,不合格
20053500,72,47,76,52,26,273,不合格
20053501,89,36,23,42,7,197,不合格
20053502,70,59,67,28,25,249,不合格
20053503,93,78,17,69,99,356,合格
20053504,25,21,58,30,5,139,不合格
20053505,48,99,6,68,63,284,不合格
20053506,57,15,23,84,83,262,不合格
20053507,54,16,71,56,42,239,不合格
20053508,33,14,42,68,4,161,不合格
20053509,95,88,76,12,16,287,不合格
20053510,20,66,83,50,78,297,不合格
20053511,75,20,1,82,34,212,不合格
20053512,33,33,50,97,24,237,不合格
20053513,9,40,23,48,91,211,不合格
20053514,46,78,90,75,10,299,不合格
20053515,61,98,86,40,32,317,合格
20053516,23,61,91,31,1,207,不合格
20053517,60,99,61,74,36,330,合格
20053518,6,47,58,73,89,273,不合格
20053519,17,94,74,11,40,236,不合格
20053520,56,32,92,76,47,303,合格
20053521,90,77,93,42,62,364,合格
20053522,2,50,70,45,93,260,不合格
20053523,27,22,86,39,97,271,不合格
20053524,4,32,63,34,10,143,不合格
20053525,32,58,50,51,82,273,不合格
20053526,30,14,84,48,19,195,不合格
20053527,18,97,56,11,30,212,不合格
20053528,38,23,12,27,10,110,不合格
20053529,52,55,86,77,57,327,合格
20053530,61,38,25,22,74,220,不合格
20053531,70,68,0,85,3,226,不合格
20053532,8,72,69,39,90,278,不合格
20053533,25,17,82,55,33,212,不合格
20053534,15,14,70,12,1,112,不合格
20053535,61,28,52,49,6,196,不合格
20053536,83,69,85,11,65,313,合格
20053537,25,36,62,75,10,208,不合格
20053538,15,73,23,49,38,198,不合格
20053539,82,33,73,57,11,256,不合格
20053540,84,95,26,50,11,266,不合格
20053541,23,8,33,63,84,211,不合格
20053542,32,21,80,15,5,153,不合格
20053543,84,61,77,61,34,317,合格
20053544,10,72,19,5,20,126,不合格
20053545,64,85,72,57,17,295,不合格
20053546,94,68,16,90,81,349,合格
20053547,21,1,66,7,74,169,不合格
20053548,90,84,69,57,6,306,合格
20053549,74,37,64,61,21,257,不合格
20053550,42,63,11,67,42,225,不合格
20053551,82,23,36,23,88,252,不合格
20053552,20,91,93,88,95,387,合格
20053553,5,39,51,44,81,220,不合格
20053554,29,6,40,28,58,161,不合格
20053555,1,15,85,29,26,156,不合格
20053556,42,80,43,42,17,224,不合格
20053557,58,4,8,14,20,104,不合格
20053558,24,69,21,85,82,281,不合格
20053559,23,66,67,77,2,235,不合格
20053560,23,58,29,33,97,240,不合格
20053561,35,45,24,63,28,195,不合格
20053562,76,2,70,65,56,269,不合格
20053563,31,61,90,20,7,209,不合格
20053564,53,99,57,39,12,260,不合格
20053565,25,95,21,29,51,221,不合格
20053566,75,86,22,35,82,300,合格
20053567,4,14,47,50,91,206,不合格
20053568,63,97,6,68,7,241,不合格
20053569,30,83,3,90,31,237,不合格
20053570,35,5,11,68,35,154,不合格
20053571,96,65,92,70,8,331,合格
20053572,53,69,87,41,30,280,不合格
20053573,88,43,28,34,14,207,不合格
20053574,45,44,97,96,71,353,合格
20053575,12,64,48,53,15,192,不合格
20053576,54,99,67,53,33,306,合格
20053577,48,90,89,4,79,310,合格
20053578,90,95,81,89,26,381,合格
20053579,80,91,51,40,97,359,合格
20053580,67,57,10,26,91,251,不合格
20053581,69,24,24,12,57,186,不合格
20053582,45,91,55,39,61,291,不合格
20053583,48,64,57,55,62,286,不合格
20053584,4,15,83,43,57,202,不合格
20053585,18,93,39,67,8,225,不合格
20053586,69,52,54,14,8,197,不合格
20053587,35,31,14,91,1,172,不合格
20053588,10,45,28,57,41,181,不合格
20053589,17,70,29,91,21,228,不合格
20053590,86,73,13,64,54,290,不合格
20053591,14,22,7,15,35,93,不合格
20053592,54,21,56,68,80,279,不合格
20053593,61,24,28,61,34,208,不合格
20053594,70,70,53,3,7,203,不合格
20053595,58,24,55,30,61,228,不合格
20053596,30,82,36,30,54,232,不合格
20053597,3,86,98,90,83,360,合格
20053598,65,72,9,93,76,315,合格
20053599,9,56,20,63,3,151,不合格
20053600,14,41,82,70,8,215,不合格
20053601,99,92,41,36,53,321,合格
20053602,96,29,19,0,45,189,不合格
20053603,71,33,47,76,78,305,合格
20053604,46,70,67,29,85,297,不合格
20053605,41,5,18,18,9,91,不合格
20053606,36,85,34,86,99,340,合格
20053607,59,94,49,42,93,337,合格
20053608,15,83,31,67,41,237,不合格
20053609,25,57,47,57,79,265,不合格
20053610,57,72,6,51,3,189,不合格
20053611,79,11,90,87,21,288,不合格
20053612,89,57,44,91,42,323,合格
20053613,38,27,70,90,64,289,不合格
20053614,84,16,44,54,81,279,不合格
20053615,60,14,72,41,11,198,不合格
20053616,48,13,58,14,71,204,不合格
20053617,60,45,7,97,73,282,不合格
20053618,29,82,17,83,10,221,不合格
20053619,75,37,57,45,82,296,不合格
20053620,62,13,39,89,70,273,不合格
20053621,24,95,27,78,78,302,合格
20053622,62,58,15,69,82,286,不合格
20053623,34,84,21,65,2,206,不合格
20053624,62,46,69,80,68,325,合格
20053625,59,32,61,26,36,214,不合格
20053626,70,78,38,62,46,294,不合格
20053627,87,24,24,52,84,271,不合格
20053628,89,60,30,36,55,270,不合格
20053629,27,21,25,57,39,169,不合格
20053630,72,57,79,76,91,375,合格
20053631,96,80,37,8,17,238,不合格
20053632,49,62,7,25,96,239,不合格
20053633,11,35,8,95,67,216,不合格
20053634,53,24,50,79,17,223,不合格
20053635,30,75,68,91,72,336,合格
20053636,80,51,13,73,43,260,不合格
20053637,4,55,44,37,66,206,不合格
20053638,3,57,52,63,83,258,不合格
20053639,7,92,24,97,89,309,合格
20053640,13,47,73,54,9,196,不合格
20053641,93,9,96,1,59,258,不合格
20053642,1,12,35,80,51,179,不合格
20053643,6,16,52,53,41,168,不合格
20053644,35,16,96,93,96,336,合格
20053645,19,3,3,6,87,118,不合格
20053646,68,75,17,69,64,293,不合格
20053647,57,54,85,46,32,274,不合格
20053648,9,5,80,81,54,229,不合格
20053649,70,39,61,47,83,300,合格
20053650,35,79,73,78,76,341,合格
20053651,9,91,94,32,28,254,不合格
20053652,79,94,37,65,82,357,合格
20053653,45,75,30,94,10,254,不合格
20053654,14,1,77,78,44,214,不合格
20053655,14,95,39,86,96,330,合格
20053656,1,99,96,87,30,313,合格
20053657,28,2,39,91,5,165,不合格
20053658,7,0,98,20,4,129,不合格
20053659,40,71,12,97,72,292,不合格
20053660,37,65,22,73,19,216,不合格
20053661,40,68,67,1,8,184,不合格
20053662,48,98,30,68,53,297,不合格
20053663,56,23,19,1,45,144,不合格
20053664,7,69,3,41,89,209,不合格
20053665,39,75,47,92,43,296,不合格
20053666,88,98,78,15,80,359,合格
20053667,51,68,51,26,12,208,不合格
20053668,81,90,20,33,59,283,不合格
20053669,17,24,8,67,9,125,不合格
20053670,2,54,17,60,45,178,不合格
20053671,16,55,68,43,71,253,不合格
20053672,18,50,91,66,35,260,不合格
20053673,9,38,21,40,21,129,不合格
20053674,68,75,4,86,63,296,不合格
20053675,41,50,45,50,48,234,不合格
20053676,52,11,70,15,60,208,不合格
20053677,34,73,74,50,97,328,合格
20053678,88,74,51,8,98,319,合格
20053679,16,90,15,78,57,256,不合格
20053680,36,25,57,59,85,262,不合格
20053681,75,58,31,95,90,349,合格
20053682,66,72,19,30,56,243,不合格
20053683,29,59,30,83,41,242,不合格
20053684,8,44,22,44,98,216,不合格
20053685,20,83,74,9,30,216,不合格
20053686,67,86,87,15,84,339,合格
20053687,33,23,49,24,80,209,不合格
20053688,81,68,58,21,9,237,不合格
20053689,3,97,24,11,25,160,不合格
20053690,84,74,38,54,59,309,合格
20053691,60,1,94,89,87,331,合格
20053692,48,52,2,87,26,215,不合格
20053693,66,46,33,29,0,174,不合格
20053694,18,9,30,93,42,192,不合格
20053695,55,16,93,75,72,311,合格
20053696,95,86,45,20,74,320,合格
20053697,79,28,92,13,52,264,不合格
20053698,25,84,40,70,0,219,不合格
20053699,74,91,97,70,13,345,合格
20053700,72,62,46,28,67,275,不合格
20053701,28,61,87,14,79,269,不合格
20053702,68,56,41,80,47,292,不合格
20053703,61,93,74,22,62,312,合格
20053704,67,70,6,21,72,236,不合格
20053705,32,53,82,20,38,225,不合格
20053706,36,63,30,45,82,256,不合格
20053707,75,66,36,93,45,315,合格
20053708,60,91,44,2,58,255,不合格
20053709,32,89,54,85,86,346,合格
20053710,91,13,23,19,34,180,不合格
20053711,65,44,49,6,98,262,不合格
20053712,87,9,78,16,42,232,不合格
20053713,7,40,99,87,88,321,合格
20053714,75,82,3,72,18,250,不合格
20053715,67,98,2,62,43,272,不合格
20053716,95,89,23,1,3,211,不合格
20053717,28,5,53,10,38,134,不合格
20053718,10,44,75,42,64,235,不合格
20053719,62,21,11,70,2,166,不合格
20053720,15,42,58,18,90,223,不合格
20053721,49,51,44,28,78,250,不合格
20053722,50,60,38,27,88,263,不合格
20053723,86,37,45,99,3,270,不合格
20053724,1,20,30,74,16,141,不合格
20053725,34,39,70,46,80,269,不合格
20053726,32,0,28,23,27,110,不合格
20053727,91,66,79,17,14,267,不合格
20053728,16,93,91,91,50,341,合格
20053729,81,60,22,40,14,217,不合格
20053730,34,73,19,69,7,202,不合格
20053731,21,83,79,67,20,270,不合格
20053732,50,23,32,1,17,123,不合格
20053733,6,18,83,12,90,209,不合格
20053734,87,23,71,1,0,182,不合格
20053735,46,30,29,83,56,244,不合格
20053736,36,28,90,0,62,216,不合格
20053737,48,70,68,0,65,251,不合格
20053738,65,18,24,41,58,206,不合格
20053739,9,18,81,62,78,248,不合格
20053740,42,87,5,1,71,206,不合格
20053741,8,92,18,56,5,179,不合格
20053742,24,15,24,96,28,187,不合格
20053743,86,21,33,33,68,241,不合格
20053744,1,16,97,17,94,225,不合格
20053745,71,11,32,87,61,262,不合格
20053746,53,58,41,26,9,187,不合格
20053747,88,99,37,36,18,278,不合格
20053748,33,45,59,9,81,227,不合格
20053749,9,54,65,78,16,222,不合格
20053750,31,81,30,67,73,282,不合格
20053751,40,17,30,44,66,197,不合格
20053752,69,14,44,59,66,252,不合格
20053753,55,94,36,85,92,362,合格
20053754,25,92,18,64,7,206,不合格
20053755,88,67,40,5,8,208,不合格
20053756,0,3,65,33,93,194,不合格
20053757,33,18,11,29,94,185,不合格
20053758,35,59,53,25,35,207,不合格
20053759,51,86,1,78,16,232,不合格
20053760,84,35,73,19,22,233,不合格
20053761,47,49,20,0,35,151,不合格
20053762,68,29,23,20,1,141,不合格
20053763,91,37,79,18,90,315,合格
20053764,12,68,11,87,37,215,不合格
20053765,17,84,92,24,28,245,不合格
20053766,76,5,57,24,35,197,不合格
20053767,61,60,81,7,5,214,不合格
20053768,77,22,59,87,78,323,合格
20053769,8,4,49,66,49,176,不合格
20053770,34,82,64,35,70,285,不合格
20053771,44,29,61,14,27,175,不合格
20053772,1,85,99,44,62,291,不合格
20053773,22,58,27,92,89,288,不合格
20053774,46,10,39,99,94,288,不合格
20053775,39,34,4,86,31,194,不合格
20053776,79,54,57,58,41,289,不合格
20053777,72,83,51,6,94,306,合格
20053778,15,58,10,58,80,221,不合格
20053779,9,36,93,66,85,289,不合格
20053780,20,23,88,9,22,162,不合格
20053781,26,21,21,66,71,205,不合格
20053782,50,80,86,16,13,245,不合格
20053783,73,33,35,62,50,253,不合格
20053784,5,98,6,44,48,201,不合格
20053785,92,97,31,22,38,280,不合格
20053786,46,15,80,16,25,182,不合格
20053787,15,93,37,45,33,223,不合格
20053788,33,69,72,22,68,264,不合格
20053789,78,30,42,31,96,277,不合格
20053790,8,76,73,70,85,312,合格
20053791,1,0,44,46,38,129,不合格
20053792,27,7,2,16,64,116,不合格
20053793,46,63,56,0,41,206,不合格
20053794,36,44,66,54,62,262,不合格
20053795,80,58,90,60,80,368,合格
20053796,85,25,78,22,26,236,不合格
20053797,42,42,29,2,3,118,不合格
20053798,86,35,41,70,82,314,合格
20053799,78,75,87,90,30,360,合格
20053800,62,94,9,73,30,268,不合格
20053801,64,66,92,96,60,378,合格
20053802,88,13,29,19,40,189,不合格
20053803,2,5,32,27,17,83,不合格
20053804,46,36,25,54,5,166,不合格
20053805,19,31,14,44,80,188,不合格
20053806,93,33,45,58,35,264,不合格
20053807,69,71,24,91,65,320,合格
20053808,64,46,23,9,82,224,不合格
20053809,81,58,10,6,61,216,不合格
20053810,2,53,3,51,78,187,不合格
20053811,47,37,26,4,95,209,不合格
20053812,22,69,20,44,48,203,不合格
20053813,30,52,8,73,17,180,不合格
20053814,25,7,89,80,48,249,不合格
20053815,64,26,98,63,51,302,合格
20053816,15,53,45,17,65,195,不合格
20053817,83,1,46,64,2,196,不合格
20053818,24,25,80,60,71,260,不合格
20053819,99,73,19,18,54,263,不合格
20053820,35,4,17,50,4,110,不合格
20053821,25,95,89,13,6,228,不合格
20053822,41,2,84,44,29,200,不合格
20053823,60,91,79,27,88,345,合格
20053824,83,65,12,48,84,292,不合格
20053825,73,72,48,88,95,376,合格
20053826,5,63,62,79,14,223,不合格
20053827,45,10,34,64,33,186,不合格
20053828,44,46,6,81,56,233,不合格
20053829,66,80,51,14,37,248,不合格
20053830,30,16,12,11,85,154,不合格
20053831,96,30,32,33,72,263,不合格
20053832,80,50,10,63,57,260,不合格
20053833,22,14,62,70,57,225,不合格
20053834,88,82,40,4,78,292,不合格
20053835,67,33,41,11,17,169,不合格
20053836,7,11,13,93,98,222,不合格
20053837,52,89,27,97,30,295,不合格
20053838,55,28,72,52,42,249,不合格
20053839,20,18,44,65,97,244,不合格
20053840,40,44,5,67,92,248,不合格
20053841,9,67,64,9,21,170,不合格
20053842,89,40,86,83,35,333,合格
20053843,43,88,65,42,30,268,不合格
20053844,23,96,1,64,54,238,不合格
20053845,46,38,34,20,30,168,不合格
20053846,45,98,90,56,73,362,合格
20053847,50,13,65,74,21,223,不合格
20053848,39,53,39,21,23,175,不合格
20053849,28,72,45,57,16,218,不合格
20053850,85,32,0,73,16,206,不合格
20053851,39,92,55,50,38,274,不合格
20053852,96,12,21,79,89,297,不合格
20053853,74,94,8,59,48,283,不合格
20053854,28,87,93,27,35,270,不合格
20053855,81,34,78,77,19,289,不合格
20053856,89,37,92,84,14,316,合格
20053857,4,53,0,24,74,155,不合格
20053858,26,96,23,41,56,242,不合格
20053859,95,93,10,84,48,330,合格
20053860,30,69,48,66,56,269,不合格
20053861,20,27,97,69,44,257,不合格
20053862,14,71,21,3,56,165,不合格
20053863,5,72,11,99,14,201,不合格
20053864,50,87,96,36,67,336,合格
20053865,49,75,31,19,28,202,不合格
20053866,99,29,10,90,48,276,不合格
20053867,15,51,26,76,65,233,不合格
20053868,35,36,31,31,50,183,不合格
20053869,83,45,81,10,71,290,不合格
20053870,43,44,98,88,55,328,合格
20053871,43,76,18,18,60,215,不合格
20053872,78,92,89,99,28,386,合格
20053873,65,44,81,13,62,265,不合格
20053874,15,14,28,5,39,101,不合格
20053875,3,97,25,70,21,216,不合格
20053876,50,1,94,44,93,282,不合格
20053877,15,17,86,87,5,210,不合格
20053878,37,15,24,42,70,188,不合格
20053879,25,82,72,24,76,279,不合格
20053880,71,87,49,68,31,306,合格
20053881,37,12,57,32,21,159,不合格
20053882,37,54,90,11,44,236,不合格
20053883,40,33,0,80,12,165,不合格
20053884,79,56,46,14,28,223,不合格
20053885,45,54,46,66,32,243,不合格
20053886,35,2,19,85,7,148,不合格
20053887,2,14,15,82,15,128,不合格
20053888,68,47,59,79,62,315,合格
20053889,92,52,50,40,40,274,不合格
20053890,97,48,13,1,26,185,不合格
20053891,41,78,0,49,81,249,不合格
20053892,4,89,68,79,9,249,不合格
20053893,27,9,63,14,71,184,不合格
20053894,62,72,76,88,62,360,合格
20053895,32,11,75,36,52,206,不合格
20053896,27,30,27,66,39,189,不合格
20053897,21,80,18,13,85,217,不合格
20053898,39,29,75,20,88,251,不合格
20053899,65,37,93,36,80,311,合格
20053900,82,23,42,38,16,201,不合格
20053901,43,72,84,9,11,219,不合格
20053902,49,54,0,84,86,273,不合格
20053903,3,83,74,7,41,208,不合格
20053904,8,11,67,13,11,110,不合格
20053905,58,26,80,46,36,246,不合格
20053906,56,10,46,12,30,154,不合格
20053907,31,2,39,90,50,212,不合格
20053908,32,83,75,58,45,293,不合格
20053909,14,58,22,36,88,218,不合格
20053910,43,48,30,69,40,230,不合格
20053911,51,42,89,23,32,237,不合格
20053912,78,44,41,42,42,247,不合格
20053913,68,31,46,64,61,270,不合格
20053914,30,87,58,57,27,259,不合格
20053915,13,36,43,29,53,174,不合格
20053916,12,43,29,96,73,253,不合格
20053917,83,17,78,30,47,255,不合格
20053918,65,8,49,51,20,193,不合格
20053919,5,2,9,12,85,113,不合格
20053920,3,66,94,33,76,272,不合格
20053921,10,21,24,5,61,121,不合格
20053922,5,42,69,97,14,227,不合格
20053923,5,76,42,43,16,182,不合格
20053924,88,8,35,68,41,240,不合格
20053925,62,44,94,91,37,328,合格
20053926,10,71,72,16,96,265,不合格
20053927,94,73,41,70,61,339,合格
20053928,98,26,46,44,86,300,合格
20053929,29,52,8,32,42,163,不合格
20053930,75,55,36,18,66,250,不合格
20053931,35,31,21,46,58,191,不合格
20053932,63,64,50,26,32,235,不合格
20053933,86,84,63,80,56,369,合格
20053934,61,78,22,59,76,296,不合格
20053935,37,55,28,10,77,207,不合格
20053936,10,39,4,80,12,145,不合格
20053937,33,1,1,60,69,164,不合格
20053938,51,64,99,64,23,301,合格
20053939,71,90,78,28,47,314,合格
20053940,38,62,51,28,80,259,不合格
20053941,23,21,92,50,24,210,不合格
20053942,58,33,20,17,95,223,不合格
20053943,87,35,66,67,53,308,合格
20053944,24,18,97,67,27,233,不合格
20053945,49,83,83,42,98,355,合格
20053946,59,9,38,18,8,132,不合格
20053947,78,52,24,33,58,245,不合格
20053948,31,60,22,28,91,232,不合格
20053949,3,39,34,25,6,107,不合格
20053950,88,32,27,79,17,243,不合格
20053951,83,71,25,72,99,350,合格
20053952,50,13,18,47,30,158,不合格
20053953,88,16,25,99,73,301,合格
20053954,86,8,30,4,17,145,不合格
20053955,71,1,10,33,5,120,不合格
20053956,82,10,1,68,25,186,不合格
20053957,74,56,39,33,75,277,不合格
20053958,1,26,96,8,67,198,不合格
20053959,68,85,65,10,35,263,不合格
20053960,71,12,4,32,41,160,不合格
20053961,20,3,26,32,46,127,不合格
20053962,46,74,38,66,84,308,合格
20053963,76,45,15,56,95,287,不合格
20053964,98,20,47,33,53,251,不合格
20053965,36,18,65,7,61,187,不合格
20053966,1,36,50,93,31,211,不合格
20053967,30,26,25,27,78,186,不合格
20053968,53,52,20,43,46,214,不合格
20053969,94,45,59,82,55,335,合格
20053970,88,7,32,49,56,232,不合格
20053971,20,87,4,71,72,254,不合格
20053972,53,77,55,61,81,327,合格
20053973,93,73,37,81,99,383,合格
20053974,56,48,83,33,52,272,不合格
20053975,83,85,96,23,60,347,合格
20053976,88,79,18,6,49,240,不合格
20053977,67,30,11,5,86,199,不合格
20053978,49,72,12,86,30,249,不合格
20053979,51,44,58,91,87,331,合格
20053980,95,10,32,10,19,166,不合格
20053981,39,65,35,8,2,149,不合格
20053982,91,29,82,95,55,352,合格
20053983,44,60,18,46,74,242,不合格
20053984,59,18,52,13,60,202,不合格
20053985,90,40,2,56,53,241,不合格
20053986,69,81,57,71,85,363,合格
20053987,22,48,45,74,1,190,不合格
20053988,87,96,55,56,18,312,合格
20053989,16,98,38,9,0,161,不合格
20053990,51,93,31,16,82,273,不合格
20053991,21,28,72,10,12,143,不合格
20053992,57,97,57,55,6,272,不合格
20053993,96,86,95,57,68,402,合格
20053994,4,55,24,7,67,157,不合格
20053995,83,51,14,28,51,227,不合格
20053996,25,96,63,5,38,227,不合格
20053997,7,24,88,83,2,204,不合格
20053998,42,97,65,83,76,363,合格
20053999,96,91,94,30,46,357,合格
20054000,95,86,1,92,7,281,不合格
20054001,2,1,3,25,67,98,不合格
20054002,76,30,30,93,81,310,合格
20054003,5,58,78,53,68,262,不合格
20054004,99,10,0,80,74,263,不合格
20054005,8,6,98,81,41,234,不合格
20054006,42,30,81,0,82,235,不合格
20054007,17,49,3,74,42,185,不合格
20054008,64,96,2,68,91,321,合格
20054009,53,65,46,63,93,320,合格
20054010,98,3,87,79,96,363,合格
20054011,78,85,14,67,63,307,合格
20054012,14,63,26,35,48,186,不合格
20054013,70,48,57,14,37,226,不合格
20054014,11,8,7,78,76,180,不合格
20054015,80,83,65,43,95,366,合格
20054016,97,87,5,52,21,262,不合格
20054017,58,11,43,12,57,181,不合格
20054018,27,68,12,88,49,244,不合格
20054019,59,17,57,65,26,224,不合格
20054020,54,81,16,38,94,283,不合格
20054021,99,30,61,96,55,341,合格
20054022,60,28,88,46,96,318,合格
20054023,13,48,94,60,37,252,不合格
20054024,16,73,18,85,47,239,不合格
20054025,93,35,86,62,64,340,合格
20054026,25,49,38,34,38,184,不合格
20054027,88,45,61,68,69,331,合格
20054028,15,3,67,89,96,270,不合格
20054029,72,25,71,82,33,283,不合格
20054030,55,15,36,86,75,267,不合格
20054031,74,89,93,99,71,426,合格
20054032,61,54,67,44,15,241,不合格
20054033,51,56,25,68,73,273,不合格
20054034,86,32,88,96,4,306,合格
20054035,51,44,42,0,65,202,不合格
20054036,83,65,53,72,74,347,合格
20054037,59,29,53,99,39,279,不合格
20054038,51,84,73,42,73,323,合格
20054039,75,54,39,83,86,337,合格
20054040,93,20,32,38,54,237,不合格
20054041,49,80,75,95,79,378,合格
20054042,41,33,31,3,19,127,不合格
20054043,65,70,87,44,44,310,合格
20054044,37,98,69,78,65,347,合格
20054045,73,44,97,59,31,304,合格
20054046,90,47,66,0,11,214,不合格
20054047,28,25,22,3,6,84,不合格
20054048,28,12,26,73,6,145,不合格
20054049,45,12,91,55,86,289,不合格
20054050,44,47,47,4,44,186,不合格
20054051,79,17,70,62,29,257,不合格
20054052,41,48,79,83,9,260,不合格
20054053,60,74,75,66,60,335,合格
20054054,6,95,63,21,79,264,不合格
20054055,38,85,45,21,24,213,不合格
20054056,39,17,24,64,53,197,不合格
20054057,47,41,37,70,39,234,不合格
20054058,78,96,54,89,79,396,合格
20054059,25,24,67,76,18,210,不合格
20054060,1,51,83,95,68,298,不合格
20054061,91,55,22,96,39,303,合格
20054062,48,51,76,94,21,290,不合格
20054063,1,12,97,25,6,141,不合格
20054064,23,56,9,1,89,178,不合格
20054065,55,0,46,60,89,250,不合格
20054066,39,75,96,21,88,319,合格
20054067,43,15,76,7,11,152,不合格
20054068,53,70,56,42,12,233,不合格
20054069,38,73,20,51,12,194,不合格
20054070,2,3,80,90,83,258,不合格
20054071,88,35,8,18,69,218,不合格
20054072,35,39,4,77,87,242,不合格
20054073,49,13,45,44,76,227,不合格
20054074,37,45,82,26,65,255,不合格
20054075,60,15,35,46,10,166,不合格
20054076,35,45,48,95,53,276,不合格
20054077,80,84,89,47,14,314,合格
20054078,20,78,68,83,86,335,合格
20054079,96,36,12,18,87,249,不合格
20054080,54,86,14,78,54,286,不合格
20054081,41,97,96,12,3,249,不合格
20054082,83,27,22,69,79,280,不合格
20054083,5,6,21,79,20,131,不合格
20054084,26,87,73,96,70,352,合格
20054085,57,31,92,6,56,242,不合格
20054086,97,15,54,50,52,268,不合格
20054087,67,99,69,22,84,341,合格
20054088,55,61,57,25,97,295,不合格
20054089,67,96,95,45,10,313,合格
20054090,25,96,27,35,26,209,不合格
20054091,52,14,93,29,44,232,不合格
20054092,61,4,84,58,46,253,不合格
20054093,32,96,19,99,43,289,不合格
20054094,10,66,92,30,17,215,不合格
20054095,50,93,33,1,40,217,不合格
20054096,76,63,55,92,48,334,合格
20054097,36,98,59,40,71,304,合格
20054098,12,49,5,41,67,174,不合格
20054099,57,15,78,75,62,287,不合格
20054100,3,48,21,8,72,152,不合格
20054101,15,90,63,60,13,241,不合格
20054102,66,3,71,60,99,299,不合格
20054103,93,82,64,93,86,418,合格
20054104,26,8,20,0,16,70,不合格
20054105,92,26,58,39,29,244,不合格
20054106,77,79,59,1,85,301,合格
20054107,88,18,40,76,28,250,不合格
20054108,50,24,50,86,58,268,不合格
20054109,33,47,48,54,76,258,不合格
20054110,70,96,2,39,49,256,不合格
20054111,19,2,30,32,82,165,不合格
20054112,59,68,6,89,49,271,不合格
20054113,33,28,17,66,36,180,不合格
20054114,12,93,39,1,1,146,不合格
20054115,88,82,47,21,24,262,不合格
20054116,66,73,16,95,60,310,合格
20054117,25,88,94,38,83,328,合格
20054118,63,48,41,49,38,239,不合格
20054119,56,96,11,57,67,287,不合格
20054120,80,40,97,2,97,316,合格
20054121,91,72,2,16,27,208,不合格
20054122,73,53,82,99,13,320,合格
20054123,35,77,58,36,17,223,不合格
20054124,91,96,7,24,5,223,不合格
20054125,87,69,31,51,30,268,不合格
20054126,12,57,58,59,18,204,不合格
20054127,84,69,34,73,21,281,不合格
20054128,29,54,32,92,2,209,不合格
20054129,89,73,5,19,99,285,不合格
20054130,60,66,77,71,6,280,不合格
20054131,51,0,8,6,59,124,不合格
20054132,13,95,66,21,23,218,不合格
20054133,92,60,29,30,18,229,不合格
20054134,62,53,71,44,39,269,不合格
20054135,31,36,93,6,58,224,不合格
20054136,97,69,40,56,92,354,合格
20054137,90,24,66,25,82,287,不合格
20054138,16,44,7,61,78,206,不合格
20054139,16,73,20,38,62,209,不合格
20054140,29,16,34,83,98,260,不合格
20054141,7,22,7,21,93,150,不合格
20054142,75,69,84,85,99,412,合格
20054143,4,96,82,36,2,220,不合格
20054144,22,12,23,5,55,117,不合格
20054145,93,79,18,87,60,337,合格
20054146,32,93,71,8,93,297,不合格
20054147,17,70,30,13,74,204,不合格
20054148,68,80,9,86,62,305,合格
20054149,84,81,31,2,77,275,不合格
20054150,17,66,83,83,34,283,不合格
20054151,6,41,36,78,17,178,不合格
20054152,42,33,17,77,53,222,不合格
20054153,36,77,63,87,26,289,不合格
20054154,48,59,19,33,7,166,不合格
20054155,34,23,16,86,68,227,不合格
20054156,6,93,85,78,1,263,不合格
20054157,31,70,57,44,79,281,不合格
20054158,79,49,0,52,93,273,不合格
20054159,83,67,72,58,84,364,合格
20054160,64,61,97,72,99,393,合格
20054161,77,56,65,58,94,350,合格
20054162,76,51,93,23,99,342,合格
20054163,60,14,8,38,86,206,不合格
20054164,77,66,84,76,62,365,合格
20054165,52,1,72,14,88,227,不合格
20054166,81,56,54,58,4,253,不合格
20054167,2,88,58,43,88,279,不合格
20054168,32,32,16,70,78,228,不合格
20054169,88,51,99,33,54,325,合格
20054170,43,45,19,89,1,197,不合格
20054171,24,60,41,11,45,181,不合格
20054172,81,6,87,86,43,303,合格
20054173,62,16,90,4,7,179,不合格
20054174,7,57,95,44,63,266,不合格
20054175,60,97,9,83,25,274,不合格
20054176,94,72,71,37,96,370,合格
20054177,83,49,61,89,72,354,合格
20054178,37,55,25,65,36,218,不合格
20054179,59,51,31,38,87,266,不合格
20054180,13,75,24,30,13,155,不合格
20054181,45,42,61,45,59,252,不合格
20054182,92,16,82,71,80,341,合格
20054183,10,86,11,39,52,198,不合格
20054184,92,82,86,93,10,363,合格
20054185,52,13,11,81,93,250,不合格
20054186,75,14,44,64,40,237,不合格
20054187,95,52,96,55,25,323,合格
20054188,97,32,0,55,37,221,不合格
20054189,67,32,1,24,70,194,不合格
20054190,18,95,47,76,52,288,不合格
20054191,82,81,78,31,97,369,合格
20054192,13,49,33,16,59,170,不合格
20054193,61,42,34,26,17,180,不合格
20054194,23,9,5,7,93,137,不合格
20054195,0,8,52,8,11,79,不合格
20054196,78,80,18,56,33,265,不合格
20054197,11,61,11,30,83,196,不合格
20054198,88,15,48,57,26,234,不合格
20054199,83,57,69,8,52,269,不合格
20054200,35,10,2,12,33,92,不合格
20054201,89,79,95,58,40,361,合格
20054202,89,64,91,44,20,308,合格
20054203,59,43,96,25,85,308,合格
20054204,61,63,26,39,58,247,不合格
20054205,80,38,49,62,20,249,不合格
20054206,42,49,75,6,8,180,不合格
20054207,46,54,34,38,72,244,不合格
20054208,38,54,15,66,83,256,不合格
20054209,5,78,79,9,25,196,不合格
20054210,63,98,77,35,54,327,合格
20054211,34,29,28,55,36,182,不合格
20054212,17,70,79,60,5,231,不合格
20054213,24,31,27,61,92,235,不合格
20054214,20,79,30,76,58,263,不合格
20054215,53,38,31,39,16,177,不合格
20054216,21,69,20,3,18,131,不合格
20054217,38,87,30,35,9,199,不合格
20054218,27,59,20,66,2,174,不合格
20054219,24,92,32,85,96,329,合格
20054220,28,35,44,19,62,188,不合格
20054221,74,26,65,18,39,222,不合格
20054222,65,40,70,28,25,228,不合格
20054223,8,8,6,21,77,120,不合格
20054224,25,9,29,81,29,173,不合格
20054225,67,46,48,24,90,275,不合格
20054226,8,11,19,54,25,117,不合格
20054227,73,63,36,4,14,190,不合格
20054228,2,57,82,56,76,273,不合格
20054229,48,74,82,17,99,320,合格
20054230,82,35,91,5,29,242,不合格
20054231,6,38,85,66,70,265,不合格
20054232,76,62,78,56,67,339,合格
20054233,76,82,65,54,46,323,合格
20054234,21,12,74,47,99,253,不合格
20054235,63,18,95,63,87,326,合格
20054236,12,80,49,70,54,265,不合格
20054237,78,60,7,84,42,271,不合格
20054238,21,57,8,65,75,226,不合格
20054239,59,1,99,63,30,252,不合格
20054240,29,5,0,99,78,211,不合格
20054241,12,92,94,82,51,331,合格
20054242,40,33,32,0,58,163,不合格
20054243,37,80,38,98,71,324,合格
20054244,35,47,50,34,47,213,不合格
20054245,32,82,71,40,8,233,不合格
20054246,7,31,47,53,34,172,不合格
20054247,6,87,13,50,63,219,不合格
20054248,7,7,75,32,28,149,不合格
20054249,4,31,47,73,66,221,不合格
20054250,71,4,39,36,54,204,不合格
20054251,61,84,19,5,47,216,不合格
20054252,73,88,90,8,58,317,合格
20054253,43,1,25,5,27,101,不合格
20054254,56,91,71,64,76,358,合格
20054255,29,71,44,73,84,301,合格
20054256,76,50,10,61,12,209,不合格
20054257,31,6,86,9,91,223,不合格
20054258,6,57,91,21,51,226,不合格
20054259,71,6,52,10,91,230,不合格
20054260,27,43,62,87,41,260,不合格
20054261,24,83,70,16,15,208,不合格
20054262,68,90,24,10,54,246,不合格
20054263,53,89,73,58,91,364,合格
20054264,78,76,57,11,80,302,合格
20054265,58,76,97,51,38,320,合格
20054266,87,87,47,21,71,313,合格
20054267,64,15,40,75,59,253,不合格
20054268,44,85,35,22,65,251,不合格
20054269,14,19,18,99,25,175,不合格
20054270,88,81,89,29,56,343,合格
20054271,92,22,33,79,83,309,合格
20054272,51,72,9,37,62,231,不合格
20054273,51,80,24,22,75,252,不合格
20054274,48,76,18,89,7,238,不合格
20054275,88,90,57,75,72,382,合格
20054276,36,75,11,11,56,189,不合格
20054277,76,0,37,52,22,187,不合格
20054278,92,62,46,8,59,267,不合格
20054279,23,40,95,48,1,207,不合格
20054280,99,83,11,84,39,316,合格
20054281,74,64,73,86,79,376,合格
20054282,64,10,44,98,92,308,合格
20054283,76,1,71,17,84,249,不合格
20054284,43,21,50,44,72,230,不合格
20054285,56,1,50,40,10,157,不合格
20054286,57,95,22,13,57,244,不合格
20054287,39,46,97,42,5,229,不合格
20054288,82,53,52,82,16,285,不合格
20054289,33,95,1,37,46,212,不合格
20054290,67,27,70,13,91,268,不合格
20054291,39,72,44,82,9,246,不合格
20054292,18,4,95,34,16,167,不合格
20054293,2,5,21,17,28,73,不合格
20054294,89,96,16,81,78,360,合格
20054295,78,99,56,20,5,258,不合格
20054296,12,27,64,74,38,215,不合格
20054297,3,1,39,15,60,118,不合格
20054298,18,71,47,43,76,255,不合格
20054299,25,96,90,31,2,244,不合格
20054300,10,93,57,46,42,248,不合格
20054301,33,22,32,69,55,211,不合格
20054302,72,55,39,66,78,310,合格
20054303,8,22,75,70,54,229,不合格
20054304,60,1,29,35,70,195,不合格
20054305,39,31,57,63,34,224,不合格
20054306,92,87,65,74,88,406,合格
20054307,96,92,74,27,85,374,合格
20054308,3,54,37,8,78,180,不合格
20054309,75,16,15,53,67,226,不合格
20054310,65,4,83,45,41,238,不合格
20054311,78,21,75,46,98,318,合格
20054312,39,82,68,11,40,240,不合格
20054313,77,83,59,0,31,250,不合格
20054314,24,61,9,88,92,274,不合格
20054315,50,67,71,40,98,326,合格
20054316,87,29,69,46,13,244,不合格
20054317,7,18,93,59,60,237,不合格
20054318,60,80,77,5,60,282,不合格
20054319,37,68,7,8,43,163,不合格
20054320,49,46,17,73,74,259,不合格
20054321,78,24,89,89,23,303,合格
20054322,8,37,86,98,64,293,不合格
20054323,86,8,98,13,27,232,不合格
20054324,17,37,93,23,17,187,不合格
20054325,95,39,24,90,61,309,合格
20054326,8,50,52,97,53,260,不合格
20054327,39,60,5,30,52,186,不合格
20054328,78,97,88,49,33,345,合格
20054329,47,90,42,21,56,256,不合格
20054330,59,14,88,78,91,330,合格
20054331,8,18,72,44,78,220,不合格
20054332,34,58,83,98,62,335,合格
20054333,40,30,75,81,50,276,不合格
20054334,92,92,11,69,27,291,不合格
20054335,93,15,57,32,33,230,不合格
20054336,77,64,84,70,96,391,合格
20054337,71,34,20,85,37,247,不合格
20054338,11,91,17,43,39,201,不合格
20054339,11,13,70,80,18,192,不合格
20054340,53,24,39,14,74,204,不合格
20054341,43,26,60,73,61,263,不合格
20054342,43,23,11,97,70,244,不合格
20054343,43,68,36,60,86,293,不合格
20054344,74,55,34,52,95,310,合格
20054345,93,98,30,11,2,234,不合格
20054346,10,71,78,14,34,207,不合格
20054347,10,92,75,10,38,225,不合格
20054348,84,90,32,29,93,328,合格
20054349,26,55,63,99,56,299,不合格
20054350,67,14,75,65,63,284,不合格
20054351,16,77,84,75,87,339,合格
20054352,10,9,35,47,96,197,不合格
20054353,16,46,30,71,67,230,不合格
20054354,39,48,91,23,44,245,不合格
20054355,62,46,34,49,27,218,不合格
20054356,27,5,46,20,40,138,不合格
20054357,56,4,93,60,25,238,不合格
20054358,39,43,36,38,95,251,不合格
20054359,74,73,88,12,41,288,不合格
20054360,99,67,3,85,25,279,不合格
20054361,10,41,52,3,83,189,不合格
20054362,45,14,45,59,85,248,不合格
20054363,21,40,96,36,98,291,不合格
20054364,82,86,21,80,34,303,合格
20054365,11,43,32,16,37,139,不合格
20054366,8,50,52,25,73,208,不合格
20054367,0,15,10,60,7,92,不合格
20054368,55,6,13,64,9,147,不合格
20054369,91,47,1,83,1,223,不合格
20054370,36,44,18,15,44,157,不合格
20054371,50,80,57,91,4,282,不合格
20054372,91,86,61,19,42,299,不合格
20054373,47,95,90,86,61,379,合格
20054374,58,35,4,1,54,152,不合格
20054375,18,4,47,92,8,169,不合格
20054376,90,79,42,58,37,306,合格
20054377,70,7,39,27,25,168,不合格
20054378,54,19,6,18,9,106,不合格
20054379,1,67,56,93,79,296,不合格
20054380,41,43,22,12,31,149,不合格
20054381,74,81,55,12,8,230,不合格
20054382,43,26,57,48,18,192,不合格
20054383,1,98,76,53,8,236,不合格
20054384,44,17,40,18,73,192,不合格
20054385,33,87,44,97,58,319,合格
20054386,23,9,76,40,42,190,不合格
20054387,52,94,11,18,9,184,不合格
20054388,39,76,86,98,21,320,合格
20054389,87,14,1,39,99,240,不合格
20054390,81,18,79,79,12,269,不合格
20054391,24,23,97,74,52,270,不合格
20054392,51,97,13,55,22,238,不合格
20054393,61,64,4,16,78,223,不合格
20054394,71,45,72,78,85,351,合格
20054395,23,28,69,51,20,191,不合格
20054396,41,20,65,17,57,200,不合格
20054397,72,62,2,26,83,245,不合格
20054398,1,58,42,31,7,139,不合格
20054399,26,68,65,34,10,203,不合格
20054400,48,71,59,10,22,210,不合格
20054401,22,74,38,14,47,195,不合格
20054402,67,15,34,44,83,243,不合格
20054403,0,27,27,90,23,167,不合格
20054404,95,48,79,39,85,346,合格
20054405,36,19,79,68,45,247,不合格
20054406,67,77,1,59,34,238,不合格
20054407,92,28,78,33,86,317,合格
20054408,38,60,15,43,65,221,不合格
20054409,76,25,48,69,95,313,合格
20054410,25,39,71,69,84,288,不合格
20054411,8,18,75,58,79,238,不合格
20054412,86,70,8,59,77,300,合格
20054413,15,84,58,29,5,191,不合格
20054414,27,35,53,39,97,251,不合格
20054415,39,21,55,6,69,190,不合格
20054416,60,3,59,47,22,191,不合格
20054417,97,1,67,20,49,234,不合格
20054418,45,71,87,90,92,385,合格
20054419,22,59,78,2,19,180,不合格
20054420,59,88,5,48,61,261,不合格
20054421,18,54,7,70,99,248,不合格
20054422,16,84,59,90,44,293,不合格
20054423,40,16,59,8,11,134,不合格
20054424,45,33,59,86,45,268,不合格
20054425,58,22,23,89,40,232,不合格
20054426,11,16,63,82,43,215,不合格
20054427,17,61,93,57,59,287,不合格
20054428,39,3,55,93,6,196,不合格
20054429,56,97,20,39,79,291,不合格
20054430,88,62,12,60,65,287,不合格
20054431,72,73,79,81,97,402,合格
20054432,41,37,39,3,50,170,不合格
20054433,30,54,11,72,91,258,不合格
20054434,79,48,12,8,14,161,不合格
20054435,21,82,4,79,52,238,不合格
20054436,16,12,0,52,41,121,不合格
20054437,62,89,10,76,85,322,合格
20054438,47,16,56,2,56,177,不合格
20054439,50,57,50,42,37,236,不合格
20054440,92,89,1,69,74,325,合格
20054441,59,47,73,42,60,281,不合格
20054442,88,41,19,36,40,224,不合格
20054443,75,27,91,96,57,346,合格
20054444,42,42,18,99,47,248,不合格
20054445,38,33,41,81,57,250,不合格
20054446,87,64,10,75,12,248,不合格
20054447,83,43,14,9,49,198,不合格
20054448,94,55,96,61,21,327,合格
20054449,52,93,66,53,74,338,合格
20054450,42,51,39,57,15,204,不合格
20054451,19,42,13,68,50,192,不合格
20054452,39,68,68,37,43,255,不合格
20054453,87,52,42,97,92,370,合格
20054454,12,81,12,88,40,233,不合格
20054455,16,73,16,30,34,169,不合格
20054456,90,24,48,63,53,278,不合格
20054457,19,55,19,11,9,113,不合格
20054458,93,61,79,73,60,366,合格
20054459,32,67,26,98,14,237,不合格
20054460,68,34,2,39,63,206,不合格
20054461,15,88,88,74,81,346,合格
20054462,7,81,87,52,17,244,不合格
20054463,82,19,98,54,51,304,合格
20054464,81,58,27,29,45,240,不合格
20054465,10,57,60,63,78,268,不合格
20054466,61,57,57,13,39,227,不合格
20054467,7,80,64,47,72,270,不合格
20054468,86,69,18,43,58,274,不合格
20054469,43,21,18,47,36,165,不合格
20054470,66,76,9,54,56,261,不合格
20054471,77,75,8,51,91,302,合格
20054472,58,18,84,32,15,207,不合格
20054473,82,18,26,0,22,148,不合格
20054474,55,55,52,20,70,252,不合格
20054475,85,74,92,99,41,391,合格
20054476,76,22,49,64,15,226,不合格
20054477,44,73,25,71,87,300,合格
20054478,53,36,45,54,76,264,不合格
20054479,26,84,40,43,66,259,不合格
20054480,74,87,72,76,46,355,合格
20054481,90,28,74,97,82,371,合格
20054482,75,52,65,7,84,283,不合格
20054483,88,0,33,43,98,262,不合格
20054484,28,99,98,12,79,316,合格
20054485,42,18,93,82,41,276,不合格
20054486,9,26,28,18,10,91,不合格
20054487,88,8,66,99,69,330,合格
20054488,42,12,83,18,50,205,不合格
20054489,38,94,57,47,21,257,不合格
20054490,23,3,82,32,2,142,不合格
20054491,13,65,72,16,58,224,不合格
20054492,8,0,76,62,91,237,不合格
20054493,78,7,30,92,77,284,不合格
20054494,36,78,31,73,26,244,不合格
20054495,87,99,32,72,46,336,合格
20054496,16,49,59,52,3,179,不合格
20054497,41,75,14,68,41,239,不合格
20054498,58,72,58,25,43,256,不合格
20054499,84,71,99,22,40,316,合格
20054500,90,90,82,59,52,373,合格
20054501,77,84,48,63,95,367,合格
20054502,80,65,4,73,44,266,不合格
20054503,41,19,54,70,4,188,不合格
20054504,29,53,68,18,89,257,不合格
20054505,42,3,52,61,6,164,不合格
20054506,9,44,61,52,99,265,不合格
20054507,14,54,71,1,80,220,不合格
20054508,87,37,90,62,1,277,不合格
20054509,71,82,41,80,32,306,合格
20054510,60,8,99,42,2,211,不合格
20054511,34,77,66,18,32,227,不合格
20054512,72,19,52,71,34,248,不合格
20054513,80,18,8,37,55,198,不合格
20054514,42,12,87,3,8,152,不合格
20054515,86,96,10,29,39,260,不合格
20054516,16,29,74,71,32,222,不合格
20054517,56,60,53,98,40,307,合格
20054518,83,80,47,80,46,336,合格
20054519,84,66,95,15,72,332,合格
20054520,27,58,34,96,82,297,不合格
20054521,44,80,52,5,92,273,不合格
20054522,8,69,44,67,79,267,不合格
20054523,43,97,3,62,91,296,不合格
20054524,36,14,30,8,7,95,不合格
20054525,67,77,82,94,52,372,合格
20054526,15,96,55,42,8,216,不合格
20054527,21,42,39,91,23,216,不合格
20054528,74,23,65,84,22,268,不合格
20054529,89,90,11,45,94,329,合格
20054530,28,86,19,14,89,236,不合格
20054531,62,54,92,78,14,300,合格
20054532,88,65,56,46,39,294,不合格
20054533,35,86,88,14,5,228,不合格
20054534,20,13,23,0,65,121,不合格
20054535,17,5,18,98,21,159,不合格
20054536,5,23,30,63,45,166,不合格
20054537,84,91,56,82,22,335,合格
20054538,83,24,81,25,4,217,不合格
20054539,18,12,46,40,68,184,不合格
20054540,37,92,97,48,29,303,合格
20054541,9,21,47,94,70,241,不合格
20054542,64,15,99,80,92,350,合格
20054543,24,73,80,6,5,188,不合格
20054544,97,72,22,57,26,274,不合格
20054545,33,42,96,54,45,270,不合格
20054546,74,66,56,51,66,313,合格
20054547,80,36,20,95,57,288,不合格
20054548,89,47,3,77,76,292,不合格
20054549,16,84,58,8,6,172,不合格
20054550,5,22,12,11,26,76,不合格
20054551,72,98,57,37,81,345,合格
20054552,67,96,24,68,51,306,合格
20054553,89,29,93,8,37,256,不合格
20054554,68,73,94,3,57,295,不合格
20054555,92,41,91,14,80,318,合格
20054556,41,23,17,48,41,170,不合格
20054557,71,22,38,7,29,167,不合格
20054558,15,2,55,63,98,233,不合格
20054559,79,67,50,77,42,315,合格
20054560,41,91,68,64,10,274,不合格
20054561,69,54,67,97,98,385,合格
20054562,69,18,76,4,40,207,不合格
20054563,66,18,60,23,0,167,不合格
20054564,47,38,15,18,97,215,不合格
20054565,10,68,49,49,19,195,不合格
20054566,73,6,33,14,83,209,不合格
20054567,13,28,19,38,84,182,不合格
20054568,87,94,47,49,32,309,合格
20054569,34,41,19,26,62,182,不合格
20054570,17,92,23,21,10,163,不合格
20054571,48,26,20,77,40,211,不合格
20054572,71,22,41,13,74,221,不合格
20054573,74,10,84,63,51,282,不合格
20054574,46,0,64,4,22,136,不合格
20054575,47,12,56,73,6,194,不合格
20054576,77,69,32,39,17,234,不合格
20054577,64,18,30,66,97,275,不合格
20054578,71,72,74,79,51,347,合格
20054579,28,16,85,26,8,163,不合格
20054580,14,89,33,32,82,250,不合格
20054581,41,70,58,10,52,231,不合格
20054582,31,57,56,69,53,266,不合格
20054583,88,96,95,86,29,394,合格
20054584,48,95,4,60,74,281,不合格
20054585,12,65,45,73,64,259,不合格
20054586,7,13,32,22,87,161,不合格
20054587,86,32,53,70,57,298,不合格
20054588,6,90,75,65,40,276,不合格
20054589,81,20,28,87,28,244,不合格
20054590,47,57,95,57,10,266,不合格
20054591,90,30,95,79,70,364,合格
20054592,79,98,33,54,25,289,不合格
20054593,23,0,57,94,91,265,不合格
20054594,0,79,21,24,15,139,不合格
20054595,77,62,90,1,27,257,不合格
20054596,69,6,30,90,27,222,不合格
20054597,75,51,71,53,75,325,合格
20054598,27,54,57,91,57,286,不合格
20054599,94,54,95,90,61,394,合格
20054600,54,12,6,44,85,201,不合格
20054601,12,14,85,9,99,219,不合格
20054602,38,63,68,60,5,234,不合格
20054603,52,3,2,91,75,223,不合格
20054604,33,44,3,30,49,159,不合格
20054605,13,67,27,28,91,226,不合格
20054606,69,51,82,84,46,332,合格
20054607,8,65,13,41,12,139,不合格
20054608,47,86,41,79,67,320,合格
20054609,49,27,82,29,57,244,不合格
20054610,49,74,11,49,80,263,不合格
20054611,39,47,7,32,58,183,不合格
20054612,22,44,22,17,22,127,不合格
20054613,54,86,64,63,5,272,不合格
20054614,47,17,72,67,98,301,合格
20054615,99,32,12,44,11,198,不合格
20054616,2,75,14,30,36,157,不合格
20054617,43,58,28,45,1,175,不合格
20054618,96,19,79,11,90,295,不合格
20054619,5,70,1,37,18,131,不合格
20054620,3,89,22,18,69,201,不合格
20054621,98,54,18,3,7,180,不合格
20054622,39,91,96,25,76,327,合格
20054623,58,59,89,61,8,275,不合格
20054624,84,69,11,74,67,305,合格
20054625,72,84,46,50,15,267,不合格
20054626,21,51,89,14,52,227,不合格
20054627,95,30,76,93,40,334,合格
20054628,59,14,94,75,53,295,不合格
20054629,22,83,16,81,73,275,不合格
20054630,82,43,9,3,59,196,不合格
20054631,86,99,70,14,58,327,合格
20054632,86,0,57,27,17,187,不合格
20054633,85,28,49,69,71,302,合格
20054634,88,13,35,0,80,216,不合格
20054635,71,27,92,56,48,294,不合格
20054636,61,59,78,51,59,308,合格
20054637,20,91,8,96,55,270,不合格
20054638,64,6,4,63,23,160,不合格
20054639,77,66,60,66,52,321,合格
20054640,89,25,26,83,72,295,不合格
20054641,38,10,57,27,48,180,不合格
20054642,72,55,25,22,64,238,不合格
20054643,91,69,72,83,48,363,合格
20054644,36,51,8,42,50,187,不合格
20054645,16,15,14,90,96,231,不合格
20054646,50,19,39,37,19,164,不合格
20054647,55,66,95,86,48,350,合格
20054648,18,84,2,15,79,198,不合格
20054649,82,90,50,99,36,357,合格
20054650,16,43,55,76,35,225,不合格
20054651,21,1,25,93,79,219,不合格
20054652,10,6,78,59,22,175,不合格
20054653,19,71,68,43,6,207,不合格
20054654,33,76,31,69,25,234,不合格
20054655,71,92,73,89,98,423,合格
20054656,0,72,59,1,24,156,不合格
20054657,79,8,54,96,44,281,不合格
20054658,79,85,29,30,47,270,不合格
20054659,13,41,24,55,40,173,不合格
20054660,98,2,83,1,36,220,不合格
20054661,99,57,83,11,5,255,不合格
20054662,16,65,25,10,22,138,不合格
20054663,20,46,78,62,56,262,不合格
20054664,76,89,28,37,67,297,不合格
20054665,87,60,92,55,5,299,不合格
20054666,17,15,47,32,58,169,不合格
20054667,25,31,19,62,27,164,不合格
20054668,28,79,16,33,75,231,不合格
20054669,97,43,74,58,31,303,合格
20054670,77,57,51,59,42,286,不合格
20054671,22,78,43,28,23,194,不合格
20054672,88,26,0,56,2,172,不合格
20054673,71,51,58,93,61,334,合格
20054674,9,73,33,17,13,145,不合格
20054675,22,95,39,59,13,228,不合格
20054676,15,7,59,69,36,186,不合格
20054677,52,14,4,97,63,230,不合格
20054678,94,75,66,5,34,274,不合格
20054679,62,61,37,7,2,169,不合格
20054680,53,85,11,81,1,231,不合格
20054681,31,39,97,5,20,192,不合格
20054682,60,19,15,8,62,164,不合格
20054683,8,74,50,39,38,209,不合格
20054684,1,37,35,48,75,196,不合格
20054685,32,73,50,84,12,251,不合格
20054686,10,99,5,77,34,225,不合格
20054687,90,37,93,47,1,268,不合格
20054688,23,51,5,42,87,208,不合格
20054689,96,91,21,96,16,320,合格
20054690,41,73,27,8,2,151,不合格
20054691,38,59,45,0,64,206,不合格
20054692,6,36,66,33,10,151,不合格
20054693,78,71,81,51,94,375,合格
20054694,23,36,1,1,47,108,不合格
20054695,57,39,45,97,52,290,不合格
20054696,85,43,94,47,84,353,合格
20054697,68,32,56,74,19,249,不合格
20054698,23,47,6,35,51,162,不合格
20054699,90,89,61,63,34,337,合格
20054700,91,19,95,92,46,343,合格
20054701,71,79,82,90,64,386,合格
20054702,5,18,80,22,67,192,不合格
20054703,9,71,75,36,23,214,不合格
20054704,93,33,51,97,67,341,合格
20054705,5,94,31,23,0,153,不合格
20054706,27,25,96,78,22,248,不合格
20054707,68,28,16,56,98,266,不合格
20054708,14,19,23,49,40,145,不合格
20054709,14,81,9,69,7,180,不合格
20054710,13,67,86,58,18,242,不合格
20054711,59,15,46,56,93,269,不合格
20054712,92,57,6,30,23,208,不合格
20054713,39,31,3,94,47,214,不合格
20054714,88,90,6,61,75,320,合格
20054715,66,27,24,32,31,180,不合格
20054716,17,12,94,57,1,181,不合格
20054717,23,6,67,43,71,210,不合格
20054718,99,52,50,59,38,298,不合格
20054719,51,51,39,57,80,278,不合格
20054720,42,49,90,62,7,250,不合格
20054721,86,28,24,33,55,226,不合格
20054722,55,7,28,53,95,238,不合格
20054723,30,19,96,9,84,238,不合格
20054724,20,0,57,53,19,149,不合格
20054725,56,99,92,39,50,336,合格
20054726,99,22,63,32,44,260,不合格
20054727,51,88,62,54,55,310,合格
20054728,25,83,16,91,0,215,不合格
20054729,50,3,93,52,15,213,不合格
20054730,92,66,36,30,47,271,不合格
20054731,43,12,89,19,42,205,不合格
20054732,21,17,64,71,23,196,不合格
20054733,72,8,57,24,1,162,不合格
20054734,62,95,13,1,7,178,不合格
20054735,83,15,28,19,78,223,不合格
20054736,15,4,28,99,51,197,不合格
20054737,41,62,24,49,49,225,不合格
20054738,10,40,96,48,35,229,不合格
20054739,97,18,59,73,82,329,合格
20054740,99,77,27,76,15,294,不合格
20054741,36,49,47,57,33,222,不合格
20054742,30,40,21,7,8,106,不合格
20054743,68,69,81,20,77,315,合格
20054744,29,38,3,53,83,206,不合格
20054745,80,76,58,29,10,253,不合格
20054746,69,70,58,0,56,253,不合格
20054747,11,23,31,81,5,151,不合格
20054748,87,50,40,0,60,237,不合格
20054749,54,77,4,25,57,217,不合格
20054750,1,70,27,90,69,257,不合格
20054751,49,97,60,79,70,355,合格
20054752,93,98,99,40,14,344,合格
20054753,74,95,45,32,26,272,不合格
20054754,96,85,49,77,19,326,合格
20054755,90,63,64,82,23,322,合格
20054756,23,58,3,45,9,138,不合格
20054757,77,77,48,84,67,353,合格
20054758,82,99,72,72,87,412,合格
20054759,55,63,94,38,1,251,不合格
20054760,84,68,60,44,33,289,不合格
20054761,37,8,48,53,67,213,不合格
20054762,61,22,23,45,75,226,不合格
20054763,84,27,38,89,27,265,不合格
20054764,91,1,13,21,99,225,不合格
20054765,51,49,5,34,10,149,不合格
20054766,98,47,17,11,14,187,不合格
20054767,11,67,54,92,31,255,不合格
20054768,21,93,4,47,76,241,不合格
20054769,13,87,40,44,36,220,不合格
20054770,15,76,35,87,76,289,不合格
20054771,47,75,78,39,92,331,合格
20054772,85,53,80,17,73,308,合格
20054773,40,86,97,10,67,300,合格
20054774,83,44,91,23,99,340,合格
20054775,71,42,25,32,82,252,不合格
20054776,86,44,56,79,62,327,合格
20054777,10,52,33,65,86,246,不合格
20054778,31,52,43,5,80,211,不合格
20054779,14,67,10,57,23,171,不合格
20054780,19,91,10,89,24,233,不合格
20054781,89,22,39,26,89,265,不合格
20054782,66,20,25,95,14,220,不合格
20054783,79,51,75,41,0,246,不合格
20054784,72,64,42,44,99,321,合格
20054785,89,56,10,72,4,231,不合格
20054786,13,78,79,8,33,211,不合格
20054787,4,25,36,20,78,163,不合格
20054788,47,3,89,81,85,305,合格
20054789,54,44,95,82,78,353,合格
20054790,71,54,87,97,61,370,合格
20054791,99,38,4,80,40,261,不合格
20054792,25,47,63,29,3,167,不合格
20054793,66,97,18,52,99,332,合格
20054794,86,72,14,30,85,287,不合格
20054795,45,79,71,49,83,327,合格
20054796,71,64,79,54,45,313,合格
20054797,83,15,86,75,92,351,合格
20054798,23,64,13,31,65,196,不合格
20054799,51,34,54,50,13,202,不合格
20054800,59,53,70,15,25,222,不合格
20054801,43,10,66,94,80,293,不合格
20054802,55,4,73,72,82,286,不合格
20054803,11,58,74,9,54,206,不合格
20054804,69,85,30,80,67,331,合格
20054805,52,21,40,47,55,215,不合格
20054806,70,66,26,64,78,304,合格
20054807,82,17,2,75,84,260,不合格
20054808,40,20,82,74,82,298,不合格
20054809,62,5,56,97,9,229,不合格
20054810,58,90,60,62,27,297,不合格
20054811,62,97,91,53,6,309,合格
20054812,23,52,90,13,74,252,不合格
20054813,64,55,48,25,35,227,不合格
20054814,36,13,26,26,42,143,不合格
20054815,9,81,88,28,5,211,不合格
20054816,31,33,35,38,86,223,不合格
20054817,75,36,57,72,7,247,不合格
20054818,92,89,5,14,14,214,不合格
20054819,24,82,5,92,57,260,不合格
20054820,0,6,79,63,40,188,不合格
20054821,65,38,4,76,68,251,不合格
20054822,82,90,21,49,65,307,合格
20054823,39,57,22,57,32,207,不合格
20054824,50,97,83,72,83,385,合格
20054825,96,97,79,31,38,341,合格
20054826,84,31,60,46,71,292,不合格
20054827,48,73,78,70,27,296,不合格
20054828,42,91,70,58,95,356,合格
20054829,55,66,93,23,59,296,不合格
20054830,98,16,36,76,47,273,不合格
20054831,66,49,62,22,42,241,不合格
20054832,98,93,96,95,18,400,合格
20054833,48,3,98,62,50,261,不合格
20054834,52,82,0,27,34,195,不合格
20054835,2,73,36,98,19,228,不合格
20054836,43,78,9,13,95,238,不合格
20054837,77,94,24,49,93,337,合格
20054838,56,85,42,24,5,212,不合格
20054839,5,45,88,28,0,166,不合格
20054840,0,93,93,38,1,225,不合格
20054841,71,65,48,80,14,278,不合格
20054842,99,68,20,93,11,291,不合格
20054843,54,33,16,55,7,165,不合格
20054844,76,81,40,57,28,282,不合格
20054845,80,83,94,42,9,308,合格
20054846,11,29,47,50,98,235,不合格
20054847,32,46,28,59,37,202,不合格
20054848,93,64,25,33,55,270,不合格
20054849,1,14,12,61,96,184,不合格
20054850,43,6,23,68,23,163,不合格
20054851,15,60,31,3,50,159,不合格
20054852,4,83,39,47,7,180,不合格
20054853,70,62,47,67,4,250,不合格
20054854,18,69,21,39,51,198,不合格
20054855,21,81,31,32,70,235,不合格
20054856,5,25,72,10,17,129,不合格
20054857,9,36,28,9,92,174,不合格
20054858,79,38,72,47,28,264,不合格
20054859,94,81,33,83,79,370,合格
20054860,17,0,80,98,61,256,不合格
20054861,37,86,22,59,6,210,不合格
20054862,45,91,65,30,31,262,不合格
20054863,88,66,14,28,12,208,不合格
20054864,63,96,11,36,47,253,不合格
20054865,66,91,54,67,51,329,合格
20054866,63,52,13,31,73,232,不合格
20054867,91,90,21,83,75,360,合格
20054868,34,36,79,89,22,260,不合格
20054869,46,66,5,2,49,168,不合格
20054870,65,94,64,8,76,307,合格
20054871,7,71,15,45,88,226,不合格
20054872,52,98,60,63,28,301,合格
20054873,43,36,50,30,33,192,不合格
20054874,26,54,59,3,34,176,不合格
20054875,25,9,56,50,95,235,不合格
20054876,91,6,49,44,32,222,不合格
20054877,82,94,99,14,27,316,合格
20054878,24,38,57,3,86,208,不合格
20054879,36,75,38,52,93,294,不合格
20054880,86,4,97,57,66,310,合格
20054881,55,0,26,68,51,200,不合格
20054882,8,57,27,83,33,208,不合格
20054883,65,82,25,28,39,239,不合格
20054884,38,68,36,9,78,229,不合格
20054885,44,19,36,93,89,281,不合格
20054886,37,91,80,32,24,264,不合格
20054887,23,83,79,52,52,289,不合格
20054888,99,14,32,85,98,328,合格
20054889,75,34,74,80,11,274,不合格
20054890,14,70,66,53,22,225,不合格
20054891,50,40,38,61,41,230,不合格
20054892,16,73,8,9,94,200,不合格
20054893,81,38,82,86,64,351,合格
20054894,77,28,37,49,34,225,不合格
20054895,21,70,76,24,28,219,不合格
20054896,41,82,5,8,55,191,不合格
20054897,56,23,30,16,2,127,不合格
20054898,92,39,31,95,45,302,合格
20054899,13,2,30,85,73,203,不合格
20054900,75,47,61,2,63,248,不合格
20054901,78,5,56,74,91,304,合格
20054902,84,29,73,28,37,251,不合格
20054903,36,22,2,59,74,193,不合格
20054904,83,85,90,63,10,331,合格
20054905,6,90,44,57,70,267,不合格
20054906,97,75,20,3,44,239,不合格
20054907,21,19,43,58,15,156,不合格
20054908,0,1,0,45,38,84,不合格
20054909,3,42,88,76,3,212,不合格
20054910,34,63,60,12,53,222,不合格
20054911,46,25,12,24,19,126,不合格
20054912,65,20,74,39,66,264,不合格
20054913,64,62,81,58,18,283,不合格
20054914,4,35,17,11,56,123,不合格
20054915,8,36,46,62,46,198,不合格
20054916,85,3,28,24,25,165,不合格
20054917,41,78,76,67,81,343,合格
20054918,96,83,53,28,29,289,不合格
20054919,4,84,84,94,2,268,不合格
20054920,0,18,48,57,97,220,不合格
20054921,18,25,40,32,81,196,不合格
20054922,70,41,23,58,61,253,不合格
20054923,64,85,80,25,89,343,合格
20054924,27,21,64,36,42,190,不合格
20054925,34,98,27,46,34,239,不合格
20054926,0,90,27,75,68,260,不合格
20054927,71,66,58,52,33,280,不合格
20054928,82,38,45,47,38,250,不合格
20054929,26,58,58,51,44,237,不合格
20054930,2,93,32,51,1,179,不合格
20054931,84,29,13,16,78,220,不合格
20054932,49,92,12,3,25,181,不合格
20054933,10,25,81,21,13,150,不合格
20054934,58,35,7,66,63,229,不合格
20054935,34,15,49,83,33,214,不合格
20054936,26,74,59,26,99,284,不合格
20054937,61,48,33,33,7,182,不合格
20054938,2,90,72,85,53,302,合格
20054939,17,55,58,23,60,213,不合格
20054940,95,21,50,11,69,246,不合格
20054941,41,44,0,66,29,180,不合格
20054942,35,65,18,23,76,217,不合格
20054943,3,17,61,12,39,132,不合格
20054944,95,96,55,18,45,309,合格
20054945,48,44,56,60,55,263,不合格
20054946,18,61,74,27,22,202,不合格
20054947,75,35,80,67,13,270,不合格
20054948,43,21,12,14,64,154,不合格
20054949,59,33,22,77,97,288,不合格
20054950,20,48,11,10,0,89,不合格
20054951,32,23,67,72,81,275,不合格
20054952,8,90,15,35,55,203,不合格
20054953,66,1,56,67,86,276,不合格
20054954,28,78,70,67,42,285,不合格
20054955,40,53,8,67,58,226,不合格
20054956,21,37,74,19,40,191,不合格
20054957,17,25,58,28,16,144,不合格
20054958,42,58,23,21,60,204,不合格
20054959,42,19,35,32,33,161,不合格
20054960,79,94,43,65,40,321,合格
20054961,37,18,89,59,99,302,合格
20054962,19,33,16,99,19,186,不合格
20054963,5,40,64,76,21,206,不合格
20054964,58,98,92,92,57,397,合格
20054965,16,87,92,19,16,230,不合格
20054966,2,64,72,79,17,234,不合格
20054967,34,91,10,87,0,222,不合格
20054968,20,54,1,42,62,179,不合格
20054969,25,79,95,42,5,246,不合格
20054970,75,5,8,75,94,257,不合格
20054971,84,72,34,93,62,345,合格
20054972,79,23,22,80,93,297,不合格
20054973,43,63,27,95,51,279,不合格
20054974,5,61,32,31,92,221,不合格
20054975,87,99,7,19,54,266,不合格
20054976,75,42,2,7,94,220,不合格
20054977,95,65,34,43,4,241,不合格
20054978,46,90,67,57,72,332,合格
20054979,19,99,45,57,88,308,合格
20054980,83,2,80,98,69,332,合格
20054981,61,0,40,67,73,241,不合格
20054982,73,89,99,53,37,351,合格
20054983,40,56,90,7,8,201,不合格
20054984,14,3,47,26,24,114,不合格
20054985,9,61,79,95,18,262,不合格
20054986,32,85,85,37,21,260,不合格
20054987,25,60,48,17,28,178,不合格
20054988,77,67,74,45,80,343,合格
20054989,53,6,84,66,48,257,不合格
20054990,90,64,98,93,5,350,合格
20054991,19,47,64,34,66,230,不合格
20054992,39,0,85,4,14,142,不合格
20054993,44,61,19,94,67,285,不合格
20054994,17,39,42,45,65,208,不合格
20054995,64,33,90,49,45,281,不合格
20054996,99,59,99,28,43,328,合格
20054997,97,66,75,65,25,328,合格
20054998,26,85,56,85,37,289,不合格
20054999,87,49,61,67,28,292,不合格
20055000,62,64,37,81,46,290,不合格
20055001,4,71,52,62,29,218,不合格
20055002,74,57,35,1,68,235,不合格
20055003,11,45,66,2,45,169,不合格
20055004,53,46,35,58,52,244,不合格
20055005,22,99,94,3,56,274,不合格
20055006,36,37,30,87,4,194,不合格
20055007,63,89,45,48,77,322,合格
20055008,52,88,1,47,96,284,不合格
20055009,59,51,9,69,57,245,不合格
20055010,43,84,94,72,37,330,合格
20055011,86,95,25,7,4,217,不合格
20055012,3,94,29,82,46,254,不合格
20055013,95,74,47,38,31,285,不合格
20055014,74,95,83,42,1,295,不合格
20055015,91,49,25,7,84,256,不合格
20055016,10,27,86,21,37,181,不合格
20055017,12,22,65,90,74,263,不合格
20055018,97,29,52,74,22,274,不合格
20055019,10,99,79,84,47,319,合格
20055020,63,51,47,18,40,219,不合格
20055021,39,54,67,70,95,325,合格
20055022,28,2,5,18,40,93,不合格
20055023,41,67,56,47,34,245,不合格
20055024,21,28,38,69,40,196,不合格
20055025,58,74,85,78,42,337,合格
20055026,54,0,26,51,20,151,不合格
20055027,89,57,21,56,16,239,不合格
20055028,56,85,87,9,78,315,合格
20055029,2,34,70,8,1,115,不合格
20055030,77,35,92,81,35,320,合格
20055031,49,96,70,93,70,378,合格
20055032,98,62,1,3,96,260,不合格
20055033,64,31,17,87,42,241,不合格
20055034,61,74,14,23,57,229,不合格
20055035,94,7,23,8,96,228,不合格
20055036,86,34,5,38,57,220,不合格
20055037,61,92,75,42,16,286,不合格
20055038,81,33,15,5,79,213,不合格
20055039,30,96,33,37,10,206,不合格
20055040,5,71,53,61,50,240,不合格
20055041,12,48,22,92,39,213,不合格
20055042,10,82,34,98,19,243,不合格
20055043,60,61,8,86,65,280,不合格
20055044,98,14,90,55,13,270,不合格
20055045,31,95,88,88,32,334,合格
20055046,14,10,70,36,58,188,不合格
20055047,79,22,96,39,80,316,合格
20055048,94,89,6,85,17,291,不合格
20055049,5,53,19,35,78,190,不合格
20055050,88,93,40,29,2,252,不合格
20055051,62,30,2,24,7,125,不合格
20055052,65,53,74,65,20,277,不合格
20055053,95,7,97,61,22,282,不合格
20055054,83,73,13,68,11,248,不合格
20055055,28,2,75,41,3,149,不合格
20055056,84,28,25,99,93,329,合格
20055057,52,76,23,19,31,201,不合格
20055058,3,51,47,75,7,183,不合格
20055059,99,83,60,61,52,355,合格
20055060,72,2,94,47,72,287,不合格
20055061,13,88,36,30,70,237,不合格
20055062,32,15,58,77,19,201,不合格
20055063,50,63,90,1,31,235,不合格
20055064,89,90,58,31,83,351,合格
20055065,62,33,43,14,7,159,不合格
20055066,59,84,93,63,74,373,合格
20055067,40,83,38,46,88,295,不合格
20055068,38,63,61,95,34,291,不合格
20055069,56,60,83,26,6,231,不合格
20055070,57,59,70,85,4,275,不合格
20055071,61,54,69,45,57,286,不合格
20055072,67,51,19,45,10,192,不合格
20055073,9,53,29,8,41,140,不合格
20055074,87,58,52,59,98,354,合格
20055075,64,6,63,34,55,222,不合格
20055076,0,31,71,51,86,239,不合格
20055077,95,51,9,53,17,225,不合格
20055078,32,7,27,18,38,122,不合格
20055079,96,28,90,55,72,341,合格
20055080,32,27,56,68,9,192,不合格
20055081,22,67,82,72,43,286,不合格
20055082,38,44,41,13,23,159,不合格
20055083,60,26,13,4,6,109,不合格
20055084,43,10,77,43,76,249,不合格
20055085,81,26,96,78,0,281,不合格
20055086,21,11,7,82,45,166,不合格
20055087,0,34,67,26,61,188,不合格
20055088,96,60,21,50,20,247,不合格
20055089,10,28,71,58,29,196,不合格
20055090,84,41,90,92,25,332,合格
20055091,12,15,83,25,31,166,不合格
20055092,81,5,73,61,45,265,不合格
20055093,87,29,52,67,31,266,不合格
20055094,81,98,33,21,86,319,合格
20055095,85,6,21,31,78,221,不合格
20055096,93,69,35,85,90,372,合格
20055097,64,9,23,40,40,176,不合格
20055098,66,86,56,86,14,308,合格
20055099,77,52,44,31,30,234,不合格
20055100,1,57,65,2,34,159,不合格
20055101,49,98,54,59,26,286,不合格
20055102,82,0,97,88,80,347,合格
20055103,22,59,32,5,77,195,不合格
20055104,26,87,36,57,87,293,不合格
20055105,17,61,42,8,71,199,不合格
20055106,74,86,25,2,68,255,不合格
20055107,21,56,99,1,36,213,不合格
20055108,10,50,91,59,95,305,合格
20055109,85,30,32,99,37,283,不合格
20055110,6,79,46,62,63,256,不合格
20055111,58,62,3,21,96,240,不合格
20055112,54,2,19,10,20,105,不合格
20055113,81,35,21,2,90,229,不合格
20055114,25,58,36,50,7,176,不合格
20055115,57,2,52,69,5,185,不合格
20055116,38,71,4,31,36,180,不合格
20055117,2,98,92,92,22,306,合格
20055118,87,42,56,83,36,304,合格
20055119,16,55,43,76,85,275,不合格
20055120,82,26,91,29,0,228,不合格
20055121,48,39,69,54,40,250,不合格
20055122,56,24,3,93,14,190,不合格
20055123,23,75,52,13,58,221,不合格
20055124,24,53,75,86,32,270,不合格
20055125,36,67,0,28,97,228,不合格
20055126,58,91,18,54,17,238,不合格
20055127,43,20,41,76,61,241,不合格
20055128,13,50,60,49,62,234,不合格
20055129,1,41,19,29,86,176,不合格
20055130,63,29,62,47,46,247,不合格
20055131,41,96,53,23,56,269,不合格
20055132,84,93,14,19,81,291,不合格
20055133,84,64,36,82,71,337,合格
20055134,52,7,87,85,33,264,不合格
20055135,64,74,9,22,94,263,不合格
20055136,6,90,74,50,24,244,不合格
20055137,6,3,46,18,67,140,不合格
20055138,85,11,74,7,69,246,不合格
20055139,26,83,71,50,92,322,合格
20055140,32,77,12,45,13,179,不合格
20055141,59,85,90,44,10,288,不合格
20055142,18,45,77,76,29,245,不合格
20055143,32,5,75,31,1,144,不合格
20055144,50,15,91,22,61,239,不合格
20055145,97,85,79,12,59,332,合格
20055146,16,36,66,4,56,178,不合格
20055147,50,48,17,38,69,222,不合格
20055148,35,64,71,43,14,227,不合格
20055149,50,47,15,8,10,130,不合格
20055150,53,78,90,38,36,295,不合格
20055151,35,36,21,62,70,224,不合格
20055152,94,45,87,2,47,275,不合格
20055153,87,65,70,68,95,385,合格
20055154,18,7,79,25,57,186,不合格
20055155,21,81,87,65,46,300,合格
20055156,2,45,22,63,96,228,不合格
20055157,80,56,41,50,33,260,不合格
20055158,58,8,23,12,48,149,不合格
20055159,45,69,72,66,25,277,不合格
20055160,62,58,82,31,6,239,不合格
20055161,11,58,55,3,79,206,不合格
20055162,16,83,16,55,50,220,不合格
20055163,25,7,76,32,26,166,不合格
20055164,25,62,12,17,8,124,不合格
20055165,84,53,82,41,65,325,合格
20055166,87,17,83,4,90,281,不合格
20055167,28,14,17,56,44,159,不合格
20055168,1,23,61,18,43,146,不合格
20055169,86,68,15,91,17,277,不合格
20055170,45,20,23,34,17,139,不合格
20055171,83,73,11,37,39,243,不合格
20055172,95,97,56,43,77,368,合格
20055173,33,80,37,17,14,181,不合格
20055174,2,66,78,39,5,190,不合格
20055175,1,83,15,39,34,172,不合格
20055176,38,9,52,62,39,200,不合格
20055177,21,35,63,73,36,228,不合格
20055178,99,88,94,95,62,438,合格
20055179,97,76,57,66,83,379,合格
20055180,30,57,82,98,81,348,合格
20055181,4,77,2,52,98,233,不合格
20055182,92,60,81,16,78,327,合格
20055183,61,77,98,36,45,317,合格
20055184,86,95,51,24,56,312,合格
20055185,63,78,14,13,65,233,不合格
20055186,8,97,92,76,37,310,合格
20055187,26,89,68,90,80,353,合格
20055188,74,62,84,4,55,279,不合格
20055189,90,24,98,98,15,325,合格
20055190,87,76,67,19,36,285,不合格
20055191,71,31,69,73,89,333,合格
20055192,53,0,3,40,81,177,不合格
20055193,91,45,13,16,75,240,不合格
20055194,24,74,3,22,90,213,不合格
20055195,77,86,33,0,9,205,不合格
20055196,79,49,90,67,31,316,合格
20055197,27,44,91,33,16,211,不合格
20055198,3,12,82,58,65,220,不合格
20055199,91,88,74,33,35,321,合格
20055200,66,7,51,85,35,244,不合格
20055201,80,0,39,44,13,176,不合格
20055202,87,18,94,45,73,317,合格
20055203,45,25,14,64,36,184,不合格
20055204,55,77,81,99,77,389,合格
20055205,30,85,23,15,15,168,不合格
20055206,32,32,49,4,76,193,不合格
20055207,72,9,96,82,31,290,不合格
20055208,13,47,27,14,22,123,不合格
20055209,92,78,45,27,93,335,合格
20055210,77,47,6,9,63,202,不合格
20055211,97,38,65,9,17,226,不合格
20055212,51,89,56,36,95,327,合格
20055213,43,12,69,45,68,237,不合格
20055214,83,89,55,10,95,332,合格
20055215,74,35,70,41,87,307,合格
20055216,63,48,27,16,20,174,不合格
20055217,29,94,46,85,44,298,不合格
20055218,75,49,71,56,49,300,合格
20055219,91,92,95,26,26,330,合格
20055220,41,10,41,42,36,170,不合格
20055221,0,27,24,85,92,228,不合格
20055222,46,70,38,31,95,280,不合格
20055223,91,16,93,65,18,283,不合格
20055224,23,56,21,84,88,272,不合格
20055225,48,55,42,30,0,175,不合格
20055226,74,97,5,64,53,293,不合格
20055227,3,33,93,22,3,154,不合格
20055228,42,99,46,40,75,302,合格
20055229,71,16,38,72,73,270,不合格
20055230,47,96,6,42,42,233,不合格
20055231,11,4,60,91,53,219,不合格
20055232,95,58,46,77,6,282,不合格
20055233,6,77,26,93,5,207,不合格
20055234,91,0,47,11,79,228,不合格
20055235,4,90,65,1,54,214,不合格
20055236,74,49,80,1,68,272,不合格
20055237,78,27,44,74,38,261,不合格
20055238,29,99,66,90,54,338,合格
20055239,34,15,38,41,3,131,不合格
20055240,58,5,80,5,31,179,不合格
20055241,2,71,34,15,97,219,不合格
20055242,42,18,7,54,61,182,不合格
20055243,93,64,67,41,75,340,合格
20055244,36,17,57,53,16,179,不合格
20055245,27,54,94,82,62,319,合格
20055246,32,85,23,15,25,180,不合格
20055247,65,84,3,45,77,274,不合格
20055248,46,37,14,92,21,210,不合格
20055249,50,84,85,43,25,287,不合格
20055250,47,47,80,46,45,265,不合格
20055251,84,84,34,99,44,345,合格
20055252,14,42,22,26,76,180,不合格
20055253,31,3,69,91,5,199,不合格
20055254,71,48,34,20,19,192,不合格
20055255,45,22,3,46,30,146,不合格
20055256,54,82,1,9,83,229,不合格
20055257,85,81,97,93,50,406,合格
20055258,44,71,1,93,87,296,不合格
20055259,10,64,87,66,63,290,不合格
20055260,84,33,23,72,32,244,不合格
20055261,1,27,98,39,15,180,不合格
20055262,97,59,31,81,49,317,合格
20055263,33,54,47,52,56,242,不合格
20055264,6,85,29,67,11,198,不合格
20055265,79,1,77,38,4,199,不合格
20055266,85,37,71,30,49,272,不合格
20055267,28,7,31,90,27,183,不合格
20055268,32,79,60,7,63,241,不合格
20055269,53,24,37,60,19,193,不合格
20055270,81,37,12,43,38,211,不合格
20055271,50,13,95,56,7,221,不合格
20055272,53,95,55,98,57,358,合格
20055273,86,43,28,9,5,171,不合格
20055274,53,81,16,13,47,210,不合格
20055275,4,51,50,73,61,239,不合格
20055276,96,49,51,90,26,312,合格
20055277,45,35,63,55,11,209,不合格
20055278,72,40,96,67,83,358,合格
20055279,23,59,34,19,31,166,不合格
20055280,18,75,36,11,73,213,不合格
20055281,77,65,61,95,4,302,合格
20055282,22,15,66,22,82,207,不合格
20055283,58,8,41,67,47,221,不合格
20055284,66,7,70,92,90,325,合格
20055285,34,64,35,10,22,165,不合格
20055286,55,31,22,68,34,210,不合格
20055287,25,34,51,94,1,205,不合格
20055288,22,52,70,92,44,280,不合格
20055289,44,52,92,44,4,236,不合格
20055290,22,9,74,52,9,166,不合格
20055291,64,95,99,10,93,361,合格
20055292,34,44,40,88,35,241,不合格
20055293,38,99,57,14,23,231,不合格
20055294,72,11,94,19,78,274,不合格
20055295,7,31,42,95,5,180,不合格
20055296,17,89,93,47,26,272,不合格
20055297,35,31,45,78,64,253,不合格
20055298,63,67,20,40,15,205,不合格
20055299,2,66,97,67,27,259,不合格
20055300,42,63,51,8,32,196,不合格
20055301,22,85,68,52,18,245,不合格
20055302,88,78,41,94,54,355,合格
20055303,69,77,44,58,28,276,不合格
20055304,56,74,16,9,73,228,不合格
20055305,14,83,39,9,76,221,不合格
20055306,0,30,74,27,72,203,不合格
20055307,35,81,64,16,48,244,不合格
20055308,2,7,50,27,72,158,不合格
20055309,53,68,61,41,55,278,不合格
20055310,95,32,88,89,63,367,合格
20055311,78,45,85,58,65,331,合格
20055312,68,26,22,67,57,240,不合格
20055313,83,39,21,68,41,252,不合格
20055314,93,66,86,88,36,369,合格
20055315,68,71,69,39,94,341,合格
20055316,68,23,65,43,60,259,不合格
20055317,90,90,91,30,45,346,合格
20055318,14,12,21,44,1,92,不合格
20055319,21,46,54,24,19,164,不合格
20055320,32,18,86,7,97,240,不合格
20055321,25,44,51,62,88,270,不合格
20055322,99,47,38,9,5,198,不合格
20055323,86,65,81,87,27,346,合格
20055324,85,18,19,51,84,257,不合格
20055325,14,58,39,33,8,152,不合格
20055326,54,59,51,84,77,325,合格
20055327,20,43,30,62,77,232,不合格
20055328,71,60,1,47,39,218,不合格
20055329,54,96,34,70,89,343,合格
20055330,13,37,59,80,47,236,不合格
20055331,69,68,78,98,62,375,合格
20055332,9,76,33,67,94,279,不合格
20055333,18,48,69,99,87,321,合格
20055334,32,63,32,39,32,198,不合格
20055335,0,56,56,89,91,292,不合格
20055336,79,68,72,14,55,288,不合格
20055337,11,46,89,84,72,302,合格
20055338,93,62,87,19,86,347,合格
20055339,45,63,44,36,36,224,不合格
20055340,62,53,28,28,22,193,不合格
20055341,77,63,77,9,55,281,不合格
20055342,69,53,79,24,45,270,不合格
20055343,4,78,92,92,2,268,不合格
20055344,92,94,83,94,83,446,合格
20055345,66,44,11,98,77,296,不合格
20055346,96,99,23,46,70,334,合格
20055347,17,72,38,6,5,138,不合格
20055348,55,22,61,60,49,247,不合格
20055349,22,38,48,52,61,221,不合格
20055350,20,68,85,13,39,225,不合格
20055351,83,29,92,85,39,328,合格
20055352,31,55,8,1,79,174,不合格
20055353,61,24,1,43,68,197,不合格
20055354,55,97,31,47,74,304,合格
20055355,12,63,55,1,49,180,不合格
20055356,73,21,99,96,60,349,合格
20055357,32,14,33,36,23,138,不合格
20055358,64,19,78,47,43,251,不合格
20055359,82,99,45,93,42,361,合格
20055360,4,85,38,7,82,216,不合格
20055361,99,81,58,85,8,331,合格
20055362,39,8,56,8,1,112,不合格
20055363,14,41,99,29,46,229,不合格
20055364,33,59,10,41,86,229,不合格
20055365,75,82,59,55,52,323,合格
20055366,57,47,59,49,36,248,不合格
20055367,80,18,88,67,3,256,不合格
20055368,40,59,13,61,94,267,不合格
20055369,67,72,6,37,81,263,不合格
20055370,81,12,86,45,80,304,合格
20055371,99,45,29,49,68,290,不合格
20055372,94,18,77,47,16,252,不合格
20055373,60,9,17,44,11,141,不合格
20055374,66,27,21,35,67,216,不合格
20055375,39,17,21,41,41,159,不合格
20055376,50,63,59,56,30,258,不合格
20055377,45,1,23,50,80,199,不合格
20055378,32,49,81,1,85,248,不合格
20055379,99,99,54,54,87,393,合格
20055380,17,7,15,34,37,110,不合格
20055381,5,26,35,30,75,171,不合格
20055382,86,75,98,95,10,364,合格
20055383,37,18,18,53,50,176,不合格
20055384,76,89,77,66,98,406,合格
20055385,33,47,84,77,31,272,不合格
20055386,90,96,80,47,71,384,合格
20055387,34,56,77,31,14,212,不合格
20055388,45,73,0,55,11,184,不合格
20055389,40,55,20,10,24,149,不合格
20055390,88,80,2,4,62,236,不合格
20055391,67,98,46,26,63,300,合格
20055392,84,23,26,40,28,201,不合格
20055393,39,82,75,92,33,321,合格
20055394,47,79,31,69,88,314,合格
20055395,51,60,1,5,16,133,不合格
20055396,10,39,76,99,96,320,合格
20055397,39,60,18,40,54,211,不合格
20055398,86,30,97,10,44,267,不合格
20055399,60,93,8,8,73,242,不合格
20055400,50,27,44,28,13,162,不合格
20055401,2,46,28,86,91,253,不合格
20055402,49,41,10,12,79,191,不合格
20055403,33,25,58,32,73,221,不合格
20055404,91,99,88,78,97,453,合格
20055405,51,46,10,92,71,270,不合格
20055406,61,82,18,46,53,260,不合格
20055407,4,59,43,66,69,241,不合格
20055408,59,25,79,57,60,280,不合格
20055409,9,32,99,99,83,322,合格
20055410,4,83,86,51,29,253,不合格
20055411,70,24,76,92,47,309,合格
20055412,36,97,67,43,68,311,合格
20055413,42,31,8,7,94,182,不合格
20055414,28,4,89,96,44,261,不合格
20055415,12,90,88,86,58,334,合格
20055416,67,47,23,99,22,258,不合格
20055417,26,60,51,34,67,238,不合格
20055418,80,18,6,35,3,142,不合格
20055419,44,57,17,18,89,225,不合格
20055420,1,90,89,1,28,209,不合格
20055421,46,37,58,63,99,303,合格
20055422,88,80,86,5,23,282,不合格
20055423,83,33,44,15,29,204,不合格
20055424,35,67,8,21,68,199,不合格
20055425,26,42,0,9,46,123,不合格
20055426,8,12,58,68,26,172,不合格
20055427,17,17,22,82,75,213,不合格
20055428,28,30,23,99,37,217,不合格
20055429,91,30,6,51,88,266,不合格
20055430,98,24,36,10,72,240,不合格
20055431,42,74,53,25,74,268,不合格
20055432,63,1,52,60,58,234,不合格
20055433,69,72,87,41,22,291,不合格
20055434,31,79,30,41,44,225,不合格
20055435,89,18,75,39,62,283,不合格
20055436,75,74,66,73,19,307,合格
20055437,76,45,50,94,21,286,不合格
20055438,10,99,41,5,27,182,不合格
20055439,41,50,90,89,67,337,合格
20055440,76,25,23,42,97,263,不合格
20055441,87,85,76,66,62,376,合格
20055442,50,86,98,60,93,387,合格
20055443,77,82,5,60,74,298,不合格
20055444,84,18,10,26,10,148,不合格
20055445,4,67,20,34,57,182,不合格
20055446,24,79,65,65,24,257,不合格
20055447,36,93,63,36,49,277,不合格
20055448,25,95,54,49,20,243,不合格
20055449,90,98,19,71,30,308,合格
20055450,46,47,13,63,66,235,不合格
20055451,8,78,95,73,89,343,合格
20055452,96,62,94,88,27,367,合格
20055453,72,93,41,82,81,369,合格
20055454,44,36,63,68,63,274,不合格
20055455,52,12,52,6,78,200,不合格
20055456,99,1,14,35,94,243,不合格
20055457,25,1,9,58,94,187,不合格
20055458,96,66,54,83,97,396,合格
20055459,68,82,3,92,74,319,合格
20055460,81,67,95,62,86,391,合格
20055461,21,34,68,43,85,251,不合格
20055462,55,48,73,68,53,297,不合格
20055463,54,95,96,52,45,342,合格
20055464,17,67,75,3,23,185,不合格
20055465,5,98,85,71,96,355,合格
20055466,39,86,82,47,59,313,合格
20055467,88,19,83,82,76,348,合格
20055468,16,4,31,64,19,134,不合格
20055469,79,4,41,14,29,167,不合格
20055470,8,28,52,45,70,203,不合格
20055471,25,40,68,29,31,193,不合格
20055472,57,79,56,6,19,217,不合格
20055473,38,34,84,84,30,270,不合格
20055474,97,18,4,60,1,180,不合格
20055475,61,90,37,38,4,230,不合格
20055476,42,5,87,13,33,180,不合格
20055477,45,85,91,74,74,369,合格
20055478,58,66,24,23,97,268,不合格
20055479,40,9,83,39,30,201,不合格
20055480,14,75,67,89,87,332,合格
20055481,49,93,80,69,44,335,合格
20055482,43,76,53,46,56,274,不合格
20055483,78,66,31,44,37,256,不合格
20055484,74,15,14,44,21,168,不合格
20055485,52,95,85,9,5,246,不合格
20055486,3,21,98,57,45,224,不合格
20055487,18,85,82,48,26,259,不合格
20055488,85,45,59,63,14,266,不合格
20055489,85,79,35,65,68,332,合格
20055490,67,89,16,57,42,271,不合格
20055491,7,67,50,28,29,181,不合格
20055492,46,42,55,25,82,250,不合格
20055493,32,1,88,65,54,240,不合格
20055494,2,39,79,98,24,242,不合格
20055495,92,12,83,65,33,285,不合格
20055496,28,15,82,92,49,266,不合格
20055497,99,65,86,19,1,270,不合格
20055498,40,79,72,11,74,276,不合格
20055499,87,4,54,59,36,240,不合格
20055500,20,62,48,38,46,214,不合格
