ID,国語,数学,英語,理科,社会,合計,判定
20100001,59,49,45,26,68,247,不合格
20100002,75,60,75,29,49,288,不合格
20100003,44,34,66,95,14,253,不合格
20100004,12,97,3,68,88,268,不合格
20100005,6,19,24,65,54,168,不合格
20100006,72,14,34,76,31,227,不合格
20100007,27,28,6,4,25,90,不合格
20100008,37,54,6,2,88,187,不合格
20100009,72,90,92,57,57,368,合格
20100010,88,26,34,2,68,218,不合格
20100011,90,24,22,12,94,242,不合格
20100012,55,0,48,88,23,214,不合格
20100013,32,22,50,45,57,206,不合格
20100014,42,87,78,43,84,334,合格
20100015,32,68,87,16,56,259,不合格
20100016,60,58,56,14,36,224,不合格
20100017,89,46,68,94,87,384,合格
20100018,55,33,82,75,27,272,不合格
20100019,5,14,21,38,76,154,不合格
20100020,83,56,83,52,7,281,不合格
20100021,40,61,22,71,67,261,不合格
20100022,63,88,61,31,27,270,不合格
20100023,24,4,77,48,8,161,不合格
20100024,26,39,38,56,5,164,不合格
20100025,63,67,35,49,4,218,不合格
20100026,98,43,65,60,22,288,不合格
20100027,32,91,59,42,41,265,不合格
20100028,14,94,85,79,63,335,合格
20100029,57,44,86,73,94,354,合格
20100030,60,82,90,20,16,268,不合格
20100031,82,45,80,49,38,294,不合格
20100032,54,59,47,73,77,310,合格
20100033,11,92,42,97,52,294,不合格
20100034,83,85,49,50,89,356,合格
20100035,64,55,86,7,58,270,不合格
20100036,11,81,19,57,22,190,不合格
20100037,19,7,35,27,45,133,不合格
20100038,63,23,23,23,39,171,不合格
20100039,2,95,62,92,52,303,合格
20100040,73,77,69,1,49,269,不合格
20100041,13,94,74,83,5,269,不合格
20100042,59,60,41,53,40,253,不合格
20100043,32,72,80,29,83,296,不合格
20100044,29,69,62,61,93,314,合格
20100045,94,60,24,11,49,238,不合格
20100046,28,86,91,37,96,338,合格
20100047,57,48,90,70,14,279,不合格
20100048,68,65,52,48,70,303,合格
20100049,86,10,29,95,16,236,不合格
20100050,48,36,86,44,35,249,不合格
20100051,40,7,28,44,52,171,不合格
20100052,5,6,16,2,53,82,不合格
20100053,0,39,25,70,74,208,不合格
20100054,0,49,68,11,67,195,不合格
20100055,96,24,70,5,62,257,不合格
20100056,15,86,64,16,85,266,不合格
20100057,98,38,67,98,97,398,合格
20100058,48,98,60,67,30,303,合格
20100059,56,47,57,70,7,237,不合格
20100060,30,96,97,22,55,300,合格
20100061,13,12,45,42,18,130,不合格
20100062,10,15,75,26,96,222,不合格
20100063,51,61,28,74,48,262,不合格
20100064,10,81,62,1,46,200,不合格
20100065,25,39,99,36,50,249,不合格
20100066,88,58,99,40,64,349,合格
20100067,78,66,35,17,49,245,不合格
20100068,81,54,62,67,36,300,合格
20100069,30,32,2,47,2,113,不合格
20100070,36,9,64,15,4,128,不合格
20100071,61,93,56,50,59,319,合格
20100072,65,9,65,25,23,187,不合格
20100073,9,62,37,67,75,250,不合格
20100074,32,85,31,13,68,229,不合格
20100075,47,62,60,85,1,255,不合格
20100076,93,17,78,63,60,311,合格
20100077,85,22,27,97,69,300,合格
20100078,85,44,66,62,58,315,合格
20100079,98,41,98,49,8,294,不合格
20100080,90,83,91,98,1,363,合格
20100081,66,20,47,48,66,247,不合格
20100082,9,17,40,91,12,169,不合格
20100083,44,92,35,20,45,236,不合格
20100084,97,67,35,47,89,335,合格
20100085,92,28,23,26,32,201,不合格
20100086,88,56,45,82,92,363,合格
20100087,91,88,29,46,25,279,不合格
20100088,13,83,66,37,8,207,不合格
20100089,51,74,24,44,59,252,不合格
20100090,9,87,95,35,37,263,不合格
20100091,66,82,98,20,43,309,合格
20100092,50,20,52,76,48,246,不合格
20100093,33,67,28,86,39,253,不合格
20100094,95,12,5,15,36,163,不合格
20100095,22,55,84,55,22,238,不合格
20100096,74,24,24,94,50,266,不合格
20100097,28,33,78,90,29,258,不合格
20100098,15,93,44,43,88,283,不合格
20100099,52,53,12,28,68,213,不合格
20100100,27,51,83,27,57,245,不合格
20100101,2,59,88,84,71,304,合格
20100102,33,97,29,81,17,257,不合格
20100103,86,35,31,9,80,241,不合格
20100104,12,94,2,6,84,198,不合格
20100105,64,67,2,8,42,183,不合格
20100106,48,82,40,10,44,224,不合格
20100107,55,49,33,37,2,176,不合格
20100108,18,82,52,11,95,258,不合格
20100109,30,91,58,77,2,258,不合格
20100110,51,78,2,56,84,271,不合格
20100111,53,40,21,88,13,215,不合格
20100112,58,23,20,68,84,253,不合格
20100113,92,60,71,55,35,313,合格
20100114,80,93,82,61,30,346,合格
20100115,7,35,57,20,21,140,不合格
20100116,90,67,3,71,87,318,合格
20100117,80,6,15,67,23,191,不合格
20100118,30,40,49,87,68,274,不合格
20100119,18,35,36,90,37,216,不合格
20100120,29,66,25,67,96,283,不合格
20100121,74,41,1,78,77,271,不合格
20100122,80,83,26,36,35,260,不合格
20100123,71,84,83,30,91,359,合格
20100124,81,89,30,73,82,355,合格
20100125,63,73,76,33,86,331,合格
20100126,33,16,88,73,86,296,不合格
20100127,47,4,9,21,67,148,不合格
20100128,75,51,63,14,35,238,不合格
20100129,2,34,92,44,46,218,不合格
20100130,95,93,82,31,31,332,合格
20100131,31,79,26,99,68,303,合格
20100132,22,6,9,81,88,206,不合格
20100133,20,71,47,88,28,254,不合格
20100134,3,88,43,21,55,210,不合格
20100135,34,90,25,1,87,237,不合格
20100136,29,17,91,33,87,257,不合格
20100137,74,58,91,24,80,327,合格
20100138,44,56,19,22,96,237,不合格
20100139,11,42,25,39,60,177,不合格
20100140,74,3,51,21,32,181,不合格
20100141,92,72,17,77,65,323,合格
20100142,99,47,97,2,84,329,合格
20100143,65,86,85,20,9,265,不合格
20100144,18,23,53,84,13,191,不合格
20100145,47,43,29,37,39,195,不合格
20100146,97,79,53,19,32,280,不合格
20100147,89,0,66,30,68,253,不合格
20100148,22,53,55,69,13,212,不合格
20100149,2,27,4,31,14,78,不合格
20100150,2,91,0,59,8,160,不合格
20100151,40,42,62,26,74,244,不合格
20100152,90,75,43,37,0,245,不合格
20100153,31,44,45,9,56,185,不合格
20100154,74,31,84,24,68,281,不合格
20100155,11,53,91,85,39,279,不合格
20100156,70,46,21,35,96,268,不合格
20100157,97,58,58,92,41,346,合格
20100158,77,66,14,54,43,254,不合格
20100159,71,76,90,79,27,343,合格
20100160,54,44,39,67,17,221,不合格
20100161,51,1,40,36,96,224,不合格
20100162,92,34,86,93,87,392,合格
20100163,36,11,3,69,11,130,不合格
20100164,5,63,46,31,48,193,不合格
20100165,69,44,86,9,74,282,不合格
20100166,98,26,40,26,6,196,不合格
20100167,54,10,40,38,66,208,不合格
20100168,97,42,84,90,40,353,合格
20100169,66,58,10,29,25,188,不合格
20100170,77,38,67,7,48,237,不合格
20100171,12,7,95,26,25,165,不合格
20100172,83,70,46,34,0,233,不合格
20100173,55,61,11,24,15,166,不合格
20100174,24,91,49,38,73,275,不合格
20100175,69,22,86,24,35,236,不合格
20100176,86,6,5,32,96,225,不合格
20100177,92,76,94,17,13,292,不合格
20100178,29,52,35,21,92,229,不合格
20100179,68,20,52,73,63,276,不合格
20100180,35,76,79,83,75,348,合格
20100181,46,99,47,61,64,317,合格
20100182,75,8,98,47,99,327,合格
20100183,6,85,69,97,98,355,合格
20100184,83,43,52,36,78,292,不合格
20100185,60,54,72,26,69,281,不合格
20100186,52,49,33,14,64,212,不合格
20100187,85,22,37,62,44,250,不合格
20100188,70,30,14,16,99,229,不合格
20100189,67,54,75,52,65,313,合格
20100190,40,9,82,94,8,233,不合格
20100191,44,68,60,35,76,283,不合格
20100192,8,14,71,21,60,174,不合格
20100193,74,21,24,79,25,223,不合格
20100194,94,55,54,6,51,260,不合格
20100195,0,26,28,30,28,112,不合格
20100196,77,19,5,73,95,269,不合格
20100197,7,41,55,92,81,276,不合格
20100198,99,79,35,3,83,299,不合格
20100199,30,36,8,51,89,214,不合格
20100200,42,6,69,54,9,180,不合格
20100201,33,71,89,11,93,297,不合格
20100202,46,70,49,15,86,266,不合格
20100203,91,17,43,6,46,203,不合格
20100204,58,70,35,90,98,351,合格
20100205,68,59,24,90,99,340,合格
20100206,17,16,70,28,15,146,不合格
20100207,96,43,71,13,7,230,不合格
20100208,68,0,10,63,74,215,不合格
20100209,9,35,73,64,47,228,不合格
20100210,92,62,95,13,5,267,不合格
20100211,5,9,30,24,96,164,不合格
20100212,42,2,55,30,6,135,不合格
20100213,61,63,92,77,71,364,合格
20100214,29,31,98,32,79,269,不合格
20100215,59,41,26,34,93,253,不合格
20100216,43,66,91,51,0,251,不合格
20100217,72,88,98,33,13,304,合格
20100218,54,83,7,92,85,321,合格
20100219,9,69,95,3,33,209,不合格
20100220,20,89,25,92,22,248,不合格
20100221,34,62,37,12,62,207,不合格
20100222,46,70,86,43,90,335,合格
20100223,34,72,40,26,33,205,不合格
20100224,74,89,55,87,99,404,合格
20100225,66,19,26,3,59,173,不合格
20100226,47,82,61,25,50,265,不合格
20100227,44,5,18,99,52,218,不合格
20100228,61,54,61,45,75,296,不合格
20100229,44,10,27,49,95,225,不合格
20100230,48,54,82,79,24,287,不合格
20100231,62,31,76,45,54,268,不合格
20100232,15,93,98,65,94,365,合格
20100233,41,77,79,46,45,288,不合格
20100234,76,16,70,34,86,282,不合格
20100235,56,53,59,80,16,264,不合格
20100236,71,85,75,14,98,343,合格
20100237,60,72,47,44,72,295,不合格
20100238,75,92,65,73,59,364,合格
20100239,91,13,76,62,92,334,合格
20100240,52,28,95,25,55,255,不合格
20100241,24,24,77,9,9,143,不合格
20100242,38,92,33,17,26,206,不合格
20100243,98,26,55,87,5,271,不合格
20100244,47,3,86,88,6,230,不合格
20100245,94,52,86,5,8,245,不合格
20100246,79,98,63,66,41,347,合格
20100247,12,90,31,49,11,193,不合格
20100248,98,62,54,15,81,310,合格
20100249,96,65,42,94,87,384,合格
20100250,61,48,21,79,74,283,不合格
20100251,90,43,76,71,48,328,合格
20100252,20,93,84,10,94,301,合格
20100253,49,43,48,78,81,299,不合格
20100254,98,72,67,68,34,339,合格
20100255,78,11,50,23,49,211,不合格
20100256,28,76,39,96,90,329,合格
20100257,59,5,51,46,27,188,不合格
20100258,21,30,96,30,42,219,不合格
20100259,59,98,76,24,84,341,合格
20100260,53,10,35,80,64,242,不合格
20100261,47,15,83,95,69,309,合格
20100262,82,45,12,87,41,267,不合格
20100263,85,41,48,32,60,266,不合格
20100264,12,79,20,76,89,276,不合格
20100265,33,92,73,86,57,341,合格
20100266,8,89,96,0,12,205,不合格
20100267,1,62,95,7,21,186,不合格
20100268,14,22,6,49,37,128,不合格
20100269,92,79,76,34,23,304,合格
20100270,38,16,3,27,20,104,不合格
20100271,47,33,37,59,80,256,不合格
20100272,78,84,1,12,73,248,不合格
20100273,22,87,5,1,77,192,不合格
20100274,54,73,64,59,41,291,不合格
20100275,38,0,63,4,22,127,不合格
20100276,88,77,90,47,43,345,合格
20100277,65,45,49,49,55,263,不合格
20100278,76,20,93,66,62,317,合格
20100279,18,38,76,37,86,255,不合格
20100280,17,23,82,96,44,262,不合格
20100281,9,20,83,40,10,162,不合格
20100282,51,62,3,64,65,245,不合格
20100283,96,96,92,56,30,370,合格
20100284,73,22,76,83,66,320,合格
20100285,63,22,31,50,27,193,不合格
20100286,63,17,16,37,12,145,不合格
20100287,42,50,78,54,84,308,合格
20100288,9,10,47,81,73,220,不合格
20100289,70,46,95,15,98,324,合格
20100290,17,92,23,15,59,206,不合格
20100291,94,97,12,45,58,306,合格
20100292,87,30,95,21,66,299,不合格
20100293,90,52,99,88,38,367,合格
20100294,6,2,69,92,46,215,不合格
20100295,21,64,66,27,85,263,不合格
20100296,60,33,81,59,27,260,不合格
20100297,23,63,59,9,67,221,不合格
20100298,13,74,68,82,94,331,合格
20100299,98,20,86,44,32,280,不合格
20100300,29,33,4,77,9,152,不合格
20100301,20,88,99,26,23,256,不合格
20100302,64,12,49,83,88,296,不合格
20100303,83,53,64,48,57,305,合格
20100304,46,27,70,25,81,249,不合格
20100305,10,56,37,27,79,209,不合格
20100306,79,48,19,36,77,259,不合格
20100307,89,2,28,77,77,273,不合格
20100308,27,66,55,72,10,230,不合格
20100309,49,0,54,52,55,210,不合格
20100310,76,74,74,22,94,340,合格
20100311,9,53,73,10,85,230,不合格
20100312,76,72,1,69,67,285,不合格
20100313,48,25,46,14,74,207,不合格
20100314,99,53,45,23,25,245,不合格
20100315,72,29,58,61,22,242,不合格
20100316,46,36,17,84,23,206,不合格
20100317,59,56,88,68,25,296,不合格
20100318,37,21,47,34,78,217,不合格
20100319,2,1,44,44,34,125,不合格
20100320,25,1,7,60,98,191,不合格
20100321,7,22,38,43,18,128,不合格
20100322,74,91,66,60,44,335,合格
20100323,42,67,20,76,3,208,不合格
20100324,82,41,67,88,29,307,合格
20100325,22,11,41,0,24,98,不合格
20100326,44,38,76,97,15,270,不合格
20100327,97,16,42,22,91,268,不合格
20100328,66,10,43,24,78,221,不合格
20100329,91,48,33,92,72,336,合格
20100330,82,72,82,39,37,312,合格
20100331,9,31,12,66,95,213,不合格
20100332,25,1,93,16,96,231,不合格
20100333,45,57,55,84,89,330,合格
20100334,4,65,35,28,27,159,不合格
20100335,37,61,51,67,64,280,不合格
20100336,80,11,99,76,21,287,不合格
20100337,58,90,23,57,16,244,不合格
20100338,68,29,33,78,17,225,不合格
20100339,35,80,53,35,11,214,不合格
20100340,43,47,42,70,51,253,不合格
20100341,25,89,97,5,71,287,不合格
20100342,77,27,69,36,51,260,不合格
20100343,73,39,46,71,43,272,不合格
20100344,45,76,18,69,20,228,不合格
20100345,93,58,27,13,22,213,不合格
20100346,29,33,31,39,72,204,不合格
20100347,11,14,17,51,32,125,不合格
20100348,18,76,36,15,59,204,不合格
20100349,67,55,94,2,68,286,不合格
20100350,10,87,36,34,55,222,不合格
20100351,60,81,67,93,56,357,合格
20100352,60,65,52,16,2,195,不合格
20100353,87,39,27,61,32,246,不合格
20100354,51,80,63,52,8,254,不合格
20100355,1,66,49,66,58,240,不合格
20100356,18,14,10,84,15,141,不合格
20100357,23,74,2,66,8,173,不合格
20100358,38,33,37,8,22,138,不合格
20100359,40,79,23,95,5,242,不合格
20100360,54,55,61,91,50,311,合格
20100361,18,8,20,13,6,65,不合格
20100362,40,6,51,6,66,169,不合格
20100363,25,10,3,33,27,98,不合格
20100364,9,65,33,0,71,178,不合格
20100365,72,94,65,99,10,340,合格
20100366,53,72,83,82,16,306,合格
20100367,38,12,49,80,43,222,不合格
20100368,1,95,62,39,57,254,不合格
20100369,28,77,3,51,33,192,不合格
20100370,78,97,66,82,9,332,合格
20100371,70,88,68,79,15,320,合格
20100372,53,19,9,91,66,238,不合格
20100373,58,99,92,32,78,359,合格
20100374,76,74,28,80,76,334,合格
20100375,63,13,24,49,46,195,不合格
20100376,31,3,11,18,57,120,不合格
20100377,0,72,89,10,52,223,不合格
20100378,50,92,54,14,7,217,不合格
20100379,84,56,88,86,42,356,合格
20100380,86,4,38,92,63,283,不合格
20100381,70,99,65,19,98,351,合格
20100382,25,95,81,61,35,297,不合格
20100383,7,31,82,71,40,231,不合格
20100384,30,44,52,13,88,227,不合格
20100385,96,66,96,69,41,368,合格
20100386,0,94,68,43,90,295,不合格
20100387,75,55,26,87,68,311,合格
20100388,0,64,85,74,34,257,不合格
20100389,45,83,40,96,94,358,合格
20100390,24,59,6,64,79,232,不合格
20100391,88,85,75,58,12,318,合格
20100392,22,1,61,5,16,105,不合格
20100393,15,17,32,47,16,127,不合格
20100394,20,56,30,63,9,178,不合格
20100395,21,46,55,99,20,241,不合格
20100396,79,93,36,90,72,370,合格
20100397,81,3,71,34,27,216,不合格
20100398,44,66,77,51,41,279,不合格
20100399,68,72,8,65,8,221,不合格
20100400,62,80,59,71,6,278,不合格
20100401,13,67,38,67,88,273,不合格
20100402,12,94,37,58,8,209,不合格
20100403,35,25,3,49,36,148,不合格
20100404,78,25,48,55,93,299,不合格
20100405,76,84,50,36,61,307,合格
20100406,9,30,66,27,67,199,不合格
20100407,73,97,85,96,12,363,合格
20100408,69,9,8,79,74,239,不合格
20100409,84,36,32,86,72,310,合格
20100410,35,49,43,60,20,207,不合格
20100411,47,22,56,0,20,145,不合格
20100412,70,96,49,2,80,297,不合格
20100413,71,79,20,22,52,244,不合格
20100414,3,32,78,24,16,153,不合格
20100415,33,72,1,12,37,155,不合格
20100416,33,50,68,98,57,306,合格
20100417,16,56,13,87,35,207,不合格
20100418,24,37,14,93,2,170,不合格
20100419,62,11,80,16,50,219,不合格
20100420,78,7,55,2,83,225,不合格
20100421,35,58,48,64,55,260,不合格
20100422,85,8,5,22,11,131,不合格
20100423,56,54,49,99,74,332,合格
20100424,64,48,65,30,54,261,不合格
20100425,16,66,46,68,20,216,不合格
20100426,34,46,49,63,30,222,不合格
20100427,21,46,54,4,71,196,不合格
20100428,75,54,75,51,61,316,合格
20100429,57,31,65,38,36,227,不合格
20100430,64,21,11,14,27,137,不合格
20100431,75,75,55,33,35,273,不合格
20100432,80,6,61,50,60,257,不合格
20100433,31,89,79,82,58,339,合格
20100434,27,21,33,9,3,93,不合格
20100435,69,48,21,55,99,292,不合格
20100436,80,98,57,55,50,340,合格
20100437,43,34,1,97,14,189,不合格
20100438,13,23,67,99,50,252,不合格
20100439,11,15,90,99,95,310,合格
20100440,73,62,20,3,19,177,不合格
20100441,95,41,70,13,51,270,不合格
20100442,56,43,82,59,9,249,不合格
20100443,80,43,3,97,29,252,不合格
20100444,75,77,43,89,91,375,合格
20100445,38,91,72,62,59,322,合格
20100446,7,37,97,11,22,174,不合格
20100447,39,91,7,60,75,272,不合格
20100448,24,25,85,61,5,200,不合格
20100449,85,51,30,47,86,299,不合格
20100450,63,53,83,46,35,280,不合格
20100451,14,54,47,64,59,238,不合格
20100452,76,46,71,9,56,258,不合格
20100453,85,26,87,92,51,341,合格
20100454,81,66,39,45,95,326,合格
20100455,2,42,88,66,4,202,不合格
20100456,2,75,42,16,77,212,不合格
20100457,85,47,80,15,37,264,不合格
20100458,52,71,95,69,23,310,合格
20100459,9,3,63,60,67,202,不合格
20100460,58,64,56,48,81,307,合格
20100461,56,13,64,20,59,212,不合格
20100462,74,63,24,88,21,270,不合格
20100463,2,6,96,27,1,132,不合格
20100464,12,68,45,12,10,147,不合格
20100465,86,91,49,31,68,325,合格
20100466,69,19,46,82,23,239,不合格
20100467,6,46,67,60,99,278,不合格
20100468,15,53,68,86,7,229,不合格
20100469,34,64,60,57,56,271,不合格
20100470,30,93,12,50,56,241,不合格
20100471,64,18,56,27,81,246,不合格
20100472,5,66,13,45,77,206,不合格
20100473,41,13,54,64,81,253,不合格
20100474,61,57,86,84,17,305,合格
20100475,96,28,92,25,76,317,合格
20100476,56,71,28,17,2,174,不合格
20100477,25,17,71,29,56,198,不合格
20100478,17,98,7,46,78,246,不合格
20100479,22,51,77,42,74,266,不合格
20100480,80,76,43,67,78,344,合格
20100481,52,71,86,67,41,317,合格
20100482,53,11,80,65,6,215,不合格
20100483,89,89,62,16,55,311,合格
20100484,42,12,69,46,18,187,不合格
20100485,50,90,3,47,56,246,不合格
20100486,23,63,91,15,27,219,不合格
20100487,71,95,71,69,62,368,合格
20100488,10,72,82,8,41,213,不合格
20100489,87,84,99,89,32,391,合格
20100490,2,36,49,30,51,168,不合格
20100491,6,29,14,71,50,170,不合格
20100492,74,60,73,7,92,306,合格
20100493,50,19,72,79,6,226,不合格
20100494,22,56,28,75,59,240,不合格
20100495,6,97,54,91,56,304,合格
20100496,85,87,30,79,36,317,合格
20100497,89,33,27,48,82,279,不合格
20100498,56,13,73,84,95,321,合格
20100499,25,4,59,3,11,102,不合格
20100500,12,61,52,34,83,242,不合格
20100501,14,28,20,69,7,138,不合格
20100502,88,53,90,18,35,284,不合格
20100503,0,87,92,41,93,313,合格
20100504,10,84,14,22,20,150,不合格
20100505,9,35,72,97,47,260,不合格
20100506,91,35,6,83,14,229,不合格
20100507,30,46,61,14,44,195,不合格
20100508,65,34,49,65,2,215,不合格
20100509,55,3,37,60,96,251,不合格
20100510,97,73,12,11,98,291,不合格
20100511,72,17,2,6,48,145,不合格
20100512,96,75,85,45,88,389,合格
20100513,94,54,42,91,9,290,不合格
20100514,51,45,54,23,65,238,不合格
20100515,18,52,81,6,68,225,不合格
20100516,57,10,55,87,49,258,不合格
20100517,91,60,38,45,21,255,不合格
20100518,96,32,37,9,41,215,不合格
20100519,47,47,72,5,75,246,不合格
20100520,56,98,23,61,7,245,不合格
20100521,47,48,68,39,86,288,不合格
20100522,52,21,16,42,2,133,不合格
20100523,11,57,14,86,52,220,不合格
20100524,55,50,41,48,25,219,不合格
20100525,71,96,94,93,47,401,合格
20100526,73,49,15,9,22,168,不合格
20100527,75,86,85,54,66,366,合格
20100528,30,79,43,74,19,245,不合格
20100529,78,86,15,2,99,280,不合格
20100530,50,20,60,6,69,205,不合格
20100531,87,61,55,59,12,274,不合格
20100532,83,55,7,45,33,223,不合格
20100533,36,30,35,68,44,213,不合格
20100534,88,78,16,65,53,300,合格
20100535,36,89,44,82,52,303,合格
20100536,18,47,79,75,15,234,不合格
20100537,19,21,8,28,81,157,不合格
20100538,80,60,70,34,82,326,合格
20100539,75,92,90,28,17,302,合格
20100540,94,89,45,76,37,341,合格
20100541,98,37,94,45,46,320,合格
20100542,81,13,68,65,87,314,合格
20100543,53,51,35,1,15,155,不合格
20100544,84,74,20,41,61,280,不合格
20100545,98,14,86,33,5,236,不合格
20100546,95,50,11,9,3,168,不合格
20100547,5,0,35,89,65,194,不合格
20100548,93,51,81,50,36,311,合格
20100549,61,79,39,79,76,334,合格
20100550,32,0,26,43,32,133,不合格
20100551,22,83,50,82,27,264,不合格
20100552,10,89,22,3,47,171,不合格
20100553,21,40,12,11,5,89,不合格
20100554,15,5,98,65,86,269,不合格
20100555,43,14,30,42,8,137,不合格
20100556,57,28,5,71,58,219,不合格
20100557,43,67,21,14,37,182,不合格
20100558,19,32,2,53,44,150,不合格
20100559,21,36,50,9,48,164,不合格
20100560,91,81,37,18,47,274,不合格
20100561,78,69,84,70,87,388,合格
20100562,50,40,8,37,73,208,不合格
20100563,92,13,21,94,5,225,不合格
20100564,74,35,91,61,4,265,不合格
20100565,62,50,38,63,75,288,不合格
20100566,75,57,75,45,93,345,合格
20100567,38,44,14,58,92,246,不合格
20100568,23,97,53,49,48,270,不合格
20100569,96,20,59,16,83,274,不合格
20100570,37,71,30,66,46,250,不合格
20100571,15,49,4,86,20,174,不合格
20100572,68,94,38,19,84,303,合格
20100573,48,70,79,94,3,294,不合格
20100574,47,68,69,48,47,279,不合格
20100575,6,95,26,98,45,270,不合格
20100576,91,72,11,63,72,309,合格
20100577,66,71,88,92,3,320,合格
20100578,93,36,12,29,87,257,不合格
20100579,33,95,58,89,83,358,合格
20100580,40,64,12,31,1,148,不合格
20100581,37,96,3,68,12,216,不合格
20100582,60,57,88,89,74,368,合格
20100583,15,53,39,27,11,145,不合格
20100584,12,14,73,14,89,202,不合格
20100585,95,88,26,43,0,252,不合格
20100586,39,52,17,50,23,181,不合格
20100587,45,65,40,89,43,282,不合格
20100588,37,42,28,89,77,273,不合格
20100589,10,89,14,13,7,133,不合格
20100590,40,92,10,66,70,278,不合格
20100591,11,51,9,71,89,231,不合格
20100592,61,12,41,89,21,224,不合格
20100593,6,87,68,54,16,231,不合格
20100594,19,31,71,43,13,177,不合格
20100595,1,6,3,78,41,129,不合格
20100596,45,63,19,21,2,150,不合格
20100597,28,46,35,59,75,243,不合格
20100598,63,38,59,82,92,334,合格
20100599,65,36,60,60,54,275,不合格
20100600,21,54,52,89,46,262,不合格
20100601,24,49,84,71,13,241,不合格
20100602,45,26,62,37,23,193,不合格
20100603,89,81,28,44,42,284,不合格
20100604,76,72,70,24,83,325,合格
20100605,11,88,97,46,15,257,不合格
20100606,77,82,11,62,52,284,不合格
20100607,60,86,37,37,84,304,合格
20100608,25,51,50,62,53,241,不合格
20100609,78,7,28,64,93,270,不合格
20100610,78,23,36,66,80,283,不合格
20100611,62,38,48,79,79,306,合格
20100612,24,46,16,66,14,166,不合格
20100613,19,97,99,1,75,291,不合格
20100614,33,99,76,98,57,363,合格
20100615,79,12,0,75,96,262,不合格
20100616,10,67,95,70,78,320,合格
20100617,85,26,16,58,71,256,不合格
20100618,99,70,69,91,81,410,合格
20100619,48,81,96,95,0,320,合格
20100620,71,0,99,87,6,263,不合格
20100621,58,97,66,59,94,374,合格
20100622,89,9,14,88,3,203,不合格
20100623,36,33,58,57,89,273,不合格
20100624,94,12,13,80,60,259,不合格
20100625,58,25,8,92,52,235,不合格
20100626,10,85,27,30,33,185,不合格
20100627,33,39,72,17,21,182,不合格
20100628,36,55,1,58,7,157,不合格
20100629,47,23,69,11,54,204,不合格
20100630,55,24,62,88,69,298,不合格
20100631,56,77,66,5,13,217,不合格
20100632,80,29,9,95,10,223,不合格
20100633,40,11,80,84,64,279,不合格
20100634,59,81,87,94,44,365,合格
20100635,51,71,87,32,66,307,合格
20100636,5,94,20,34,92,245,不合格
20100637,22,16,21,43,26,128,不合格
20100638,56,47,91,97,42,333,合格
20100639,6,2,33,49,78,168,不合格
20100640,54,21,23,64,52,214,不合格
20100641,48,7,99,8,2,164,不合格
20100642,0,75,76,4,98,253,不合格
20100643,82,29,39,80,61,291,不合格
20100644,90,47,11,85,69,302,合格
20100645,78,95,36,5,91,305,合格
20100646,19,52,55,5,10,141,不合格
20100647,31,61,28,92,21,233,不合格
20100648,39,11,31,9,59,149,不合格
20100649,86,80,18,37,12,233,不合格
20100650,48,12,5,74,77,216,不合格
20100651,26,33,23,10,62,154,不合格
20100652,98,99,0,14,2,213,不合格
20100653,12,5,94,87,3,201,不合格
20100654,49,14,17,4,22,106,不合格
20100655,41,2,12,16,44,115,不合格
20100656,88,60,81,47,8,284,不合格
20100657,31,6,27,29,53,146,不合格
20100658,4,63,40,7,45,159,不合格
20100659,17,10,38,78,51,194,不合格
20100660,32,93,86,21,44,276,不合格
20100661,0,43,28,90,57,218,不合格
20100662,32,57,64,56,34,243,不合格
20100663,84,84,23,97,9,297,不合格
20100664,40,20,7,28,60,155,不合格
20100665,75,10,74,78,40,277,不合格
20100666,2,61,24,92,96,275,不合格
20100667,27,96,35,37,81,276,不合格
20100668,42,71,86,77,30,306,合格
20100669,16,57,18,92,98,281,不合格
20100670,23,71,30,70,30,224,不合格
20100671,39,50,7,39,46,181,不合格
20100672,74,90,42,65,24,295,不合格
20100673,51,15,17,48,69,200,不合格
20100674,18,71,14,10,2,115,不合格
20100675,52,94,10,46,93,295,不合格
20100676,87,33,16,88,68,292,不合格
20100677,53,43,19,96,21,232,不合格
20100678,67,44,85,63,10,269,不合格
20100679,78,3,44,93,67,285,不合格
20100680,17,69,59,53,28,226,不合格
20100681,63,30,86,35,52,266,不合格
20100682,98,44,2,43,57,244,不合格
20100683,19,78,66,9,0,172,不合格
20100684,8,90,80,42,98,318,合格
20100685,69,91,49,81,4,294,不合格
20100686,69,16,49,43,66,243,不合格
20100687,81,31,82,73,19,286,不合格
20100688,56,12,45,21,75,209,不合格
20100689,0,47,84,34,57,222,不合格
20100690,14,7,96,0,49,166,不合格
20100691,84,62,38,35,89,308,合格
20100692,81,95,54,1,93,324,合格
20100693,3,32,21,6,3,65,不合格
20100694,82,49,1,40,31,203,不合格
20100695,1,33,98,5,53,190,不合格
20100696,29,40,88,8,31,196,不合格
20100697,77,2,97,20,65,261,不合格
20100698,82,78,71,33,45,309,合格
20100699,10,52,2,81,49,194,不合格
20100700,1,26,87,14,96,224,不合格
20100701,71,97,13,67,1,249,不合格
20100702,56,90,24,5,12,187,不合格
20100703,27,52,57,22,22,180,不合格
20100704,92,92,86,49,1,320,合格
20100705,88,53,60,37,97,335,合格
20100706,13,52,5,74,47,191,不合格
20100707,61,5,38,81,34,219,不合格
20100708,66,59,32,85,55,297,不合格
20100709,82,97,13,85,37,314,合格
20100710,45,44,22,79,52,242,不合格
20100711,60,0,1,84,37,182,不合格
20100712,57,30,56,81,70,294,不合格
20100713,24,13,63,21,90,211,不合格
20100714,69,72,48,44,15,248,不合格
20100715,48,86,49,33,87,303,合格
20100716,60,18,45,32,56,211,不合格
20100717,64,21,41,48,22,196,不合格
20100718,59,92,71,33,58,313,合格
20100719,49,60,9,4,99,221,不合格
20100720,4,84,95,51,42,276,不合格
20100721,4,95,96,67,58,320,合格
20100722,78,29,7,84,33,231,不合格
20100723,73,18,7,14,98,210,不合格
20100724,21,26,44,77,79,247,不合格
20100725,87,40,30,6,53,216,不合格
20100726,32,82,29,52,58,253,不合格
20100727,88,49,31,80,21,269,不合格
20100728,97,28,95,64,53,337,合格
20100729,30,58,17,44,56,205,不合格
20100730,13,59,2,67,60,201,不合格
20100731,57,53,45,68,11,234,不合格
20100732,36,87,3,2,98,226,不合格
20100733,85,44,88,36,75,328,合格
20100734,69,57,3,64,99,292,不合格
20100735,1,55,78,95,59,288,不合格
20100736,76,32,37,73,3,221,不合格
20100737,14,35,25,65,71,210,不合格
20100738,47,15,76,37,39,214,不合格
20100739,51,11,4,6,27,99,不合格
20100740,59,89,26,14,82,270,不合格
20100741,45,22,14,74,53,208,不合格
20100742,11,58,40,46,39,194,不合格
20100743,73,93,7,4,8,185,不合格
20100744,42,25,52,35,66,220,不合格
20100745,71,85,66,29,45,296,不合格
20100746,72,86,2,92,16,268,不合格
20100747,51,52,74,52,68,297,不合格
20100748,51,36,18,27,90,222,不合格
20100749,59,57,72,91,37,316,合格
20100750,0,73,6,65,32,176,不合格
20100751,71,97,40,6,69,283,不合格
20100752,85,93,9,46,48,281,不合格
20100753,99,40,43,79,53,314,合格
20100754,54,78,20,14,92,258,不合格
20100755,75,58,8,28,75,244,不合格
20100756,17,24,6,79,27,153,不合格
20100757,80,37,2,80,41,240,不合格
20100758,80,77,65,30,88,340,合格
20100759,23,8,97,51,96,275,不合格
20100760,13,33,95,38,87,266,不合格
20100761,70,48,40,33,45,236,不合格
20100762,68,51,19,98,35,271,不合格
20100763,30,6,41,29,82,188,不合格
20100764,30,14,44,82,68,238,不合格
20100765,58,68,25,86,24,261,不合格
20100766,60,72,75,71,7,285,不合格
20100767,2,31,72,28,2,135,不合格
20100768,93,74,18,58,5,248,不合格
20100769,14,16,86,90,56,262,不合格
20100770,90,69,30,27,51,267,不合格
20100771,11,13,93,0,19,136,不合格
20100772,13,43,40,40,56,192,不合格
20100773,54,63,9,42,9,177,不合格
20100774,90,29,54,83,52,308,合格
20100775,9,6,83,36,56,190,不合格
20100776,62,64,55,0,3,184,不合格
20100777,69,92,86,56,4,307,合格
20100778,41,5,90,43,74,253,不合格
20100779,71,46,5,12,42,176,不合格
20100780,37,20,10,94,18,179,不合格
20100781,3,61,2,37,95,198,不合格
20100782,51,36,88,96,43,314,合格
20100783,14,46,17,12,61,150,不合格
20100784,71,64,47,91,59,332,合格
20100785,2,52,72,7,7,140,不合格
20100786,34,23,65,89,10,221,不合格
20100787,46,82,81,1,76,286,不合格
20100788,20,37,20,13,71,161,不合格
20100789,94,56,87,60,53,350,合格
20100790,15,99,61,57,52,284,不合格
20100791,23,24,33,38,68,186,不合格
20100792,54,85,41,9,97,286,不合格
20100793,4,43,81,92,1,221,不合格
20100794,74,8,91,24,33,230,不合格
20100795,11,64,40,31,76,222,不合格
20100796,93,87,30,41,28,279,不合格
20100797,70,15,52,29,79,245,不合格
20100798,19,58,17,33,52,179,不合格
20100799,21,53,65,3,9,151,不合格
20100800,68,26,41,18,69,222,不合格
20100801,9,16,16,70,27,138,不合格
20100802,2,56,27,38,70,193,不合格
20100803,82,15,17,56,15,185,不合格
20100804,56,25,57,53,54,245,不合格
20100805,56,87,57,10,36,246,不合格
20100806,13,70,97,61,46,287,不合格
20100807,93,1,48,30,16,188,不合格
20100808,82,85,39,62,32,300,合格
20100809,9,0,99,68,91,267,不合格
20100810,67,88,64,18,28,265,不合格
20100811,99,52,12,78,20,261,不合格
20100812,47,70,48,15,89,269,不合格
20100813,6,38,48,35,13,140,不合格
20100814,8,77,12,5,89,191,不合格
20100815,85,16,25,1,62,189,不合格
20100816,16,61,54,54,30,215,不合格
20100817,40,28,2,99,61,230,不合格
20100818,47,48,38,59,19,211,不合格
20100819,24,56,55,1,83,219,不合格
20100820,44,18,97,1,83,243,不合格
20100821,12,62,33,17,63,187,不合格
20100822,66,87,30,13,93,289,不合格
20100823,51,57,50,77,19,254,不合格
20100824,9,32,82,90,44,257,不合格
20100825,81,65,46,96,28,316,合格
20100826,7,80,29,23,93,232,不合格
20100827,39,75,53,80,69,316,合格
20100828,28,3,83,23,53,190,不合格
20100829,17,27,74,39,99,256,不合格
20100830,62,42,35,79,99,317,合格
20100831,41,2,24,44,42,153,不合格
20100832,8,21,49,42,2,122,不合格
20100833,30,70,96,35,85,316,合格
20100834,55,23,38,61,0,177,不合格
20100835,60,64,58,69,60,311,合格
20100836,69,95,60,27,80,331,合格
20100837,92,57,37,78,72,336,合格
20100838,82,65,40,18,42,247,不合格
20100839,52,64,67,19,81,283,不合格
20100840,69,55,33,72,12,241,不合格
20100841,87,87,0,68,96,338,合格
20100842,40,18,50,48,75,231,不合格
20100843,42,76,34,69,30,251,不合格
20100844,15,57,43,47,35,197,不合格
20100845,57,23,9,67,1,157,不合格
20100846,54,4,36,0,97,191,不合格
20100847,26,56,25,93,90,290,不合格
20100848,46,8,38,61,32,185,不合格
20100849,32,26,94,92,87,331,合格
20100850,40,32,27,1,35,135,不合格
20100851,39,64,20,81,21,225,不合格
20100852,63,45,42,32,30,212,不合格
20100853,23,28,1,33,69,154,不合格
20100854,6,45,33,16,54,154,不合格
20100855,7,9,43,27,12,98,不合格
20100856,91,24,96,92,44,347,合格
20100857,38,96,93,25,99,351,合格
20100858,74,21,65,46,44,250,不合格
20100859,5,49,72,32,11,169,不合格
20100860,51,28,72,23,2,176,不合格
20100861,15,9,86,31,84,225,不合格
20100862,66,87,0,14,53,220,不合格
20100863,26,13,62,36,3,140,不合格
20100864,80,87,64,47,41,319,合格
20100865,5,55,87,25,1,173,不合格
20100866,32,19,3,89,23,166,不合格
20100867,68,35,62,16,89,270,不合格
20100868,69,43,3,43,4,162,不合格
20100869,75,67,67,53,23,285,不合格
20100870,24,18,27,33,14,116,不合格
20100871,41,85,77,32,31,266,不合格
20100872,38,17,60,21,27,163,不合格
20100873,42,6,56,10,17,131,不合格
20100874,99,4,56,38,78,275,不合格
20100875,77,71,47,61,69,325,合格
20100876,67,38,42,72,76,295,不合格
20100877,35,99,46,28,2,210,不合格
20100878,84,12,22,47,11,176,不合格
20100879,92,13,56,5,53,219,不合格
20100880,99,13,92,0,87,291,不合格
20100881,89,36,11,15,11,162,不合格
20100882,57,1,81,3,83,225,不合格
20100883,31,29,82,57,85,284,不合格
20100884,82,83,12,74,7,258,不合格
20100885,87,23,59,93,97,359,合格
20100886,19,11,28,80,14,152,不合格
20100887,38,25,30,67,50,210,不合格
20100888,17,65,25,53,45,205,不合格
20100889,61,45,39,26,88,259,不合格
20100890,99,65,49,16,70,299,不合格
20100891,62,49,2,73,67,253,不合格
20100892,37,61,13,9,61,181,不合格
20100893,65,84,88,33,84,354,合格
20100894,89,10,81,78,41,299,不合格
20100895,70,16,50,44,48,228,不合格
20100896,81,37,15,5,6,144,不合格
20100897,13,90,98,79,36,316,合格
20100898,29,72,54,48,57,260,不合格
20100899,55,8,69,19,58,209,不合格
20100900,45,19,57,21,50,192,不合格
20100901,2,95,24,88,13,222,不合格
20100902,64,20,59,8,18,169,不合格
20100903,69,44,2,76,88,279,不合格
20100904,82,68,65,18,78,311,合格
20100905,7,98,54,15,96,270,不合格
20100906,67,37,97,23,40,264,不合格
20100907,17,52,94,91,51,305,合格
20100908,83,35,57,42,59,276,不合格
20100909,4,46,68,34,81,233,不合格
20100910,43,24,53,33,5,158,不合格
20100911,14,39,66,69,28,216,不合格
20100912,97,88,65,46,64,360,合格
20100913,45,78,98,13,82,316,合格
20100914,71,80,27,30,28,236,不合格
20100915,18,49,59,98,17,241,不合格
20100916,31,16,15,58,63,183,不合格
20100917,31,38,58,33,84,244,不合格
20100918,40,39,37,99,56,271,不合格
20100919,96,84,31,32,98,341,合格
20100920,58,96,17,17,42,230,不合格
20100921,61,47,73,82,87,350,合格
20100922,62,95,76,15,59,307,合格
20100923,79,38,1,66,71,255,不合格
20100924,65,89,59,27,61,301,合格
20100925,60,57,17,75,28,237,不合格
20100926,64,13,29,85,58,249,不合格
20100927,70,15,61,70,78,294,不合格
20100928,93,44,80,33,25,275,不合格
20100929,83,17,75,29,36,240,不合格
20100930,95,91,44,52,40,322,合格
20100931,98,2,95,14,94,303,合格
20100932,78,87,68,38,61,332,合格
20100933,18,95,13,52,94,272,不合格
20100934,99,86,92,38,83,398,合格
20100935,86,50,94,55,40,325,合格
20100936,38,97,62,64,24,285,不合格
20100937,21,57,67,40,42,227,不合格
20100938,67,3,75,33,22,200,不合格
20100939,36,38,54,28,77,233,不合格
20100940,77,36,18,76,86,293,不合格
20100941,22,68,69,24,45,228,不合格
20100942,93,69,75,17,95,349,合格
20100943,14,19,15,46,69,163,不合格
20100944,32,44,40,67,91,274,不合格
20100945,69,58,53,83,8,271,不合格
20100946,99,72,12,64,3,250,不合格
20100947,45,29,92,39,46,251,不合格
20100948,97,79,57,2,12,247,不合格
20100949,93,15,12,61,72,253,不合格
20100950,94,57,72,93,47,363,合格
20100951,93,95,80,76,66,410,合格
20100952,0,91,52,18,57,218,不合格
20100953,19,44,46,84,0,193,不合格
20100954,2,72,4,88,60,226,不合格
20100955,81,80,28,60,50,299,不合格
20100956,37,60,73,24,50,244,不合格
20100957,16,93,14,32,31,186,不合格
20100958,67,52,4,68,60,251,不合格
20100959,36,95,53,4,0,188,不合格
20100960,83,25,31,95,85,319,合格
20100961,53,80,13,21,96,263,不合格
20100962,13,33,35,80,20,181,不合格
20100963,6,48,61,12,80,207,不合格
20100964,84,44,93,34,1,256,不合格
20100965,13,0,10,81,24,128,不合格
20100966,77,63,95,39,0,274,不合格
20100967,50,56,56,23,84,269,不合格
20100968,73,78,67,13,70,301,合格
20100969,18,29,3,38,69,157,不合格
20100970,24,58,90,51,84,307,合格
20100971,40,62,59,43,91,295,不合格
20100972,48,97,19,55,92,311,合格
20100973,16,76,88,91,29,300,合格
20100974,67,46,83,84,60,340,合格
20100975,98,7,92,90,63,350,合格
20100976,77,2,64,79,43,265,不合格
20100977,19,54,20,6,55,154,不合格
20100978,97,38,21,92,55,303,合格
20100979,52,63,96,48,9,268,不合格
20100980,5,48,50,14,41,158,不合格
20100981,9,31,15,50,96,201,不合格
20100982,34,39,20,30,59,182,不合格
20100983,14,30,38,40,89,211,不合格
20100984,72,59,44,70,53,298,不合格
20100985,78,66,41,75,70,330,合格
20100986,9,13,18,73,14,127,不合格
20100987,88,87,52,87,22,336,合格
20100988,59,91,29,84,63,326,合格
20100989,47,85,88,58,65,343,合格
20100990,44,93,89,93,12,331,合格
20100991,5,0,26,0,18,49,不合格
20100992,79,74,4,34,0,191,不合格
20100993,89,37,55,19,22,222,不合格
20100994,12,43,12,42,67,176,不合格
20100995,8,62,79,30,22,201,不合格
20100996,40,24,91,81,33,269,不合格
20100997,62,12,24,83,22,203,不合格
20100998,59,8,17,97,32,213,不合格
20100999,10,21,3,69,1,104,不合格
20101000,9,54,62,6,88,219,不合格
20101001,22,35,30,79,36,202,不合格
20101002,8,98,61,26,22,215,不合格
20101003,62,14,57,14,84,231,不合格
20101004,0,3,25,63,28,119,不合格
20101005,64,85,49,33,49,280,不合格
20101006,89,10,24,20,9,152,不合格
20101007,14,65,71,57,35,242,不合格
20101008,51,71,89,85,29,325,合格
20101009,77,63,91,14,91,336,合格
20101010,86,45,45,18,62,256,不合格
20101011,73,14,44,17,71,219,不合格
20101012,37,57,33,61,25,213,不合格
20101013,41,9,82,46,65,243,不合格
20101014,87,37,51,37,17,229,不合格
20101015,85,66,62,63,57,333,合格
20101016,65,43,96,50,44,298,不合格
20101017,96,56,80,36,24,292,不合格
20101018,77,98,64,3,10,252,不合格
20101019,27,19,23,16,53,138,不合格
20101020,53,74,15,88,14,244,不合格
20101021,73,32,9,76,81,271,不合格
20101022,53,34,74,82,15,258,不合格
20101023,30,90,93,63,6,282,不合格
20101024,98,63,10,51,13,235,不合格
20101025,27,95,64,44,13,243,不合格
20101026,11,19,58,31,96,215,不合格
20101027,4,94,2,25,36,161,不合格
20101028,90,23,76,83,99,371,合格
20101029,15,99,51,28,41,234,不合格
20101030,74,7,25,67,19,192,不合格
20101031,15,86,61,99,67,328,合格
20101032,24,10,52,76,81,243,不合格
20101033,56,68,13,56,21,214,不合格
20101034,50,96,45,46,26,263,不合格
20101035,68,65,76,16,92,317,合格
20101036,37,1,98,73,14,223,不合格
20101037,66,19,89,57,77,308,合格
20101038,64,42,49,26,11,192,不合格
20101039,28,39,14,57,34,172,不合格
20101040,19,24,0,25,77,145,不合格
20101041,79,24,63,72,89,327,合格
20101042,24,12,56,39,16,147,不合格
20101043,95,71,29,30,96,321,合格
20101044,61,91,29,86,95,362,合格
20101045,79,80,24,34,71,288,不合格
20101046,7,88,40,11,7,153,不合格
20101047,17,25,23,25,40,130,不合格
20101048,17,45,60,52,20,194,不合格
20101049,69,10,33,29,70,211,不合格
20101050,46,77,7,5,5,140,不合格
20101051,99,44,41,21,77,282,不合格
20101052,64,80,73,7,52,276,不合格
20101053,25,84,72,38,22,241,不合格
20101054,38,22,41,65,52,218,不合格
20101055,48,28,46,71,78,271,不合格
20101056,1,63,28,74,0,166,不合格
20101057,14,20,94,26,20,174,不合格
20101058,35,53,0,42,96,226,不合格
20101059,47,9,34,71,12,173,不合格
20101060,20,10,29,53,98,210,不合格
20101061,56,76,16,24,81,253,不合格
20101062,5,27,34,79,98,243,不合格
20101063,1,83,30,81,18,213,不合格
20101064,25,39,52,4,49,169,不合格
20101065,96,5,77,5,21,204,不合格
20101066,72,20,19,77,0,188,不合格
20101067,96,49,13,18,99,275,不合格
20101068,11,96,1,43,69,220,不合格
20101069,9,79,11,76,24,199,不合格
20101070,72,71,31,0,54,228,不合格
20101071,81,43,19,0,6,149,不合格
20101072,91,58,70,94,72,385,合格
20101073,86,37,13,50,20,206,不合格
20101074,7,24,21,80,99,231,不合格
20101075,51,43,2,2,87,185,不合格
20101076,70,77,12,81,46,286,不合格
20101077,44,96,30,71,90,331,合格
20101078,17,19,30,61,80,207,不合格
20101079,63,73,5,69,9,219,不合格
20101080,21,38,90,99,88,336,合格
20101081,94,26,71,63,50,304,合格
20101082,65,23,3,21,1,113,不合格
20101083,40,66,43,7,23,179,不合格
20101084,92,98,77,89,67,423,合格
20101085,61,29,30,66,9,195,不合格
20101086,59,12,18,62,87,238,不合格
20101087,98,75,62,17,97,349,合格
20101088,97,71,44,44,21,277,不合格
20101089,92,35,64,16,90,297,不合格
20101090,46,66,70,15,95,292,不合格
20101091,12,3,79,0,56,150,不合格
20101092,68,13,28,4,97,210,不合格
20101093,47,85,66,0,14,212,不合格
20101094,83,46,65,12,5,211,不合格
20101095,17,73,38,38,71,237,不合格
20101096,6,61,4,56,42,169,不合格
20101097,63,50,64,53,11,241,不合格
20101098,42,96,1,90,15,244,不合格
20101099,43,22,8,64,70,207,不合格
20101100,38,37,44,52,75,246,不合格
20101101,81,44,55,19,32,231,不合格
20101102,48,28,79,33,24,212,不合格
20101103,6,20,17,92,56,191,不合格
20101104,74,45,25,50,11,205,不合格
20101105,25,96,54,65,43,283,不合格
20101106,48,40,16,29,62,195,不合格
20101107,71,45,58,83,70,327,合格
20101108,85,88,86,68,15,342,合格
20101109,86,36,13,28,70,233,不合格
20101110,50,57,37,81,43,268,不合格
20101111,12,76,1,23,27,139,不合格
20101112,16,60,48,24,93,241,不合格
20101113,32,27,75,96,49,279,不合格
20101114,42,71,9,55,49,226,不合格
20101115,37,44,86,69,80,316,合格
20101116,84,36,75,43,63,301,合格
20101117,98,48,60,69,85,360,合格
20101118,19,10,83,74,11,197,不合格
20101119,79,37,5,14,16,151,不合格
20101120,4,42,83,53,88,270,不合格
20101121,14,56,56,58,17,201,不合格
20101122,22,59,14,90,39,224,不合格
20101123,41,82,73,73,17,286,不合格
20101124,48,10,9,26,60,153,不合格
20101125,51,13,94,50,83,291,不合格
20101126,2,96,45,36,44,223,不合格
20101127,47,75,8,20,66,216,不合格
20101128,13,11,46,50,33,153,不合格
20101129,87,24,37,68,1,217,不合格
20101130,92,17,90,58,3,260,不合格
20101131,62,80,30,21,63,256,不合格
20101132,62,70,77,4,30,243,不合格
20101133,24,23,55,49,21,172,不合格
20101134,10,71,1,66,38,186,不合格
20101135,3,96,48,44,80,271,不合格
20101136,68,92,27,78,38,303,合格
20101137,39,86,37,56,39,257,不合格
20101138,5,64,53,44,71,237,不合格
20101139,91,48,96,69,68,372,合格
20101140,94,0,89,45,53,281,不合格
20101141,67,12,54,42,28,203,不合格
20101142,91,47,71,38,63,310,合格
20101143,11,20,6,62,30,129,不合格
20101144,16,50,84,34,51,235,不合格
20101145,91,78,72,69,83,393,合格
20101146,68,62,12,6,83,231,不合格
20101147,4,77,68,27,82,258,不合格
20101148,73,42,69,99,99,382,合格
20101149,78,3,0,11,59,151,不合格
20101150,45,12,33,67,84,241,不合格
20101151,47,29,82,59,21,238,不合格
20101152,46,51,65,94,47,303,合格
20101153,42,63,94,5,94,298,不合格
20101154,21,88,18,50,25,202,不合格
20101155,56,80,45,40,75,296,不合格
20101156,2,2,45,60,10,119,不合格
20101157,71,64,85,20,22,262,不合格
20101158,77,49,93,32,56,307,合格
20101159,96,61,64,55,75,351,合格
20101160,55,5,49,57,96,262,不合格
20101161,90,86,50,93,34,353,合格
20101162,75,6,48,30,23,182,不合格
20101163,15,18,78,97,99,307,合格
20101164,15,5,37,32,8,97,不合格
20101165,33,97,24,8,70,232,不合格
20101166,37,3,1,71,19,131,不合格
20101167,55,74,45,31,66,271,不合格
20101168,2,79,30,69,94,274,不合格
20101169,52,10,84,30,27,203,不合格
20101170,78,87,90,72,49,376,合格
20101171,37,76,92,91,3,299,不合格
20101172,17,24,43,67,63,214,不合格
20101173,41,38,14,71,35,199,不合格
20101174,92,31,46,86,16,271,不合格
20101175,44,38,34,69,51,236,不合格
20101176,41,45,95,31,24,236,不合格
20101177,86,13,69,12,89,269,不合格
20101178,21,21,82,43,93,260,不合格
20101179,68,85,1,33,6,193,不合格
20101180,99,0,31,71,14,215,不合格
20101181,65,0,79,5,49,198,不合格
20101182,25,5,5,99,33,167,不合格
20101183,98,55,49,47,47,296,不合格
20101184,77,82,89,39,26,313,合格
20101185,93,92,39,27,43,294,不合格
20101186,80,69,91,88,81,409,合格
20101187,14,56,85,81,92,328,合格
20101188,86,57,79,37,92,351,合格
20101189,71,73,93,8,28,273,不合格
20101190,62,39,15,11,58,185,不合格
20101191,69,71,15,94,53,302,合格
20101192,97,5,63,32,77,274,不合格
20101193,79,66,77,15,53,290,不合格
20101194,24,93,60,72,14,263,不合格
20101195,79,35,3,4,39,160,不合格
20101196,98,9,91,45,0,243,不合格
20101197,25,25,14,65,23,152,不合格
20101198,38,43,79,56,56,272,不合格
20101199,43,48,8,88,29,216,不合格
20101200,74,30,78,76,27,285,不合格
20101201,70,55,77,59,87,348,合格
20101202,38,58,42,72,2,212,不合格
20101203,82,72,63,85,84,386,合格
20101204,10,76,96,98,5,285,不合格
20101205,70,43,31,51,17,212,不合格
20101206,70,30,4,46,17,167,不合格
20101207,27,30,79,46,5,187,不合格
20101208,75,60,55,29,87,306,合格
20101209,29,47,37,35,99,247,不合格
20101210,36,58,33,79,73,279,不合格
20101211,91,39,52,74,13,269,不合格
20101212,71,69,75,53,67,335,合格
20101213,6,43,18,16,59,142,不合格
20101214,75,12,35,28,46,196,不合格
20101215,82,60,98,86,3,329,合格
20101216,10,71,98,83,61,323,合格
20101217,76,8,87,54,11,236,不合格
20101218,93,55,49,21,52,270,不合格
20101219,46,54,8,66,56,230,不合格
20101220,6,38,48,40,63,195,不合格
20101221,4,27,5,20,61,117,不合格
20101222,43,28,81,34,94,280,不合格
20101223,48,54,98,35,43,278,不合格
20101224,99,2,72,70,41,284,不合格
20101225,41,55,65,94,69,324,合格
20101226,20,13,81,97,19,230,不合格
20101227,68,81,94,15,23,281,不合格
20101228,83,25,49,37,89,283,不合格
20101229,43,96,54,22,40,255,不合格
20101230,86,13,47,87,20,253,不合格
20101231,58,50,60,76,28,272,不合格
20101232,9,90,23,89,33,244,不合格
20101233,44,4,28,66,3,145,不合格
20101234,6,4,87,56,64,217,不合格
20101235,0,53,61,60,5,179,不合格
20101236,46,17,3,11,30,107,不合格
20101237,61,22,89,18,13,203,不合格
20101238,85,15,11,85,20,216,不合格
20101239,92,54,70,69,5,290,不合格
20101240,25,61,7,81,79,253,不合格
20101241,8,3,12,94,37,154,不合格
20101242,22,57,48,83,11,221,不合格
20101243,7,67,59,57,93,283,不合格
20101244,18,36,38,69,91,252,不合格
20101245,3,92,90,90,91,366,合格
20101246,64,66,17,9,20,176,不合格
20101247,50,42,72,37,43,244,不合格
20101248,57,48,11,82,76,274,不合格
20101249,37,65,49,8,68,227,不合格
20101250,45,1,14,46,34,140,不合格
20101251,87,29,10,4,7,137,不合格
20101252,98,95,72,49,41,355,合格
20101253,69,7,68,91,37,272,不合格
20101254,97,89,29,58,87,360,合格
20101255,83,67,43,95,39,327,合格
20101256,58,91,19,26,79,273,不合格
20101257,4,18,51,23,40,136,不合格
20101258,69,91,51,95,25,331,合格
20101259,35,88,80,92,73,368,合格
20101260,32,7,58,18,3,118,不合格
20101261,7,73,73,72,71,296,不合格
20101262,19,11,94,10,15,149,不合格
20101263,73,12,8,84,85,262,不合格
20101264,92,82,66,54,56,350,合格
20101265,17,23,52,26,1,119,不合格
20101266,28,1,5,3,54,91,不合格
20101267,82,61,72,65,48,328,合格
20101268,20,61,64,83,50,278,不合格
20101269,29,5,13,60,47,154,不合格
20101270,2,19,34,66,75,196,不合格
20101271,8,26,57,11,77,179,不合格
20101272,97,24,3,53,28,205,不合格
20101273,19,90,6,26,23,164,不合格
20101274,80,62,55,49,59,305,合格
20101275,80,51,34,35,89,289,不合格
20101276,29,71,63,55,16,234,不合格
20101277,77,13,48,35,57,230,不合格
20101278,6,52,30,11,61,160,不合格
20101279,66,92,70,90,50,368,合格
20101280,52,14,93,15,3,177,不合格
20101281,26,52,15,53,23,169,不合格
20101282,1,65,12,68,37,183,不合格
20101283,48,50,94,47,71,310,合格
20101284,32,71,36,62,58,259,不合格
20101285,17,30,43,84,42,216,不合格
20101286,86,46,43,4,62,241,不合格
20101287,5,49,25,50,41,170,不合格
20101288,49,16,54,43,56,218,不合格
20101289,61,2,68,94,56,281,不合格
20101290,28,37,43,18,85,211,不合格
20101291,0,23,88,63,21,195,不合格
20101292,39,95,35,15,21,205,不合格
20101293,69,90,53,84,1,297,不合格
20101294,85,29,92,81,73,360,合格
20101295,6,12,30,59,65,172,不合格
20101296,54,33,57,75,73,292,不合格
20101297,57,38,21,79,12,207,不合格
20101298,64,76,75,5,43,263,不合格
20101299,64,5,89,23,37,218,不合格
20101300,2,77,78,52,53,262,不合格
20101301,73,73,50,49,44,289,不合格
20101302,96,40,94,27,34,291,不合格
20101303,97,99,93,85,3,377,合格
20101304,3,38,61,44,63,209,不合格
20101305,12,69,55,41,12,189,不合格
20101306,33,79,42,70,77,301,合格
20101307,92,58,63,14,10,237,不合格
20101308,42,39,29,96,53,259,不合格
20101309,49,31,3,88,78,249,不合格
20101310,72,68,63,26,95,324,合格
20101311,87,79,31,43,96,336,合格
20101312,54,45,87,68,18,272,不合格
20101313,91,90,92,7,92,372,合格
20101314,26,98,61,29,89,303,合格
20101315,81,11,86,72,27,277,不合格
20101316,21,35,90,91,21,258,不合格
20101317,14,77,20,8,94,213,不合格
20101318,5,42,22,82,47,198,不合格
20101319,51,85,81,31,80,328,合格
20101320,29,76,32,31,72,240,不合格
20101321,30,97,25,18,88,258,不合格
20101322,11,54,19,96,2,182,不合格
20101323,32,39,81,63,26,241,不合格
20101324,63,28,18,91,18,218,不合格
20101325,98,98,11,9,13,229,不合格
20101326,53,96,47,10,65,271,不合格
20101327,90,54,46,4,99,293,不合格
20101328,22,7,83,90,18,220,不合格
20101329,48,99,71,87,36,341,合格
20101330,36,59,38,4,86,223,不合格
20101331,49,22,79,85,18,253,不合格
20101332,4,70,50,30,66,220,不合格
20101333,70,25,7,21,84,207,不合格
20101334,68,16,36,42,73,235,不合格
20101335,63,6,22,94,0,185,不合格
20101336,3,97,90,38,35,263,不合格
20101337,83,26,44,4,82,239,不合格
20101338,91,67,34,45,42,279,不合格
20101339,21,69,85,73,85,333,合格
20101340,82,31,41,72,5,231,不合格
20101341,5,49,30,57,12,153,不合格
20101342,14,97,30,19,85,245,不合格
20101343,54,72,93,11,22,252,不合格
20101344,97,62,40,76,41,316,合格
20101345,66,3,76,39,81,265,不合格
20101346,89,52,58,16,42,257,不合格
20101347,91,19,99,89,69,367,合格
20101348,77,74,1,17,16,185,不合格
20101349,78,71,25,29,22,225,不合格
20101350,27,31,77,74,42,251,不合格
20101351,55,11,64,87,79,296,不合格
20101352,19,74,62,17,81,253,不合格
20101353,48,88,75,55,2,268,不合格
20101354,87,96,71,74,80,408,合格
20101355,18,80,39,10,71,218,不合格
20101356,48,16,4,6,79,153,不合格
20101357,92,32,7,59,35,225,不合格
20101358,83,99,99,11,77,369,合格
20101359,37,65,39,42,19,202,不合格
20101360,48,83,30,63,71,295,不合格
20101361,16,29,88,94,60,287,不合格
20101362,76,59,90,80,50,355,合格
20101363,39,31,56,59,13,198,不合格
20101364,30,31,48,53,11,173,不合格
20101365,93,87,24,52,75,331,合格
20101366,95,46,17,60,49,267,不合格
20101367,80,8,56,10,5,159,不合格
20101368,2,13,80,92,4,191,不合格
20101369,82,57,96,17,90,342,合格
20101370,47,3,41,87,53,231,不合格
20101371,11,76,4,75,45,211,不合格
20101372,5,47,12,95,77,236,不合格
20101373,37,88,30,65,86,306,合格
20101374,64,71,39,12,3,189,不合格
20101375,19,64,66,60,89,298,不合格
20101376,80,26,75,45,54,280,不合格
20101377,63,15,44,64,2,188,不合格
20101378,40,89,14,86,81,310,合格
20101379,56,48,31,68,24,227,不合格
20101380,87,81,40,6,13,227,不合格
20101381,39,92,80,81,99,391,合格
20101382,76,37,44,58,61,276,不合格
20101383,92,61,75,90,98,416,合格
20101384,18,76,27,97,55,273,不合格
20101385,96,16,41,61,37,251,不合格
20101386,90,29,86,5,78,288,不合格
20101387,85,18,88,21,59,271,不合格
20101388,59,55,75,1,84,274,不合格
20101389,63,42,19,76,76,276,不合格
20101390,56,38,75,98,91,358,合格
20101391,9,29,10,41,76,165,不合格
20101392,59,44,53,82,86,324,合格
20101393,69,55,64,2,2,192,不合格
20101394,4,13,30,18,57,122,不合格
20101395,87,35,88,21,86,317,合格
20101396,90,15,11,92,47,255,不合格
20101397,23,75,26,9,95,228,不合格
20101398,86,18,41,89,70,304,合格
20101399,20,94,5,11,96,226,不合格
20101400,83,69,33,13,70,268,不合格
20101401,28,1,87,13,27,156,不合格
20101402,77,97,65,40,81,360,合格
20101403,39,33,99,62,56,289,不合格
20101404,24,16,94,41,86,261,不合格
20101405,11,79,47,23,88,248,不合格
20101406,1,83,26,51,84,245,不合格
20101407,47,29,88,14,86,264,不合格
20101408,33,90,19,7,28,177,不合格
20101409,10,72,82,4,25,193,不合格
20101410,78,91,4,49,60,282,不合格
20101411,98,26,44,14,13,195,不合格
20101412,76,57,50,81,79,343,合格
20101413,6,93,73,45,52,269,不合格
20101414,61,23,49,44,4,181,不合格
20101415,79,14,25,63,76,257,不合格
20101416,15,1,31,63,79,189,不合格
20101417,89,70,69,79,94,401,合格
20101418,87,94,20,29,28,258,不合格
20101419,68,29,63,42,38,240,不合格
20101420,57,82,10,20,27,196,不合格
20101421,55,23,35,7,17,137,不合格
20101422,84,59,94,37,86,360,合格
20101423,29,85,43,70,78,305,合格
20101424,12,62,86,90,95,345,合格
20101425,21,54,21,7,72,175,不合格
20101426,6,88,84,80,71,329,合格
20101427,74,44,3,33,66,220,不合格
20101428,18,83,3,15,77,196,不合格
20101429,73,65,6,55,57,256,不合格
20101430,44,74,38,69,20,245,不合格
20101431,52,69,26,35,19,201,不合格
20101432,1,54,11,76,66,208,不合格
20101433,48,50,5,79,26,208,不合格
20101434,62,64,17,80,53,276,不合格
20101435,67,22,68,61,46,264,不合格
20101436,96,66,78,2,42,284,不合格
20101437,87,45,28,50,48,258,不合格
20101438,47,42,69,53,91,302,合格
20101439,73,94,35,39,62,303,合格
20101440,17,69,94,3,33,216,不合格
20101441,43,98,86,42,33,302,合格
20101442,0,66,13,28,10,117,不合格
20101443,3,52,48,58,21,182,不合格
20101444,63,17,26,12,89,207,不合格
20101445,66,36,98,51,59,310,合格
20101446,85,81,23,65,81,335,合格
20101447,15,65,68,58,73,279,不合格
20101448,63,39,97,55,72,326,合格
20101449,12,62,55,26,51,206,不合格
20101450,57,70,97,17,87,328,合格
20101451,58,7,83,55,50,253,不合格
20101452,47,63,77,83,47,317,合格
20101453,60,15,54,21,9,159,不合格
20101454,52,68,91,14,8,233,不合格
20101455,72,14,5,85,99,275,不合格
20101456,76,81,78,20,61,316,合格
20101457,12,78,34,92,27,243,不合格
20101458,87,44,89,76,39,335,合格
20101459,54,25,98,51,86,314,合格
20101460,97,66,31,43,9,246,不合格
20101461,82,4,79,94,21,280,不合格
20101462,9,83,10,73,68,243,不合格
20101463,97,59,62,5,27,250,不合格
20101464,97,91,60,50,30,328,合格
20101465,72,70,16,91,71,320,合格
20101466,56,77,57,22,95,307,合格
20101467,9,49,39,46,11,154,不合格
20101468,30,4,52,49,10,145,不合格
20101469,37,61,99,85,77,359,合格
20101470,49,96,93,25,56,319,合格
20101471,6,17,43,67,16,149,不合格
20101472,35,25,92,58,54,264,不合格
20101473,65,73,9,14,1,162,不合格
20101474,81,64,71,37,81,334,合格
20101475,93,40,95,58,61,347,合格
20101476,66,17,14,12,29,138,不合格
20101477,11,93,86,67,29,286,不合格
20101478,55,82,15,40,5,197,不合格
20101479,24,39,94,89,65,311,合格
20101480,40,93,98,57,56,344,合格
20101481,54,37,5,18,22,136,不合格
20101482,14,97,69,32,47,259,不合格
20101483,83,56,6,98,65,308,合格
20101484,9,8,81,57,57,212,不合格
20101485,11,68,18,11,20,128,不合格
20101486,9,25,48,42,65,189,不合格
20101487,95,36,62,16,69,278,不合格
20101488,15,43,85,70,39,252,不合格
20101489,12,58,5,50,79,204,不合格
20101490,40,95,76,11,14,236,不合格
20101491,28,13,21,73,74,209,不合格
20101492,26,74,45,1,4,150,不合格
20101493,94,8,1,78,88,269,不合格
20101494,39,7,76,91,19,232,不合格
20101495,29,14,29,38,6,116,不合格
20101496,67,51,67,44,45,274,不合格
20101497,31,2,0,66,83,182,不合格
20101498,65,2,36,80,39,222,不合格
20101499,54,48,87,42,1,232,不合格
20101500,26,34,7,78,46,191,不合格
20101501,3,37,50,24,70,184,不合格
20101502,11,21,81,20,61,194,不合格
20101503,22,75,94,26,0,217,不合格
20101504,45,36,78,50,48,257,不合格
20101505,14,57,95,19,6,191,不合格
20101506,90,74,5,95,61,325,合格
20101507,76,50,64,66,8,264,不合格
20101508,20,6,97,31,72,226,不合格
20101509,59,14,67,44,53,237,不合格
20101510,80,98,11,68,90,347,合格
20101511,56,97,55,0,88,296,不合格
20101512,33,24,82,35,58,232,不合格
20101513,46,66,80,12,2,206,不合格
20101514,73,70,71,16,1,231,不合格
20101515,93,13,67,50,39,262,不合格
20101516,55,33,61,40,90,279,不合格
20101517,22,73,53,40,48,236,不合格
20101518,74,0,65,89,41,269,不合格
20101519,2,68,57,35,16,178,不合格
20101520,64,30,1,12,46,153,不合格
20101521,72,93,72,68,7,312,合格
20101522,38,57,58,25,13,191,不合格
20101523,12,97,7,59,87,262,不合格
20101524,57,34,6,27,91,215,不合格
20101525,43,18,21,3,96,181,不合格
20101526,70,9,68,87,3,237,不合格
20101527,70,57,28,11,93,259,不合格
20101528,11,77,37,52,21,198,不合格
20101529,74,91,73,88,37,363,合格
20101530,82,48,64,93,57,344,合格
20101531,56,1,91,12,80,240,不合格
20101532,26,14,76,97,36,249,不合格
20101533,38,97,56,60,88,339,合格
20101534,23,23,50,75,60,231,不合格
20101535,4,18,10,18,55,105,不合格
20101536,40,0,61,8,63,172,不合格
20101537,39,6,66,85,85,281,不合格
20101538,60,77,31,16,6,190,不合格
20101539,36,56,83,97,10,282,不合格
20101540,48,78,39,9,7,181,不合格
20101541,6,59,87,95,87,334,合格
20101542,26,75,19,61,30,211,不合格
20101543,65,40,24,65,1,195,不合格
20101544,97,59,84,59,75,374,合格
20101545,35,71,96,90,45,337,合格
20101546,33,46,65,3,76,223,不合格
20101547,63,70,18,82,27,260,不合格
20101548,79,53,1,58,25,216,不合格
20101549,87,16,58,31,27,219,不合格
20101550,7,77,1,64,46,195,不合格
20101551,42,8,35,13,43,141,不合格
20101552,21,69,82,32,84,288,不合格
20101553,49,28,93,36,30,236,不合格
20101554,48,45,82,20,3,198,不合格
20101555,78,76,68,0,57,279,不合格
20101556,4,7,67,98,7,183,不合格
20101557,98,49,43,88,85,363,合格
20101558,22,17,20,45,9,113,不合格
20101559,68,40,58,1,43,210,不合格
20101560,48,97,61,87,95,388,合格
20101561,18,4,48,35,80,185,不合格
20101562,16,90,32,57,66,261,不合格
20101563,13,99,62,77,70,321,合格
20101564,70,85,45,27,47,274,不合格
20101565,88,85,49,55,93,370,合格
20101566,0,23,34,96,62,215,不合格
20101567,31,73,28,27,23,182,不合格
20101568,45,12,92,25,0,174,不合格
20101569,87,22,78,51,50,288,不合格
20101570,51,64,51,1,98,265,不合格
20101571,53,48,28,18,55,202,不合格
20101572,14,69,76,98,63,320,合格
20101573,48,99,37,77,11,272,不合格
20101574,70,70,54,4,86,284,不合格
20101575,3,37,88,65,92,285,不合格
20101576,96,61,76,29,71,333,合格
20101577,73,17,83,95,93,361,合格
20101578,25,21,68,54,31,199,不合格
20101579,76,68,77,22,58,301,合格
20101580,86,15,22,39,49,211,不合格
20101581,16,15,46,40,38,155,不合格
20101582,93,86,96,20,75,370,合格
20101583,84,96,70,66,70,386,合格
20101584,95,46,3,16,74,234,不合格
20101585,63,78,36,5,79,261,不合格
20101586,77,10,73,83,48,291,不合格
20101587,49,91,23,10,29,202,不合格
20101588,92,47,88,8,33,268,不合格
20101589,82,94,63,56,91,386,合格
20101590,98,91,38,66,35,328,合格
20101591,40,7,22,9,25,103,不合格
20101592,73,58,8,39,32,210,不合格
20101593,65,9,89,98,82,343,合格
20101594,6,59,67,88,57,277,不合格
20101595,36,98,81,90,61,366,合格
20101596,51,31,32,4,28,146,不合格
20101597,5,87,83,23,95,293,不合格
20101598,24,28,10,24,56,142,不合格
20101599,87,77,84,20,84,352,合格
20101600,5,59,80,7,73,224,不合格
20101601,86,9,40,85,0,220,不合格
20101602,65,34,7,4,20,130,不合格
20101603,90,53,0,63,85,291,不合格
20101604,41,33,3,66,5,148,不合格
20101605,85,32,8,91,37,253,不合格
20101606,84,7,57,98,72,318,合格
20101607,60,52,68,64,57,301,合格
20101608,31,34,64,64,5,198,不合格
20101609,95,59,22,5,10,191,不合格
20101610,14,84,38,22,62,220,不合格
20101611,49,20,34,60,58,221,不合格
20101612,25,78,50,66,13,232,不合格
20101613,82,43,4,29,36,194,不合格
20101614,33,95,11,31,19,189,不合格
20101615,36,78,86,26,41,267,不合格
20101616,8,32,93,18,70,221,不合格
20101617,75,74,53,77,8,287,不合格
20101618,78,96,42,97,18,331,合格
20101619,65,92,42,88,0,287,不合格
20101620,75,15,84,39,93,306,合格
20101621,75,4,50,57,24,210,不合格
20101622,60,98,50,32,74,314,合格
20101623,92,22,5,48,26,193,不合格
20101624,1,64,41,95,28,229,不合格
20101625,12,84,49,10,58,213,不合格
20101626,33,71,14,8,67,193,不合格
20101627,36,54,50,56,30,226,不合格
20101628,11,57,32,73,82,255,不合格
20101629,26,61,84,4,6,181,不合格
20101630,4,50,62,5,1,122,不合格
20101631,82,11,35,70,98,296,不合格
20101632,88,90,98,49,87,412,合格
20101633,89,38,55,23,68,273,不合格
20101634,22,43,79,71,78,293,不合格
20101635,63,69,52,77,14,275,不合格
20101636,80,67,95,86,7,335,合格
20101637,9,16,5,32,55,117,不合格
20101638,73,63,0,76,89,301,合格
20101639,79,85,48,60,19,291,不合格
20101640,96,88,96,45,40,365,合格
20101641,30,72,86,77,4,269,不合格
20101642,65,17,55,34,12,183,不合格
20101643,60,50,40,25,38,213,不合格
20101644,45,7,60,47,42,201,不合格
20101645,0,39,77,83,80,279,不合格
20101646,63,58,29,4,10,164,不合格
20101647,61,37,58,3,16,175,不合格
20101648,27,48,83,59,59,276,不合格
20101649,88,18,52,86,5,249,不合格
20101650,59,45,38,75,94,311,合格
20101651,84,22,11,10,62,189,不合格
20101652,20,22,12,25,34,113,不合格
20101653,28,23,39,77,69,236,不合格
20101654,33,94,3,7,11,148,不合格
20101655,72,44,37,85,72,310,合格
20101656,49,73,9,36,92,259,不合格
20101657,21,90,98,43,51,303,合格
20101658,39,89,39,11,25,203,不合格
20101659,46,13,37,57,1,154,不合格
20101660,6,37,39,5,18,105,不合格
20101661,38,28,47,28,79,220,不合格
20101662,78,47,5,41,45,216,不合格
20101663,7,40,7,75,46,175,不合格
20101664,58,92,10,66,2,228,不合格
20101665,47,51,94,23,12,227,不合格
20101666,13,90,77,83,17,280,不合格
20101667,57,22,97,4,80,260,不合格
20101668,56,20,12,54,23,165,不合格
20101669,36,13,89,15,44,197,不合格
20101670,76,31,13,69,87,276,不合格
20101671,24,10,41,27,30,132,不合格
20101672,39,9,91,15,68,222,不合格
20101673,17,89,67,49,8,230,不合格
20101674,3,55,41,45,48,192,不合格
20101675,82,73,59,12,91,317,合格
20101676,6,69,18,75,72,240,不合格
20101677,86,80,54,94,86,400,合格
20101678,1,12,52,19,16,100,不合格
20101679,21,5,14,25,41,106,不合格
20101680,15,85,48,13,77,238,不合格
20101681,20,83,52,37,55,247,不合格
20101682,64,57,63,34,31,249,不合格
20101683,80,39,36,84,92,331,合格
20101684,80,88,90,63,86,407,合格
20101685,50,62,82,17,7,218,不合格
20101686,63,92,85,25,76,341,合格
20101687,2,46,33,89,32,202,不合格
20101688,52,94,73,68,57,344,合格
20101689,64,66,45,4,87,266,不合格
20101690,41,49,88,42,82,302,合格
20101691,89,0,5,23,5,122,不合格
20101692,2,70,70,9,38,189,不合格
20101693,81,41,98,40,92,352,合格
20101694,4,37,59,66,24,190,不合格
20101695,74,79,99,21,46,319,合格
20101696,31,50,7,74,61,223,不合格
20101697,41,59,1,97,22,220,不合格
20101698,22,12,4,58,65,161,不合格
20101699,51,81,93,28,47,300,合格
20101700,80,51,69,13,79,292,不合格
20101701,47,63,97,84,34,325,合格
20101702,97,53,70,72,69,361,合格
20101703,5,19,85,28,50,187,不合格
20101704,38,11,2,70,55,176,不合格
20101705,99,57,99,84,17,356,合格
20101706,60,37,77,47,28,249,不合格
20101707,29,61,44,82,29,245,不合格
20101708,38,44,81,68,16,247,不合格
20101709,92,66,66,66,43,333,合格
20101710,12,90,26,9,70,207,不合格
20101711,67,95,14,7,8,191,不合格
20101712,71,64,93,6,35,269,不合格
20101713,5,89,49,71,56,270,不合格
20101714,81,22,43,35,74,255,不合格
20101715,70,84,59,40,22,275,不合格
20101716,1,11,98,81,12,203,不合格
20101717,70,10,70,51,8,209,不合格
20101718,98,22,85,81,22,308,合格
20101719,71,12,36,26,91,236,不合格
20101720,16,37,33,36,72,194,不合格
20101721,37,89,50,20,0,196,不合格
20101722,40,21,46,81,38,226,不合格
20101723,63,8,11,76,18,176,不合格
20101724,0,31,65,91,88,275,不合格
20101725,59,78,34,27,75,273,不合格
20101726,58,31,38,23,37,187,不合格
20101727,27,34,43,1,36,141,不合格
20101728,72,96,94,83,34,379,合格
20101729,66,44,68,91,53,322,合格
20101730,50,69,3,51,74,247,不合格
20101731,73,5,2,5,14,99,不合格
20101732,54,99,54,95,19,321,合格
20101733,85,67,5,86,97,340,合格
20101734,1,2,72,0,9,84,不合格
20101735,85,25,69,88,81,348,合格
20101736,45,61,32,10,50,198,不合格
20101737,60,83,49,37,12,241,不合格
20101738,23,20,76,75,83,277,不合格
20101739,77,15,9,94,19,214,不合格
20101740,41,36,4,20,8,109,不合格
20101741,50,70,80,32,45,277,不合格
20101742,38,56,8,99,33,234,不合格
20101743,91,15,56,4,60,226,不合格
20101744,36,83,77,76,95,367,合格
20101745,83,44,26,20,85,258,不合格
20101746,49,36,87,74,67,313,合格
20101747,32,74,71,21,27,225,不合格
20101748,28,49,10,11,92,190,不合格
20101749,84,80,46,68,36,314,合格
20101750,53,34,36,80,52,255,不合格
20101751,54,63,0,65,64,246,不合格
20101752,53,64,32,78,54,281,不合格
20101753,2,14,2,70,39,127,不合格
20101754,4,62,17,48,29,160,不合格
20101755,84,92,14,61,78,329,合格
20101756,89,55,74,8,30,256,不合格
20101757,53,19,46,84,91,293,不合格
20101758,48,72,43,96,33,292,不合格
20101759,47,83,6,43,34,213,不合格
20101760,63,84,70,74,96,387,合格
20101761,74,66,98,93,13,344,合格
20101762,47,17,5,13,93,175,不合格
20101763,32,96,35,6,31,200,不合格
20101764,31,61,29,40,78,239,不合格
20101765,65,86,12,48,90,301,合格
20101766,24,29,51,41,88,233,不合格
20101767,28,1,25,89,80,223,不合格
20101768,11,45,64,42,68,230,不合格
20101769,16,22,99,2,19,158,不合格
20101770,14,69,13,31,8,135,不合格
20101771,16,32,57,11,41,157,不合格
20101772,59,80,12,41,27,219,不合格
20101773,15,94,97,79,30,315,合格
20101774,31,9,47,14,94,195,不合格
20101775,22,12,8,86,82,210,不合格
20101776,76,1,7,22,62,168,不合格
20101777,50,36,74,96,40,296,不合格
20101778,94,9,82,34,99,318,合格
20101779,26,92,54,14,60,246,不合格
20101780,82,34,64,24,22,226,不合格
20101781,35,23,83,56,91,288,不合格
20101782,45,92,1,39,59,236,不合格
20101783,76,72,97,28,70,343,合格
20101784,89,14,81,12,66,262,不合格
20101785,65,50,88,67,55,325,合格
20101786,50,42,24,42,87,245,不合格
20101787,36,30,14,78,37,195,不合格
20101788,63,47,67,20,28,225,不合格
20101789,86,28,68,24,26,232,不合格
20101790,49,40,93,0,90,272,不合格
20101791,74,89,78,33,9,283,不合格
20101792,49,88,97,51,50,335,合格
20101793,91,62,15,8,61,237,不合格
20101794,0,68,36,33,82,219,不合格
20101795,93,79,49,50,85,356,合格
20101796,27,6,6,14,48,101,不合格
20101797,96,15,63,22,10,206,不合格
20101798,96,39,29,86,41,291,不合格
20101799,12,24,48,73,84,241,不合格
20101800,84,14,2,89,31,220,不合格
20101801,45,54,93,76,15,283,不合格
20101802,2,39,3,33,64,141,不合格
20101803,88,62,58,76,74,358,合格
20101804,77,70,35,67,47,296,不合格
20101805,23,48,41,83,68,263,不合格
20101806,94,23,83,75,2,277,不合格
20101807,93,21,25,98,43,280,不合格
20101808,41,38,8,69,81,237,不合格
20101809,87,44,81,67,31,310,合格
20101810,41,84,0,35,28,188,不合格
20101811,43,52,48,94,26,263,不合格
20101812,73,7,4,63,97,244,不合格
20101813,72,27,96,86,87,368,合格
20101814,28,30,62,16,0,136,不合格
20101815,56,63,68,23,58,268,不合格
20101816,70,2,16,91,34,213,不合格
20101817,63,78,33,32,39,245,不合格
20101818,23,22,14,2,91,152,不合格
20101819,44,61,84,19,77,285,不合格
20101820,99,1,31,69,45,245,不合格
20101821,90,69,36,6,48,249,不合格
20101822,31,72,24,92,97,316,合格
20101823,42,48,7,77,54,228,不合格
20101824,32,84,61,48,87,312,合格
20101825,30,53,1,59,64,207,不合格
20101826,37,10,0,92,22,161,不合格
20101827,10,62,96,19,57,244,不合格
20101828,28,33,37,11,72,181,不合格
20101829,19,18,99,54,49,239,不合格
20101830,44,69,29,99,26,267,不合格
20101831,13,61,61,23,23,181,不合格
20101832,91,91,55,79,64,380,合格
20101833,77,70,77,61,24,309,合格
20101834,85,53,40,70,97,345,合格
20101835,76,28,46,93,16,259,不合格
20101836,81,89,93,51,14,328,合格
20101837,64,74,97,45,3,283,不合格
20101838,49,55,29,17,4,154,不合格
20101839,92,79,85,51,40,347,合格
20101840,81,57,34,94,33,299,不合格
20101841,14,65,85,19,71,254,不合格
20101842,95,33,83,61,92,364,合格
20101843,65,96,6,97,64,328,合格
20101844,33,72,73,19,87,284,不合格
20101845,26,63,22,74,69,254,不合格
20101846,96,44,21,55,2,218,不合格
20101847,92,98,98,78,93,459,合格
20101848,2,65,46,4,3,120,不合格
20101849,60,0,85,16,70,231,不合格
20101850,54,22,68,11,58,213,不合格
20101851,25,42,40,96,17,220,不合格
20101852,65,61,54,89,74,343,合格
20101853,18,69,33,63,92,275,不合格
20101854,31,72,81,32,30,246,不合格
20101855,95,69,77,63,99,403,合格
20101856,44,72,71,91,36,314,合格
20101857,81,45,52,64,35,277,不合格
20101858,35,8,27,66,88,224,不合格
20101859,13,9,54,70,52,198,不合格
20101860,3,3,2,30,15,53,不合格
20101861,99,17,12,43,68,239,不合格
20101862,42,97,15,65,81,300,合格
20101863,11,77,32,69,57,246,不合格
20101864,42,53,76,58,22,251,不合格
20101865,70,45,47,65,16,243,不合格
20101866,12,58,51,51,8,180,不合格
20101867,9,38,50,77,76,250,不合格
20101868,90,85,4,26,42,247,不合格
20101869,77,40,62,79,0,258,不合格
20101870,24,38,22,80,4,168,不合格
20101871,77,34,89,65,65,330,合格
20101872,50,86,7,30,9,182,不合格
20101873,98,39,65,48,62,312,合格
20101874,76,3,34,8,31,152,不合格
20101875,49,2,7,70,13,141,不合格
20101876,92,35,44,79,87,337,合格
20101877,31,81,87,64,53,316,合格
20101878,7,77,62,92,0,238,不合格
20101879,90,72,97,56,14,329,合格
20101880,34,73,14,71,90,282,不合格
20101881,92,1,85,10,77,265,不合格
20101882,59,94,49,61,77,340,合格
20101883,74,99,42,50,13,278,不合格
20101884,80,48,31,39,44,242,不合格
20101885,82,88,20,9,49,248,不合格
20101886,30,84,92,12,2,220,不合格
20101887,16,17,67,3,21,124,不合格
20101888,88,53,77,9,52,279,不合格
20101889,34,57,22,69,36,218,不合格
20101890,57,86,21,46,82,292,不合格
20101891,87,21,2,24,58,192,不合格
20101892,45,97,76,63,71,352,合格
20101893,67,53,50,97,44,311,合格
20101894,78,30,68,97,18,291,不合格
20101895,24,82,18,3,89,216,不合格
20101896,96,75,61,57,99,388,合格
20101897,83,18,41,41,61,244,不合格
20101898,86,67,34,68,39,294,不合格
20101899,65,35,29,19,99,247,不合格
20101900,12,5,5,33,56,111,不合格
20101901,82,8,77,70,86,323,合格
20101902,6,1,50,8,56,121,不合格
20101903,73,73,64,72,76,358,合格
20101904,66,80,90,18,28,282,不合格
20101905,34,24,61,24,77,220,不合格
20101906,88,51,27,40,1,207,不合格
20101907,59,80,84,27,58,308,合格
20101908,72,20,88,20,37,237,不合格
20101909,93,40,33,32,15,213,不合格
20101910,53,51,86,92,65,347,合格
20101911,53,93,61,50,1,258,不合格
20101912,56,89,6,43,19,213,不合格
20101913,58,10,91,62,59,280,不合格
20101914,97,38,64,96,63,358,合格
20101915,74,9,71,7,52,213,不合格
20101916,14,80,19,79,58,250,不合格
20101917,88,4,31,13,90,226,不合格
20101918,88,5,9,38,88,228,不合格
20101919,90,58,97,55,93,393,合格
20101920,20,31,28,68,45,192,不合格
20101921,19,43,55,28,81,226,不合格
20101922,99,91,4,51,90,335,合格
20101923,90,10,58,2,73,233,不合格
20101924,14,57,15,83,55,224,不合格
20101925,73,70,26,33,23,225,不合格
20101926,61,66,63,3,34,227,不合格
20101927,12,94,49,73,8,236,不合格
20101928,7,78,77,33,23,218,不合格
20101929,88,92,84,95,2,361,合格
20101930,36,46,99,45,14,240,不合格
20101931,43,89,58,47,87,324,合格
20101932,18,33,13,7,63,134,不合格
20101933,22,24,4,8,60,118,不合格
20101934,67,28,86,14,10,205,不合格
20101935,91,76,19,51,50,287,不合格
20101936,42,99,27,86,64,318,合格
20101937,43,50,10,38,71,212,不合格
20101938,8,55,7,93,60,223,不合格
20101939,37,75,63,23,39,237,不合格
20101940,17,54,79,76,43,269,不合格
20101941,78,46,11,51,71,257,不合格
20101942,32,80,60,98,24,294,不合格
20101943,20,9,56,67,31,183,不合格
20101944,50,92,28,89,47,306,合格
20101945,99,88,35,23,10,255,不合格
20101946,47,2,14,54,24,141,不合格
20101947,11,15,63,80,78,247,不合格
20101948,49,16,59,43,40,207,不合格
20101949,13,63,93,59,89,317,合格
20101950,29,21,40,51,41,182,不合格
20101951,68,58,37,3,86,252,不合格
20101952,14,14,46,51,98,223,不合格
20101953,49,77,88,24,85,323,合格
20101954,70,69,52,36,77,304,合格
20101955,73,99,87,22,74,355,合格
20101956,68,75,63,49,98,353,合格
20101957,23,74,71,97,98,363,合格
20101958,53,50,54,61,93,311,合格
20101959,23,40,97,93,74,327,合格
20101960,30,48,22,74,0,174,不合格
20101961,43,97,55,67,42,304,合格
20101962,42,73,71,82,85,353,合格
20101963,51,69,8,21,70,219,不合格
20101964,48,87,58,80,59,332,合格
20101965,31,37,38,50,55,211,不合格
20101966,22,43,89,69,40,263,不合格
20101967,74,77,31,51,23,256,不合格
20101968,35,40,69,60,24,228,不合格
20101969,52,45,7,47,90,241,不合格
20101970,1,25,12,39,54,131,不合格
20101971,93,90,2,8,98,291,不合格
20101972,99,58,32,99,23,311,合格
20101973,46,93,75,48,33,295,不合格
20101974,47,55,17,68,84,271,不合格
20101975,48,54,68,87,83,340,合格
20101976,15,43,47,66,7,178,不合格
20101977,88,39,10,61,90,288,不合格
20101978,2,0,12,30,80,124,不合格
20101979,53,50,65,89,29,286,不合格
20101980,62,81,13,26,4,186,不合格
20101981,91,0,39,28,11,169,不合格
20101982,42,27,7,22,76,174,不合格
20101983,30,36,32,77,17,192,不合格
20101984,37,53,2,97,52,241,不合格
20101985,91,72,23,44,11,241,不合格
20101986,80,9,66,11,1,167,不合格
20101987,78,88,76,2,52,296,不合格
20101988,62,74,60,52,36,284,不合格
20101989,96,41,8,89,51,285,不合格
20101990,9,90,46,30,15,190,不合格
20101991,46,44,61,93,62,306,合格
20101992,48,48,88,89,34,307,合格
20101993,98,20,68,29,42,257,不合格
20101994,60,82,40,22,43,247,不合格
20101995,22,54,18,73,76,243,不合格
20101996,15,98,10,51,91,265,不合格
20101997,85,45,37,32,13,212,不合格
20101998,88,47,17,96,84,332,合格
20101999,40,92,53,25,22,232,不合格
20102000,99,42,81,39,24,285,不合格
20102001,82,8,40,51,8,189,不合格
20102002,34,85,60,25,93,297,不合格
20102003,61,51,21,78,11,222,不合格
20102004,18,7,65,2,20,112,不合格
20102005,30,7,13,46,8,104,不合格
20102006,9,67,20,42,92,230,不合格
20102007,16,83,43,67,26,235,不合格
20102008,85,57,61,32,98,333,合格
20102009,77,28,29,4,90,228,不合格
20102010,6,43,72,26,83,230,不合格
20102011,53,32,26,8,51,170,不合格
20102012,96,3,18,64,89,270,不合格
20102013,72,65,55,97,21,310,合格
20102014,16,60,49,81,47,253,不合格
20102015,69,49,81,54,1,254,不合格
20102016,94,19,85,37,60,295,不合格
20102017,48,78,30,29,67,252,不合格
20102018,3,73,80,88,85,329,合格
20102019,93,33,88,23,58,295,不合格
20102020,23,4,68,29,31,155,不合格
20102021,49,29,21,71,11,181,不合格
20102022,49,31,45,41,65,231,不合格
20102023,15,36,14,64,31,160,不合格
20102024,89,71,1,69,89,319,合格
20102025,4,69,84,45,4,206,不合格
20102026,83,61,2,5,92,243,不合格
20102027,57,3,34,55,12,161,不合格
20102028,44,5,13,81,98,241,不合格
20102029,75,5,98,28,79,285,不合格
20102030,84,86,14,18,91,293,不合格
20102031,81,81,7,47,10,226,不合格
20102032,0,17,75,82,14,188,不合格
20102033,46,82,26,56,16,226,不合格
20102034,87,22,71,68,60,308,合格
20102035,23,73,6,44,86,232,不合格
20102036,72,54,18,49,95,288,不合格
20102037,22,88,48,56,49,263,不合格
20102038,51,89,39,19,10,208,不合格
20102039,80,36,17,66,74,273,不合格
20102040,32,78,92,28,87,317,合格
20102041,53,10,41,53,76,233,不合格
20102042,17,60,94,7,18,196,不合格
20102043,16,69,13,39,95,232,不合格
20102044,7,61,48,16,43,175,不合格
20102045,83,70,35,67,76,331,合格
20102046,93,20,68,9,94,284,不合格
20102047,3,92,24,52,56,227,不合格
20102048,91,16,77,46,97,327,合格
20102049,79,75,73,32,81,340,合格
20102050,72,38,19,29,40,198,不合格
20102051,80,91,51,29,83,334,合格
20102052,26,90,5,26,63,210,不合格
20102053,85,16,78,6,77,262,不合格
20102054,27,96,94,93,80,390,合格
20102055,69,43,10,21,68,211,不合格
20102056,26,25,35,61,15,162,不合格
20102057,49,78,0,21,18,166,不合格
20102058,14,80,47,30,16,187,不合格
20102059,63,72,8,8,34,185,不合格
20102060,15,58,31,55,33,192,不合格
20102061,55,64,98,17,46,280,不合格
20102062,53,66,17,30,31,197,不合格
20102063,19,98,76,10,51,254,不合格
20102064,37,75,44,10,9,175,不合格
20102065,29,35,64,26,29,183,不合格
20102066,32,59,13,73,90,267,不合格
20102067,9,98,9,62,27,205,不合格
20102068,14,46,59,59,89,267,不合格
20102069,66,78,54,25,85,308,合格
20102070,89,79,98,90,81,437,合格
20102071,67,74,64,6,39,250,不合格
20102072,7,82,75,69,62,295,不合格
20102073,66,11,26,33,49,185,不合格
20102074,58,66,58,36,98,316,合格
20102075,91,93,77,51,94,406,合格
20102076,61,11,91,94,10,267,不合格
20102077,39,35,48,33,55,210,不合格
20102078,41,23,15,61,24,164,不合格
20102079,74,3,18,97,0,192,不合格
20102080,19,57,54,80,41,251,不合格
20102081,2,55,82,60,61,260,不合格
20102082,22,34,69,75,75,275,不合格
20102083,0,75,5,68,47,195,不合格
20102084,56,15,20,49,76,216,不合格
20102085,2,87,53,61,13,216,不合格
20102086,30,73,24,98,77,302,合格
20102087,3,35,61,71,22,192,不合格
20102088,68,90,62,64,9,293,不合格
20102089,16,47,58,46,95,262,不合格
20102090,42,10,49,54,57,212,不合格
20102091,27,52,78,68,58,283,不合格
20102092,19,24,44,92,82,261,不合格
20102093,75,44,97,89,96,401,合格
20102094,16,4,41,71,61,193,不合格
20102095,65,18,26,32,53,194,不合格
20102096,15,77,84,61,21,258,不合格
20102097,53,10,58,34,38,193,不合格
20102098,13,48,7,12,1,81,不合格
20102099,17,41,73,34,24,189,不合格
20102100,60,4,6,69,19,158,不合格
20102101,82,95,22,25,19,243,不合格
20102102,48,92,70,13,53,276,不合格
20102103,62,20,68,48,67,265,不合格
20102104,84,78,94,70,78,404,合格
20102105,39,77,15,66,37,234,不合格
20102106,51,46,97,56,48,298,不合格
20102107,78,92,56,22,63,311,合格
20102108,89,41,37,40,21,228,不合格
20102109,19,0,77,91,39,226,不合格
20102110,9,35,15,10,11,80,不合格
20102111,80,99,71,90,0,340,合格
20102112,34,36,76,16,47,209,不合格
20102113,12,4,62,61,97,236,不合格
20102114,37,72,96,39,82,326,合格
20102115,78,82,37,63,30,290,不合格
20102116,73,68,2,58,21,222,不合格
20102117,14,65,9,65,28,181,不合格
20102118,15,54,40,63,37,209,不合格
20102119,84,55,23,7,49,218,不合格
20102120,39,87,78,66,24,294,不合格
20102121,54,5,95,28,97,279,不合格
20102122,93,29,5,91,32,250,不合格
20102123,99,59,19,43,91,311,合格
20102124,43,78,60,84,14,279,不合格
20102125,25,77,53,55,39,249,不合格
20102126,97,23,63,9,5,197,不合格
20102127,55,32,95,17,1,200,不合格
20102128,99,61,49,86,45,340,合格
20102129,49,88,32,47,16,232,不合格
20102130,43,10,57,1,42,153,不合格
20102131,45,22,87,10,44,208,不合格
20102132,28,95,73,48,48,292,不合格
20102133,25,51,17,54,68,215,不合格
20102134,66,87,70,99,83,405,合格
20102135,13,49,41,71,32,206,不合格
20102136,54,23,64,29,74,244,不合格
20102137,8,71,9,35,55,178,不合格
20102138,23,85,55,96,68,327,合格
20102139,72,48,51,56,73,300,合格
20102140,89,74,47,63,8,281,不合格
20102141,86,20,55,17,43,221,不合格
20102142,24,88,52,2,73,239,不合格
20102143,6,95,51,59,49,260,不合格
20102144,25,54,54,67,4,204,不合格
20102145,22,88,24,78,12,224,不合格
20102146,93,87,84,13,29,306,合格
20102147,22,27,59,65,76,249,不合格
20102148,59,91,46,16,99,311,合格
20102149,79,97,45,35,61,317,合格
20102150,46,42,71,86,47,292,不合格
20102151,52,63,90,56,67,328,合格
20102152,35,52,86,34,44,251,不合格
20102153,61,41,96,63,85,346,合格
20102154,94,99,84,2,71,350,合格
20102155,76,47,18,91,18,250,不合格
20102156,52,7,74,96,6,235,不合格
20102157,25,33,10,66,47,181,不合格
20102158,7,12,73,12,4,108,不合格
20102159,47,89,52,46,72,306,合格
20102160,89,69,2,55,53,268,不合格
20102161,52,7,75,63,46,243,不合格
20102162,6,37,39,8,47,137,不合格
20102163,97,31,76,76,19,299,不合格
20102164,89,77,41,84,37,328,合格
20102165,88,57,56,11,47,259,不合格
20102166,77,78,61,21,25,262,不合格
20102167,48,2,85,18,1,154,不合格
20102168,16,16,96,92,96,316,合格
20102169,59,78,58,64,49,308,合格
20102170,58,84,85,92,35,354,合格
20102171,92,35,25,82,20,254,不合格
20102172,43,68,95,5,90,301,合格
20102173,54,22,22,15,15,128,不合格
20102174,70,96,80,70,1,317,合格
20102175,91,99,33,90,57,370,合格
20102176,86,87,84,15,14,286,不合格
20102177,12,38,60,17,45,172,不合格
20102178,10,43,7,42,50,152,不合格
20102179,5,2,82,62,33,184,不合格
20102180,24,56,95,17,41,233,不合格
20102181,12,44,60,86,20,222,不合格
20102182,95,18,70,58,60,301,合格
20102183,85,26,32,49,92,284,不合格
20102184,64,17,27,55,54,217,不合格
20102185,25,28,27,80,57,217,不合格
20102186,38,27,39,88,93,285,不合格
20102187,2,65,22,44,2,135,不合格
20102188,96,87,53,45,3,284,不合格
20102189,53,39,95,87,6,280,不合格
20102190,54,3,50,53,97,257,不合格
20102191,43,37,51,98,8,237,不合格
20102192,22,58,46,55,39,220,不合格
20102193,69,98,65,14,24,270,不合格
20102194,54,87,58,44,73,316,合格
20102195,91,35,22,66,87,301,合格
20102196,31,98,2,25,96,252,不合格
20102197,30,19,95,71,13,228,不合格
20102198,55,23,41,33,76,228,不合格
20102199,62,99,36,92,32,321,合格
20102200,96,35,52,43,9,235,不合格
20102201,69,99,63,93,80,404,合格
20102202,81,8,62,8,29,188,不合格
20102203,68,98,5,86,95,352,合格
20102204,84,33,1,57,99,274,不合格
20102205,38,59,72,34,91,294,不合格
20102206,35,87,84,5,86,297,不合格
20102207,96,86,62,90,86,420,合格
20102208,84,2,92,90,41,309,合格
20102209,23,14,26,98,86,247,不合格
20102210,92,74,39,86,21,312,合格
20102211,14,21,55,41,7,138,不合格
20102212,14,35,96,94,16,255,不合格
20102213,80,46,39,61,33,259,不合格
20102214,53,67,36,56,15,227,不合格
20102215,71,61,69,1,86,288,不合格
20102216,42,40,13,65,23,183,不合格
20102217,74,18,15,63,77,247,不合格
20102218,48,11,54,73,68,254,不合格
20102219,0,75,97,89,0,261,不合格
20102220,38,73,77,75,31,294,不合格
20102221,63,54,69,15,40,241,不合格
20102222,50,25,55,20,30,180,不合格
20102223,81,21,0,96,31,229,不合格
20102224,86,2,32,26,87,233,不合格
20102225,83,43,99,48,68,341,合格
20102226,69,14,36,71,3,193,不合格
20102227,90,20,17,3,5,135,不合格
20102228,57,80,34,92,22,285,不合格
20102229,16,81,81,94,58,330,合格
20102230,16,41,0,52,87,196,不合格
20102231,74,78,90,73,56,371,合格
20102232,62,54,45,54,76,291,不合格
20102233,92,90,49,21,66,318,合格
20102234,25,41,35,32,90,223,不合格
20102235,72,94,10,72,62,310,合格
20102236,60,71,48,1,91,271,不合格
20102237,4,40,10,5,3,62,不合格
20102238,13,68,24,4,99,208,不合格
20102239,27,58,26,18,67,196,不合格
20102240,49,66,59,36,67,277,不合格
20102241,57,2,52,58,3,172,不合格
20102242,55,69,27,19,79,249,不合格
20102243,79,33,89,25,46,272,不合格
20102244,41,86,74,21,4,226,不合格
20102245,34,30,72,19,70,225,不合格
20102246,48,91,92,59,1,291,不合格
20102247,85,10,46,26,89,256,不合格
20102248,67,84,82,94,74,401,合格
20102249,99,63,25,80,75,342,合格
20102250,69,53,29,31,22,204,不合格
20102251,24,41,1,28,64,158,不合格
20102252,92,40,96,12,1,241,不合格
20102253,22,0,54,19,73,168,不合格
20102254,64,39,52,90,76,321,合格
20102255,96,86,97,70,67,416,合格
20102256,46,94,18,60,90,308,合格
20102257,95,15,57,96,92,355,合格
20102258,57,95,22,23,95,292,不合格
20102259,62,33,2,74,70,241,不合格
20102260,79,57,18,89,98,341,合格
20102261,15,21,29,67,60,192,不合格
20102262,67,33,98,10,71,279,不合格
20102263,91,28,39,92,83,333,合格
20102264,90,47,80,96,16,329,合格
20102265,27,44,76,58,39,244,不合格
20102266,99,80,77,33,74,363,合格
20102267,79,77,37,14,41,248,不合格
20102268,81,87,77,50,52,347,合格
20102269,31,15,57,38,84,225,不合格
20102270,93,80,49,5,84,311,合格
20102271,92,18,64,68,33,275,不合格
20102272,1,18,28,50,43,140,不合格
20102273,40,4,63,10,10,127,不合格
20102274,81,38,79,88,28,314,合格
20102275,33,99,60,64,30,286,不合格
20102276,77,63,41,21,78,280,不合格
20102277,28,0,23,87,38,176,不合格
20102278,47,80,11,1,24,163,不合格
20102279,97,86,33,90,68,374,合格
20102280,60,62,48,62,41,273,不合格
20102281,36,25,17,5,39,122,不合格
20102282,90,36,74,70,8,278,不合格
20102283,78,98,21,73,20,290,不合格
20102284,35,46,62,87,56,286,不合格
20102285,56,32,34,12,86,220,不合格
20102286,82,82,87,36,20,307,合格
20102287,0,2,85,32,11,130,不合格
20102288,95,79,33,9,14,230,不合格
20102289,66,32,89,10,1,198,不合格
20102290,58,59,4,12,57,190,不合格
20102291,81,3,79,73,35,271,不合格
20102292,81,83,29,2,3,198,不合格
20102293,85,9,92,84,93,363,合格
20102294,60,1,98,55,54,268,不合格
20102295,44,14,94,79,25,256,不合格
20102296,26,95,23,51,76,271,不合格
20102297,32,61,15,64,77,249,不合格
20102298,71,51,13,68,73,276,不合格
20102299,54,99,97,5,15,270,不合格
20102300,10,95,90,45,79,319,合格
20102301,17,10,11,63,93,194,不合格
20102302,37,65,84,67,35,288,不合格
20102303,16,36,33,12,4,101,不合格
20102304,26,73,4,0,54,157,不合格
20102305,36,91,73,62,13,275,不合格
20102306,36,97,11,78,58,280,不合格
20102307,75,74,6,0,3,158,不合格
20102308,20,73,16,3,23,135,不合格
20102309,94,2,48,66,68,278,不合格
20102310,41,12,76,5,99,233,不合格
20102311,91,4,45,74,74,288,不合格
20102312,66,18,16,4,63,167,不合格
20102313,79,40,99,17,80,315,合格
20102314,62,97,34,47,87,327,合格
20102315,29,67,50,24,92,262,不合格
20102316,80,40,22,4,2,148,不合格
20102317,7,70,37,32,13,159,不合格
20102318,1,52,25,1,45,124,不合格
20102319,47,83,89,91,24,334,合格
20102320,12,13,10,93,30,158,不合格
20102321,90,50,97,72,23,332,合格
20102322,46,9,91,95,3,244,不合格
20102323,83,56,74,59,62,334,合格
20102324,69,79,10,33,25,216,不合格
20102325,53,36,70,86,2,247,不合格
20102326,60,22,30,42,59,213,不合格
20102327,67,93,86,50,40,336,合格
20102328,54,18,13,86,97,268,不合格
20102329,9,91,93,81,96,370,合格
20102330,56,77,8,84,31,256,不合格
20102331,25,63,45,0,61,194,不合格
20102332,98,96,4,62,37,297,不合格
20102333,66,23,30,95,9,223,不合格
20102334,16,91,23,15,49,194,不合格
20102335,5,13,50,47,13,128,不合格
20102336,40,19,2,90,47,198,不合格
20102337,13,13,67,19,70,182,不合格
20102338,20,33,85,19,28,185,不合格
20102339,9,98,72,18,15,212,不合格
20102340,14,96,17,94,41,262,不合格
20102341,67,53,75,93,13,301,合格
20102342,80,66,49,27,72,294,不合格
20102343,23,83,53,91,20,270,不合格
20102344,97,23,22,1,82,225,不合格
20102345,14,75,48,16,50,203,不合格
20102346,17,68,21,31,43,180,不合格
20102347,16,64,23,86,60,249,不合格
20102348,42,70,50,8,33,203,不合格
20102349,56,7,28,29,6,126,不合格
20102350,98,35,10,98,6,247,不合格
20102351,99,69,36,98,0,302,合格
20102352,66,51,75,90,69,351,合格
20102353,38,87,54,32,19,230,不合格
20102354,46,17,28,32,80,203,不合格
20102355,42,98,23,91,36,290,不合格
20102356,93,56,95,51,56,351,合格
20102357,25,9,39,43,29,145,不合格
20102358,7,46,9,61,70,193,不合格
20102359,61,28,66,48,0,203,不合格
20102360,64,82,55,25,77,303,合格
20102361,60,89,50,14,93,306,合格
20102362,61,36,78,21,75,271,不合格
20102363,96,12,95,86,74,363,合格
20102364,16,91,2,45,32,186,不合格
20102365,42,3,55,11,57,168,不合格
20102366,8,44,32,69,28,181,不合格
20102367,52,27,10,16,86,191,不合格
20102368,75,5,78,91,81,330,合格
20102369,99,7,27,13,71,217,不合格
20102370,87,76,18,15,92,288,不合格
20102371,13,30,51,52,58,204,不合格
20102372,89,21,47,32,21,210,不合格
20102373,56,98,39,48,7,248,不合格
20102374,42,12,13,14,82,163,不合格
20102375,24,78,69,18,87,276,不合格
20102376,40,66,30,87,17,240,不合格
20102377,94,24,80,38,2,238,不合格
20102378,22,31,46,30,22,151,不合格
20102379,32,96,98,34,60,320,合格
20102380,89,52,41,21,66,269,不合格
20102381,7,23,41,13,18,102,不合格
20102382,96,37,51,75,86,345,合格
20102383,75,63,18,15,4,175,不合格
20102384,75,60,3,17,84,239,不合格
20102385,81,97,71,90,98,437,合格
20102386,40,90,5,68,73,276,不合格
20102387,13,43,83,15,69,223,不合格
20102388,78,50,11,49,28,216,不合格
20102389,86,12,78,52,73,301,合格
20102390,65,86,8,30,90,279,不合格
20102391,14,28,75,96,50,263,不合格
20102392,91,42,35,24,99,291,不合格
20102393,7,23,89,95,50,264,不合格
20102394,55,67,52,68,54,296,不合格
20102395,62,7,52,81,33,235,不合格
20102396,27,97,66,32,39,261,不合格
20102397,30,75,43,58,73,279,不合格
20102398,52,73,3,32,77,237,不合格
20102399,81,15,76,89,2,263,不合格
20102400,69,0,53,45,20,187,不合格
20102401,22,14,29,80,72,217,不合格
20102402,35,23,61,6,4,129,不合格
20102403,46,86,79,90,39,340,合格
20102404,85,38,57,23,83,286,不合格
20102405,88,76,8,13,98,283,不合格
20102406,42,92,14,78,16,242,不合格
20102407,14,95,68,37,6,220,不合格
20102408,30,27,69,99,97,322,合格
20102409,89,19,82,9,92,291,不合格
20102410,26,70,92,48,72,308,合格
20102411,73,16,68,94,76,327,合格
20102412,37,73,74,95,61,340,合格
20102413,0,24,69,29,9,131,不合格
20102414,81,11,57,53,48,250,不合格
20102415,13,44,19,68,33,177,不合格
20102416,83,68,34,30,16,231,不合格
20102417,28,10,1,91,36,166,不合格
20102418,87,96,11,43,87,324,合格
20102419,85,67,80,89,30,351,合格
20102420,16,61,54,58,76,265,不合格
20102421,56,48,7,11,8,130,不合格
20102422,17,27,75,49,11,179,不合格
20102423,50,12,92,83,41,278,不合格
20102424,66,73,18,47,4,208,不合格
20102425,70,0,47,66,37,220,不合格
20102426,19,50,61,9,45,184,不合格
20102427,11,77,90,15,75,268,不合格
20102428,39,55,82,26,74,276,不合格
20102429,46,2,58,26,72,204,不合格
20102430,72,56,93,17,31,269,不合格
20102431,20,28,57,23,95,223,不合格
20102432,27,30,30,5,95,187,不合格
20102433,84,77,59,23,50,293,不合格
20102434,80,21,70,99,33,303,合格
20102435,79,42,97,3,99,320,合格
20102436,73,22,94,47,5,241,不合格
20102437,34,98,23,92,61,308,合格
20102438,89,44,17,40,12,202,不合格
20102439,20,68,2,39,14,143,不合格
20102440,66,51,75,66,57,315,合格
20102441,37,65,66,10,55,233,不合格
20102442,67,44,82,14,44,251,不合格
20102443,26,30,67,59,97,279,不合格
20102444,60,27,91,58,16,252,不合格
20102445,20,42,87,88,46,283,不合格
20102446,34,38,23,36,36,167,不合格
20102447,50,27,75,28,34,214,不合格
20102448,10,88,33,89,28,248,不合格
20102449,40,44,25,3,1,113,不合格
20102450,15,70,86,17,16,204,不合格
20102451,48,9,46,48,11,162,不合格
20102452,55,73,4,15,74,221,不合格
20102453,68,95,70,47,67,347,合格
20102454,21,5,61,62,90,239,不合格
20102455,62,47,59,68,52,288,不合格
20102456,79,34,81,37,94,325,合格
20102457,55,70,1,58,96,280,不合格
20102458,49,91,37,28,97,302,合格
20102459,66,90,26,15,5,202,不合格
20102460,97,26,18,32,15,188,不合格
20102461,72,17,33,10,19,151,不合格
20102462,95,43,50,18,18,224,不合格
20102463,9,40,92,76,7,224,不合格
20102464,84,80,89,40,52,345,合格
20102465,59,2,50,59,31,201,不合格
20102466,78,70,2,51,87,288,不合格
20102467,23,18,81,13,35,170,不合格
20102468,99,39,23,37,41,239,不合格
20102469,81,53,87,19,0,240,不合格
20102470,47,48,99,29,90,313,合格
20102471,68,74,34,44,7,227,不合格
20102472,14,26,35,49,52,176,不合格
20102473,61,81,79,39,21,281,不合格
20102474,74,49,43,67,84,317,合格
20102475,53,32,30,86,35,236,不合格
20102476,80,89,89,2,57,317,合格
20102477,77,34,90,85,7,293,不合格
20102478,29,43,51,66,79,268,不合格
20102479,13,28,84,96,53,274,不合格
20102480,50,94,17,46,9,216,不合格
20102481,11,51,24,78,89,253,不合格
20102482,19,80,8,99,59,265,不合格
20102483,90,6,89,63,83,331,合格
20102484,59,59,28,64,75,285,不合格
20102485,45,89,55,11,6,206,不合格
20102486,63,19,26,94,98,300,合格
20102487,64,26,96,95,9,290,不合格
20102488,5,80,95,22,3,205,不合格
20102489,78,82,56,72,66,354,合格
20102490,59,33,16,75,85,268,不合格
20102491,74,7,58,76,53,268,不合格
20102492,70,75,32,21,8,206,不合格
20102493,46,27,81,86,36,276,不合格
20102494,17,59,22,19,31,148,不合格
20102495,64,50,79,73,60,326,合格
20102496,6,25,83,24,80,218,不合格
20102497,0,45,94,3,93,235,不合格
20102498,55,71,44,17,33,220,不合格
20102499,63,37,64,85,66,315,合格
20102500,22,26,75,36,58,217,不合格
20102501,15,37,40,94,11,197,不合格
20102502,46,17,45,37,71,216,不合格
20102503,53,95,35,72,23,278,不合格
20102504,67,79,58,93,21,318,合格
20102505,65,78,97,65,53,358,合格
20102506,85,30,32,10,7,164,不合格
20102507,64,23,29,17,18,151,不合格
20102508,0,37,28,90,17,172,不合格
20102509,37,95,60,21,38,251,不合格
20102510,28,13,24,99,35,199,不合格
20102511,36,96,8,79,87,306,合格
20102512,49,26,75,20,83,253,不合格
20102513,82,86,42,96,31,337,合格
20102514,28,63,46,91,84,312,合格
20102515,33,53,90,97,25,298,不合格
20102516,94,27,5,2,99,227,不合格
20102517,5,86,61,16,70,238,不合格
20102518,47,60,62,81,14,264,不合格
20102519,91,67,64,9,76,307,合格
20102520,85,28,19,31,43,206,不合格
20102521,84,50,88,2,32,256,不合格
20102522,84,40,22,50,43,239,不合格
20102523,67,44,82,8,3,204,不合格
20102524,1,67,63,31,45,207,不合格
20102525,31,65,61,77,56,290,不合格
20102526,90,57,50,4,85,286,不合格
20102527,91,32,91,10,89,313,合格
20102528,71,83,39,3,60,256,不合格
20102529,13,50,66,6,95,230,不合格
20102530,99,24,89,42,16,270,不合格
20102531,19,8,62,33,47,169,不合格
20102532,32,84,87,95,0,298,不合格
20102533,71,16,49,29,81,246,不合格
20102534,69,49,58,99,15,290,不合格
20102535,0,22,70,96,21,209,不合格
20102536,30,58,98,77,61,324,合格
20102537,65,45,92,48,88,338,合格
20102538,41,84,51,66,36,278,不合格
20102539,39,46,61,60,37,243,不合格
20102540,2,16,40,57,25,140,不合格
20102541,35,23,96,98,39,291,不合格
20102542,98,74,80,96,27,375,合格
20102543,86,27,60,9,97,279,不合格
20102544,20,52,67,44,26,209,不合格
20102545,60,4,50,3,65,182,不合格
20102546,32,81,21,21,37,192,不合格
20102547,16,7,52,33,38,146,不合格
20102548,96,17,89,44,89,335,合格
20102549,12,53,68,92,83,308,合格
20102550,63,77,18,42,5,205,不合格
20102551,24,78,89,3,19,213,不合格
20102552,28,2,96,65,71,262,不合格
20102553,1,6,22,75,21,125,不合格
20102554,59,91,43,49,64,306,合格
20102555,90,65,26,80,81,342,合格
20102556,80,98,21,95,27,321,合格
20102557,18,35,2,44,37,136,不合格
20102558,78,23,96,45,65,307,合格
20102559,48,73,80,90,78,369,合格
20102560,40,30,80,39,61,250,不合格
20102561,16,32,85,86,36,255,不合格
20102562,65,4,36,57,75,237,不合格
20102563,42,87,4,24,22,179,不合格
20102564,40,50,41,11,29,171,不合格
20102565,0,3,52,15,47,117,不合格
20102566,23,51,98,87,1,260,不合格
20102567,87,21,28,72,26,234,不合格
20102568,68,39,50,55,27,239,不合格
20102569,67,39,48,94,57,305,合格
20102570,44,28,64,92,79,307,合格
20102571,43,53,93,43,75,307,合格
20102572,3,48,76,54,78,259,不合格
20102573,15,68,30,14,97,224,不合格
20102574,59,4,82,70,28,243,不合格
20102575,31,56,22,3,72,184,不合格
20102576,40,40,33,14,97,224,不合格
20102577,71,10,27,54,6,168,不合格
20102578,71,18,91,5,75,260,不合格
20102579,63,93,57,53,32,298,不合格
20102580,95,45,81,83,83,387,合格
20102581,63,55,93,9,12,232,不合格
20102582,83,28,66,58,84,319,合格
20102583,98,79,39,16,21,253,不合格
20102584,85,98,55,22,96,356,合格
20102585,33,50,51,4,39,177,不合格
20102586,80,19,78,70,27,274,不合格
20102587,19,52,18,80,92,261,不合格
20102588,32,54,60,97,21,264,不合格
20102589,6,89,99,63,12,269,不合格
20102590,85,46,26,20,8,185,不合格
20102591,65,41,55,16,33,210,不合格
20102592,96,68,80,85,3,332,合格
20102593,38,2,8,43,77,168,不合格
20102594,49,20,61,78,52,260,不合格
20102595,92,11,18,54,27,202,不合格
20102596,92,64,17,4,79,256,不合格
20102597,29,50,14,26,30,149,不合格
20102598,8,26,29,89,97,249,不合格
20102599,28,87,97,72,34,318,合格
20102600,63,45,1,40,85,234,不合格
20102601,92,85,99,76,85,437,合格
20102602,61,37,31,75,54,258,不合格
20102603,59,50,7,55,74,245,不合格
20102604,91,49,35,66,56,297,不合格
20102605,53,82,87,95,71,388,合格
20102606,70,61,30,64,29,254,不合格
20102607,59,12,96,42,35,244,不合格
20102608,41,98,90,79,62,370,合格
20102609,85,61,71,94,54,365,合格
20102610,43,64,75,14,39,235,不合格
20102611,47,54,43,37,68,249,不合格
20102612,30,93,32,36,11,202,不合格
20102613,65,47,98,41,4,255,不合格
20102614,7,13,91,87,81,279,不合格
20102615,16,90,8,89,52,255,不合格
20102616,93,95,19,23,66,296,不合格
20102617,62,81,73,1,18,235,不合格
20102618,20,1,98,88,17,224,不合格
20102619,65,10,88,52,2,217,不合格
20102620,54,76,7,19,16,172,不合格
20102621,54,74,35,36,36,235,不合格
20102622,47,17,78,59,35,236,不合格
20102623,56,84,52,37,25,254,不合格
20102624,29,92,63,43,37,264,不合格
20102625,38,83,56,6,10,193,不合格
20102626,4,24,96,11,10,145,不合格
20102627,67,85,45,90,38,325,合格
20102628,32,28,60,80,19,219,不合格
20102629,91,65,1,46,22,225,不合格
20102630,58,22,64,75,62,281,不合格
20102631,58,82,9,30,11,190,不合格
20102632,42,35,37,31,59,204,不合格
20102633,85,29,75,67,91,347,合格
20102634,44,9,4,91,33,181,不合格
20102635,62,20,57,58,63,260,不合格
20102636,24,68,14,54,2,162,不合格
20102637,81,5,75,65,0,226,不合格
20102638,54,94,69,99,22,338,合格
20102639,87,67,66,82,90,392,合格
20102640,91,64,44,82,58,339,合格
20102641,81,96,66,77,39,359,合格
20102642,51,49,99,88,66,353,合格
20102643,36,86,66,90,51,329,合格
20102644,47,72,65,63,13,260,不合格
20102645,10,92,72,87,27,288,不合格
20102646,23,50,2,8,98,181,不合格
20102647,16,33,12,36,73,170,不合格
20102648,61,81,95,44,91,372,合格
20102649,35,70,54,8,18,185,不合格
20102650,93,9,15,95,83,295,不合格
20102651,96,49,87,62,36,330,合格
20102652,99,79,83,15,25,301,合格
20102653,62,15,29,58,22,186,不合格
20102654,49,20,21,89,12,191,不合格
20102655,3,43,39,6,47,138,不合格
20102656,74,74,11,27,48,234,不合格
20102657,68,40,9,49,66,232,不合格
20102658,88,83,96,15,24,306,合格
20102659,32,18,7,40,9,106,不合格
20102660,13,41,67,6,32,159,不合格
20102661,27,57,12,89,43,228,不合格
20102662,76,0,81,75,29,261,不合格
20102663,53,41,22,61,38,215,不合格
20102664,50,12,27,14,26,129,不合格
20102665,67,67,1,38,80,253,不合格
20102666,20,60,45,86,4,215,不合格
20102667,51,38,72,18,18,197,不合格
20102668,57,98,15,91,70,331,合格
20102669,37,17,74,58,33,219,不合格
20102670,83,45,47,84,93,352,合格
20102671,89,26,26,33,58,232,不合格
20102672,38,24,73,68,44,247,不合格
20102673,16,29,97,87,71,300,合格
20102674,54,10,17,61,10,152,不合格
20102675,16,75,72,8,40,211,不合格
20102676,12,67,67,85,26,257,不合格
20102677,85,58,63,64,73,343,合格
20102678,30,8,85,95,85,303,合格
20102679,39,97,24,41,85,286,不合格
20102680,59,41,73,51,14,238,不合格
20102681,38,21,78,88,96,321,合格
20102682,70,8,97,83,65,323,合格
20102683,70,33,95,99,65,362,合格
20102684,76,4,77,22,85,264,不合格
20102685,98,60,8,52,48,266,不合格
20102686,52,64,54,87,19,276,不合格
20102687,22,66,7,0,24,119,不合格
20102688,20,50,93,70,98,331,合格
20102689,87,81,43,41,57,309,合格
20102690,66,55,2,66,76,265,不合格
20102691,57,52,95,53,20,277,不合格
20102692,90,16,87,56,24,273,不合格
20102693,46,45,42,57,82,272,不合格
20102694,18,74,96,76,17,281,不合格
20102695,8,94,27,80,87,296,不合格
20102696,86,0,87,41,77,291,不合格
20102697,18,60,82,97,78,335,合格
20102698,85,38,80,15,50,268,不合格
20102699,53,92,15,81,62,303,合格
20102700,94,19,87,12,91,303,合格
20102701,63,82,96,81,90,412,合格
20102702,12,82,51,84,72,301,合格
20102703,59,36,61,39,11,206,不合格
20102704,72,61,83,65,62,343,合格
20102705,80,84,80,84,85,413,合格
20102706,79,72,27,29,57,264,不合格
20102707,60,54,80,24,60,278,不合格
20102708,34,2,27,46,23,132,不合格
20102709,29,78,45,50,55,257,不合格
20102710,89,16,84,72,1,262,不合格
20102711,84,68,34,10,94,290,不合格
20102712,2,35,99,51,62,249,不合格
20102713,53,54,6,54,38,205,不合格
20102714,40,15,34,28,12,129,不合格
20102715,26,62,83,90,71,332,合格
20102716,67,10,29,17,92,215,不合格
20102717,51,77,39,91,90,348,合格
20102718,22,64,58,48,98,290,不合格
20102719,59,20,52,4,82,217,不合格
20102720,95,0,69,58,16,238,不合格
20102721,73,47,25,80,2,227,不合格
20102722,82,12,77,4,24,199,不合格
20102723,25,71,84,93,80,353,合格
20102724,55,38,27,77,89,286,不合格
20102725,68,58,55,32,59,272,不合格
20102726,64,54,54,16,35,223,不合格
20102727,59,98,92,80,35,364,合格
20102728,38,62,72,42,45,259,不合格
20102729,97,46,76,47,35,301,合格
20102730,49,68,20,51,57,245,不合格
20102731,89,74,58,72,48,341,合格
20102732,45,88,92,85,88,398,合格
20102733,93,10,6,39,70,218,不合格
20102734,79,98,83,74,76,410,合格
20102735,38,3,24,86,25,176,不合格
20102736,60,7,78,21,42,208,不合格
20102737,91,20,38,63,84,296,不合格
20102738,53,47,29,50,0,179,不合格
20102739,33,35,62,47,81,258,不合格
20102740,90,78,26,83,71,348,合格
20102741,87,74,13,31,73,278,不合格
20102742,50,82,58,83,94,367,合格
20102743,86,88,94,70,12,350,合格
20102744,41,86,91,60,37,315,合格
20102745,60,93,69,65,5,292,不合格
20102746,31,50,42,87,24,234,不合格
20102747,66,20,34,80,28,228,不合格
20102748,69,25,33,93,9,229,不合格
20102749,99,93,6,39,9,246,不合格
20102750,96,9,52,16,94,267,不合格
20102751,5,76,1,19,30,131,不合格
20102752,43,44,7,9,78,181,不合格
20102753,19,58,9,23,1,110,不合格
20102754,5,26,61,45,23,160,不合格
20102755,42,9,35,87,46,219,不合格
20102756,7,72,99,79,54,311,合格
20102757,99,78,40,92,53,362,合格
20102758,32,11,29,14,30,116,不合格
20102759,63,11,51,75,71,271,不合格
20102760,11,25,48,19,92,195,不合格
20102761,7,86,98,19,92,302,合格
20102762,27,34,45,71,90,267,不合格
20102763,46,54,27,41,48,216,不合格
20102764,45,3,94,30,55,227,不合格
20102765,5,11,33,57,32,138,不合格
20102766,26,12,30,87,70,225,不合格
20102767,34,93,25,72,30,254,不合格
20102768,62,44,7,26,45,184,不合格
20102769,57,7,93,97,41,295,不合格
20102770,28,7,24,42,79,180,不合格
20102771,84,43,24,62,47,260,不合格
20102772,95,13,6,69,58,241,不合格
20102773,29,80,68,14,88,279,不合格
20102774,43,12,55,47,13,170,不合格
20102775,78,23,4,91,36,232,不合格
20102776,61,8,65,39,53,226,不合格
20102777,0,31,77,68,11,187,不合格
20102778,84,43,39,37,50,253,不合格
20102779,1,58,18,94,68,239,不合格
20102780,16,18,9,15,88,146,不合格
20102781,97,84,67,5,52,305,合格
20102782,98,35,92,35,72,332,合格
20102783,44,12,9,58,79,202,不合格
20102784,59,87,98,2,79,325,合格
20102785,47,3,99,16,45,210,不合格
20102786,82,62,73,17,18,252,不合格
20102787,64,82,10,1,63,220,不合格
20102788,30,38,28,34,4,134,不合格
20102789,16,62,71,48,4,201,不合格
20102790,7,45,49,19,18,138,不合格
20102791,87,70,86,75,64,382,合格
20102792,77,86,31,91,72,357,合格
20102793,37,59,55,5,94,250,不合格
20102794,40,4,78,96,36,254,不合格
20102795,12,11,13,13,49,98,不合格
20102796,68,80,6,17,64,235,不合格
20102797,29,76,13,7,99,224,不合格
20102798,86,15,67,19,11,198,不合格
20102799,1,16,42,71,79,209,不合格
20102800,88,91,78,36,42,335,合格
20102801,49,59,37,95,47,287,不合格
20102802,79,82,60,74,77,372,合格
20102803,76,25,38,94,84,317,合格
20102804,89,59,25,5,58,236,不合格
20102805,98,14,35,12,62,221,不合格
20102806,67,17,41,45,74,244,不合格
20102807,89,4,55,83,15,246,不合格
20102808,19,11,24,91,11,156,不合格
20102809,25,8,14,70,30,147,不合格
20102810,28,75,79,38,67,287,不合格
20102811,19,1,82,70,17,189,不合格
20102812,44,43,5,36,95,223,不合格
20102813,32,51,37,33,1,154,不合格
20102814,95,8,71,72,22,268,不合格
20102815,76,60,21,42,35,234,不合格
20102816,42,75,55,8,88,268,不合格
20102817,22,83,68,19,34,226,不合格
20102818,1,32,58,66,87,244,不合格
20102819,18,84,30,36,12,180,不合格
20102820,49,17,77,9,62,214,不合格
20102821,10,19,96,53,47,225,不合格
20102822,55,62,48,21,55,241,不合格
20102823,49,45,87,32,43,256,不合格
20102824,31,15,15,16,84,161,不合格
20102825,46,69,96,7,83,301,合格
20102826,83,14,2,51,35,185,不合格
20102827,67,35,70,43,74,289,不合格
20102828,94,53,35,33,76,291,不合格
20102829,8,95,47,46,21,217,不合格
20102830,55,42,81,14,12,204,不合格
20102831,30,16,17,17,55,135,不合格
20102832,3,52,30,18,48,151,不合格
20102833,56,75,18,61,80,290,不合格
20102834,59,60,13,5,23,160,不合格
20102835,7,77,43,26,56,209,不合格
20102836,28,10,33,21,15,107,不合格
20102837,1,77,83,51,47,259,不合格
20102838,61,5,59,92,92,309,合格
20102839,29,9,50,75,94,257,不合格
20102840,70,49,37,90,86,332,合格
20102841,74,96,48,6,18,242,不合格
20102842,81,10,89,40,0,220,不合格
20102843,49,48,97,58,88,340,合格
20102844,54,77,41,98,82,352,合格
20102845,72,51,80,24,22,249,不合格
20102846,84,78,64,56,95,377,合格
20102847,54,76,77,41,78,326,合格
20102848,11,87,81,1,72,252,不合格
20102849,43,8,21,28,75,175,不合格
20102850,16,84,68,24,76,268,不合格
20102851,87,59,85,53,66,350,合格
20102852,34,55,0,35,0,124,不合格
20102853,88,10,95,3,17,213,不合格
20102854,25,23,88,28,38,202,不合格
20102855,16,71,25,70,11,193,不合格
20102856,46,96,18,88,5,253,不合格
20102857,96,85,29,51,75,336,合格
20102858,52,72,57,45,84,310,合格
20102859,80,1,79,42,5,207,不合格
20102860,53,80,21,3,96,253,不合格
20102861,99,82,39,98,5,323,合格
20102862,69,62,99,93,49,372,合格
20102863,70,68,33,96,45,312,合格
20102864,51,42,68,3,21,185,不合格
20102865,24,18,82,83,97,304,合格
20102866,84,35,16,88,67,290,不合格
20102867,24,27,43,43,53,190,不合格
20102868,86,37,56,88,51,318,合格
20102869,51,39,61,29,37,217,不合格
20102870,50,6,90,3,71,220,不合格
20102871,18,12,49,3,38,120,不合格
20102872,55,15,15,28,18,131,不合格
20102873,36,76,71,95,15,293,不合格
20102874,66,34,22,51,10,183,不合格
20102875,86,20,64,86,12,268,不合格
20102876,41,17,39,31,89,217,不合格
20102877,91,66,25,55,74,311,合格
20102878,64,47,61,16,33,221,不合格
20102879,1,35,87,32,7,162,不合格
20102880,52,86,1,5,61,205,不合格
20102881,56,25,36,97,38,252,不合格
20102882,39,81,30,51,26,227,不合格
20102883,89,76,46,50,55,316,合格
20102884,94,53,85,23,35,290,不合格
20102885,8,10,72,73,36,199,不合格
20102886,80,58,28,93,75,334,合格
20102887,23,65,8,85,92,273,不合格
20102888,26,48,45,92,81,292,不合格
20102889,4,91,34,91,50,270,不合格
20102890,59,36,39,59,19,212,不合格
20102891,64,8,88,30,2,192,不合格
20102892,48,76,41,41,85,291,不合格
20102893,37,67,85,42,59,290,不合格
20102894,78,30,66,97,61,332,合格
20102895,73,99,26,41,27,266,不合格
20102896,45,35,25,87,73,265,不合格
20102897,31,23,61,5,35,155,不合格
20102898,88,66,75,50,64,343,合格
20102899,53,68,8,61,85,275,不合格
20102900,30,55,92,93,3,273,不合格
20102901,37,62,73,16,40,228,不合格
20102902,23,98,27,57,15,220,不合格
20102903,37,89,4,31,91,252,不合格
20102904,27,4,14,64,97,206,不合格
20102905,44,19,97,34,39,233,不合格
20102906,85,63,76,13,50,287,不合格
20102907,59,54,86,16,67,282,不合格
20102908,36,69,60,3,84,252,不合格
20102909,11,59,50,61,87,268,不合格
20102910,12,31,37,70,26,176,不合格
20102911,99,65,12,0,80,256,不合格
20102912,63,29,52,66,31,241,不合格
20102913,66,99,5,51,50,271,不合格
20102914,60,26,3,18,10,117,不合格
20102915,38,42,94,11,5,190,不合格
20102916,71,91,47,69,87,365,合格
20102917,15,53,49,90,74,281,不合格
20102918,66,35,82,41,63,287,不合格
20102919,52,50,59,92,62,315,合格
20102920,82,68,71,17,55,293,不合格
20102921,39,62,0,68,53,222,不合格
20102922,71,42,23,53,33,222,不合格
20102923,25,40,74,77,97,313,合格
20102924,69,11,13,73,93,259,不合格
20102925,1,58,39,43,74,215,不合格
20102926,5,56,80,39,25,205,不合格
20102927,38,18,19,51,54,180,不合格
20102928,3,36,40,5,11,95,不合格
20102929,9,13,24,55,1,102,不合格
20102930,8,76,41,16,91,232,不合格
20102931,95,61,55,41,2,254,不合格
20102932,10,40,28,80,34,192,不合格
20102933,19,17,64,55,89,244,不合格
20102934,53,93,72,9,52,279,不合格
20102935,45,54,71,67,93,330,合格
20102936,95,27,49,42,37,250,不合格
20102937,72,31,6,36,33,178,不合格
20102938,76,70,43,40,65,294,不合格
20102939,65,21,17,47,51,201,不合格
20102940,62,91,15,28,94,290,不合格
20102941,6,77,81,92,86,342,合格
20102942,28,40,47,60,13,188,不合格
20102943,7,72,61,37,32,209,不合格
20102944,23,69,96,50,33,271,不合格
20102945,29,44,81,5,29,188,不合格
20102946,47,97,50,9,21,224,不合格
20102947,10,18,37,55,34,154,不合格
20102948,49,64,22,32,91,258,不合格
20102949,66,63,30,99,66,324,合格
20102950,33,92,13,1,77,216,不合格
20102951,94,62,57,0,26,239,不合格
20102952,58,39,30,19,80,226,不合格
20102953,94,57,36,9,68,264,不合格
20102954,66,17,73,75,97,328,合格
20102955,69,87,14,13,48,231,不合格
20102956,68,53,57,48,20,246,不合格
20102957,32,90,80,96,17,315,合格
20102958,3,14,91,11,49,168,不合格
20102959,99,69,71,59,87,385,合格
20102960,48,78,18,53,22,219,不合格
20102961,78,40,18,54,97,287,不合格
20102962,91,60,58,28,11,248,不合格
20102963,81,92,95,11,67,346,合格
20102964,29,48,17,46,4,144,不合格
20102965,34,56,26,14,95,225,不合格
20102966,58,35,0,62,28,183,不合格
20102967,80,89,77,18,95,359,合格
20102968,60,61,47,94,59,321,合格
20102969,19,16,84,11,23,153,不合格
20102970,26,16,45,41,69,197,不合格
20102971,52,78,65,82,12,289,不合格
20102972,71,65,6,2,89,233,不合格
20102973,68,56,98,44,74,340,合格
20102974,13,82,73,3,81,252,不合格
20102975,55,54,18,39,35,201,不合格
20102976,29,37,89,31,27,213,不合格
20102977,35,62,20,95,42,254,不合格
20102978,89,95,62,89,25,360,合格
20102979,19,12,59,22,39,151,不合格
20102980,65,12,48,50,94,269,不合格
20102981,72,24,96,94,9,295,不合格
20102982,69,26,29,46,96,266,不合格
20102983,29,14,49,4,68,164,不合格
20102984,64,19,95,51,73,302,合格
20102985,65,75,76,5,4,225,不合格
20102986,6,58,61,94,96,315,合格
20102987,53,32,60,38,98,281,不合格
20102988,33,28,98,15,96,270,不合格
20102989,61,68,25,0,22,176,不合格
20102990,44,97,65,54,47,307,合格
20102991,24,70,2,83,55,234,不合格
20102992,85,80,71,37,66,339,合格
20102993,92,66,35,76,3,272,不合格
20102994,7,48,4,4,17,80,不合格
20102995,7,87,86,76,10,266,不合格
20102996,79,42,95,92,19,327,合格
20102997,84,58,11,73,86,312,合格
20102998,44,88,94,60,35,321,合格
20102999,58,96,24,59,46,283,不合格
20103000,94,33,56,73,91,347,合格
20103001,74,49,89,27,69,308,合格
20103002,98,57,78,78,14,325,合格
20103003,25,74,40,97,32,268,不合格
20103004,99,60,9,55,8,231,不合格
20103005,0,17,93,45,1,156,不合格
20103006,83,4,79,43,74,283,不合格
20103007,9,49,14,12,92,176,不合格
20103008,87,97,39,83,17,323,合格
20103009,19,47,55,11,11,143,不合格
20103010,57,40,26,30,78,231,不合格
20103011,45,27,75,24,11,182,不合格
20103012,95,29,45,45,90,304,合格
20103013,77,59,82,84,53,355,合格
20103014,22,96,43,19,54,234,不合格
20103015,21,95,84,77,50,327,合格
20103016,70,6,23,63,6,168,不合格
20103017,74,20,88,1,91,274,不合格
20103018,98,33,18,47,18,214,不合格
20103019,44,9,29,21,19,122,不合格
20103020,33,29,45,58,14,179,不合格
20103021,81,47,95,81,31,335,合格
20103022,17,13,40,53,6,129,不合格
20103023,69,19,81,38,8,215,不合格
20103024,23,59,89,39,8,218,不合格
20103025,59,75,25,25,55,239,不合格
20103026,73,88,71,62,99,393,合格
20103027,39,9,93,37,68,246,不合格
20103028,27,25,43,1,30,126,不合格
20103029,95,48,78,80,34,335,合格
20103030,69,30,40,79,77,295,不合格
20103031,98,5,49,48,88,288,不合格
20103032,57,5,29,78,90,259,不合格
20103033,73,31,21,33,91,249,不合格
20103034,87,78,29,53,41,288,不合格
20103035,3,5,85,4,43,140,不合格
20103036,36,56,88,43,79,302,合格
20103037,94,6,20,62,43,225,不合格
20103038,63,52,67,9,94,285,不合格
20103039,23,38,47,28,47,183,不合格
20103040,2,24,22,41,50,139,不合格
20103041,83,71,99,76,39,368,合格
20103042,30,15,83,85,12,225,不合格
20103043,1,21,18,92,76,208,不合格
20103044,39,79,40,33,8,199,不合格
20103045,20,5,46,57,71,199,不合格
20103046,66,34,99,59,81,339,合格
20103047,38,97,2,53,58,248,不合格
20103048,50,3,37,59,46,195,不合格
20103049,10,49,59,59,84,261,不合格
20103050,51,52,98,86,57,344,合格
20103051,31,36,84,69,98,318,合格
20103052,55,24,62,78,28,247,不合格
20103053,37,66,33,45,96,277,不合格
20103054,86,62,90,48,87,373,合格
20103055,12,49,9,93,37,200,不合格
20103056,99,59,87,44,23,312,合格
20103057,75,28,96,95,21,315,合格
20103058,81,41,94,82,10,308,合格
20103059,6,57,35,50,14,162,不合格
20103060,15,15,38,49,74,191,不合格
20103061,30,6,56,83,11,186,不合格
20103062,9,81,88,37,16,231,不合格
20103063,35,10,14,54,97,210,不合格
20103064,8,48,53,60,62,231,不合格
20103065,16,84,53,14,20,187,不合格
20103066,91,20,73,24,12,220,不合格
20103067,19,92,13,10,87,221,不合格
20103068,8,14,9,61,85,177,不合格
20103069,58,67,88,0,94,307,合格
20103070,35,71,92,80,32,310,合格
20103071,17,74,46,99,75,311,合格
20103072,48,45,37,62,89,281,不合格
20103073,55,39,31,54,14,193,不合格
20103074,84,75,99,20,92,370,合格
20103075,71,67,67,28,63,296,不合格
20103076,31,21,82,84,4,222,不合格
20103077,64,64,75,63,86,352,合格
20103078,31,59,6,26,36,158,不合格
20103079,88,60,87,48,8,291,不合格
20103080,42,75,81,42,14,254,不合格
20103081,50,19,96,65,45,275,不合格
20103082,45,45,2,42,88,222,不合格
20103083,1,37,53,38,42,171,不合格
20103084,97,79,79,87,23,365,合格
20103085,27,25,91,80,66,289,不合格
20103086,29,53,74,41,88,285,不合格
20103087,28,99,71,69,2,269,不合格
20103088,25,1,48,7,59,140,不合格
20103089,68,49,68,32,61,278,不合格
20103090,38,47,96,26,22,229,不合格
20103091,7,42,98,5,41,193,不合格
20103092,65,39,53,96,98,351,合格
20103093,69,26,28,45,28,196,不合格
20103094,13,62,78,57,80,290,不合格
20103095,68,37,39,62,92,298,不合格
20103096,12,2,57,92,37,200,不合格
20103097,38,52,54,20,2,166,不合格
20103098,98,11,5,8,16,138,不合格
20103099,61,1,97,14,40,213,不合格
20103100,83,77,32,4,11,207,不合格
20103101,91,6,81,2,42,222,不合格
20103102,66,18,87,50,41,262,不合格
20103103,57,86,68,0,47,258,不合格
20103104,47,88,52,62,21,270,不合格
20103105,60,7,88,23,91,269,不合格
20103106,67,71,68,43,39,288,不合格
20103107,60,97,61,51,88,357,合格
20103108,10,0,19,73,57,159,不合格
20103109,9,94,78,8,62,251,不合格
20103110,0,8,53,87,44,192,不合格
20103111,47,32,51,21,24,175,不合格
20103112,17,30,11,99,65,222,不合格
20103113,26,70,67,8,48,219,不合格
20103114,37,98,3,65,97,300,合格
20103115,80,96,35,95,36,342,合格
20103116,75,1,91,50,13,230,不合格
20103117,58,61,94,40,25,278,不合格
20103118,57,29,46,49,20,201,不合格
20103119,11,93,47,83,81,315,合格
20103120,38,15,98,45,42,238,不合格
20103121,18,87,13,15,71,204,不合格
20103122,6,80,15,17,6,124,不合格
20103123,30,42,83,77,62,294,不合格
20103124,0,49,71,82,89,291,不合格
20103125,7,22,12,52,66,159,不合格
20103126,26,87,90,28,77,308,合格
20103127,69,92,91,12,86,350,合格
20103128,88,2,56,47,72,265,不合格
20103129,76,69,63,93,23,324,合格
20103130,20,70,97,43,44,274,不合格
20103131,56,69,3,5,17,150,不合格
20103132,9,85,91,86,62,333,合格
20103133,4,40,66,37,31,178,不合格
20103134,71,78,90,88,80,407,合格
20103135,30,65,17,32,77,221,不合格
20103136,90,27,36,30,83,266,不合格
20103137,26,62,85,11,18,202,不合格
20103138,47,2,75,96,41,261,不合格
20103139,55,13,64,12,99,243,不合格
20103140,53,95,77,30,31,286,不合格
20103141,86,80,74,43,13,296,不合格
20103142,53,75,17,99,54,298,不合格
20103143,47,73,61,54,74,309,合格
20103144,70,22,33,61,59,245,不合格
20103145,89,61,73,82,77,382,合格
20103146,81,59,78,81,62,361,合格
20103147,78,21,61,54,21,235,不合格
20103148,59,43,60,54,32,248,不合格
20103149,47,77,66,0,29,219,不合格
20103150,2,40,85,24,41,192,不合格
20103151,59,95,70,83,81,388,合格
20103152,57,36,49,92,15,249,不合格
20103153,33,48,62,62,59,264,不合格
20103154,3,10,99,67,93,272,不合格
20103155,69,22,13,83,3,190,不合格
20103156,70,54,87,61,15,287,不合格
20103157,19,95,55,95,65,329,合格
20103158,65,65,7,11,50,198,不合格
20103159,72,24,73,21,56,246,不合格
20103160,3,87,50,70,80,290,不合格
20103161,25,30,26,16,44,141,不合格
20103162,42,17,32,0,91,182,不合格
20103163,99,50,36,83,29,297,不合格
20103164,41,37,74,16,78,246,不合格
20103165,20,52,15,31,67,185,不合格
20103166,50,73,73,6,89,291,不合格
20103167,38,57,50,39,26,210,不合格
20103168,19,74,98,79,62,332,合格
20103169,40,19,35,52,82,228,不合格
20103170,98,60,11,38,98,305,合格
20103171,40,3,93,78,93,307,合格
20103172,33,13,63,47,89,245,不合格
20103173,85,81,8,19,42,235,不合格
20103174,63,70,2,8,36,179,不合格
20103175,42,8,71,77,75,273,不合格
20103176,10,52,28,90,61,241,不合格
20103177,64,15,72,55,23,229,不合格
20103178,97,52,32,44,23,248,不合格
20103179,44,84,10,33,69,240,不合格
20103180,5,47,1,26,39,118,不合格
20103181,9,16,12,35,22,94,不合格
20103182,95,63,66,84,59,367,合格
20103183,10,97,19,93,54,273,不合格
20103184,82,71,22,68,83,326,合格
20103185,26,62,12,40,17,157,不合格
20103186,40,89,26,9,24,188,不合格
20103187,19,77,24,54,73,247,不合格
20103188,91,48,10,28,23,200,不合格
20103189,24,57,72,59,0,212,不合格
20103190,96,94,50,91,32,363,合格
20103191,61,86,95,33,49,324,合格
20103192,2,91,13,43,65,214,不合格
20103193,16,54,53,81,40,244,不合格
20103194,66,58,10,63,26,223,不合格
20103195,39,89,76,61,61,326,合格
20103196,11,43,34,74,20,182,不合格
20103197,36,35,81,40,72,264,不合格
20103198,62,21,67,21,55,226,不合格
20103199,42,18,7,64,94,225,不合格
20103200,86,18,58,12,2,176,不合格
20103201,24,0,58,92,20,194,不合格
20103202,57,16,94,76,27,270,不合格
20103203,99,58,72,98,4,331,合格
20103204,42,16,66,33,48,205,不合格
20103205,50,69,31,93,15,258,不合格
20103206,23,0,46,78,98,245,不合格
20103207,26,9,72,12,19,138,不合格
20103208,41,79,86,33,37,276,不合格
20103209,35,64,4,17,59,179,不合格
20103210,32,55,5,61,39,192,不合格
20103211,41,6,33,54,11,145,不合格
20103212,95,36,82,45,27,285,不合格
20103213,92,48,2,71,55,268,不合格
20103214,90,47,54,53,92,336,合格
20103215,36,12,56,45,74,223,不合格
20103216,52,80,24,10,91,257,不合格
20103217,25,75,85,70,18,273,不合格
20103218,82,54,72,8,2,218,不合格
20103219,8,45,33,16,31,133,不合格
20103220,82,51,43,44,28,248,不合格
20103221,53,8,48,86,8,203,不合格
20103222,39,16,43,80,88,266,不合格
20103223,63,69,10,51,27,220,不合格
20103224,92,22,32,99,88,333,合格
20103225,91,51,18,3,97,260,不合格
20103226,80,57,60,35,53,285,不合格
20103227,5,3,68,79,41,196,不合格
20103228,99,81,13,40,14,247,不合格
20103229,70,25,97,43,23,258,不合格
20103230,79,27,49,8,91,254,不合格
20103231,51,97,81,38,20,287,不合格
20103232,68,49,10,68,64,259,不合格
20103233,31,96,51,93,64,335,合格
20103234,85,96,42,83,18,324,合格
20103235,71,14,58,77,74,294,不合格
20103236,80,28,54,62,0,224,不合格
20103237,67,5,15,95,94,276,不合格
20103238,51,45,62,21,21,200,不合格
20103239,76,51,84,99,52,362,合格
20103240,25,96,50,34,59,264,不合格
20103241,18,70,1,77,11,177,不合格
20103242,96,15,28,75,78,292,不合格
20103243,2,18,7,93,80,200,不合格
20103244,32,38,62,19,15,166,不合格
20103245,23,32,28,37,28,148,不合格
20103246,56,0,33,87,72,248,不合格
20103247,27,7,81,43,5,163,不合格
20103248,18,48,72,49,21,208,不合格
20103249,57,52,73,1,36,219,不合格
20103250,42,11,95,13,16,177,不合格
20103251,52,68,12,3,87,222,不合格
20103252,65,86,65,89,81,386,合格
20103253,37,10,63,91,16,217,不合格
20103254,54,77,12,17,18,178,不合格
20103255,78,50,23,28,18,197,不合格
20103256,23,18,64,90,91,286,不合格
20103257,83,11,84,71,43,292,不合格
20103258,40,25,69,92,11,237,不合格
20103259,86,32,90,10,29,247,不合格
20103260,17,68,96,75,47,303,合格
20103261,20,17,12,11,61,121,不合格
20103262,45,29,43,81,86,284,不合格
20103263,85,85,8,50,57,285,不合格
20103264,38,24,13,20,18,113,不合格
20103265,96,90,67,23,5,281,不合格
20103266,34,56,16,30,79,215,不合格
20103267,26,75,88,35,99,323,合格
20103268,41,51,74,5,69,240,不合格
20103269,56,4,39,73,82,254,不合格
20103270,59,5,55,56,69,244,不合格
20103271,87,16,96,95,58,352,合格
20103272,54,18,70,33,46,221,不合格
20103273,19,68,1,17,91,196,不合格
20103274,5,94,27,43,15,184,不合格
20103275,31,39,59,35,24,188,不合格
20103276,21,38,99,31,88,277,不合格
20103277,23,17,48,44,87,219,不合格
20103278,98,80,27,34,6,245,不合格
20103279,71,1,98,51,71,292,不合格
20103280,4,52,3,28,72,159,不合格
20103281,84,26,22,72,67,271,不合格
20103282,65,52,54,75,28,274,不合格
20103283,13,21,48,80,21,183,不合格
20103284,51,6,59,85,86,287,不合格
20103285,82,60,94,61,30,327,合格
20103286,20,3,26,11,52,112,不合格
20103287,34,4,28,73,32,171,不合格
20103288,23,71,84,64,50,292,不合格
20103289,6,51,23,65,34,179,不合格
20103290,89,57,36,92,31,305,合格
20103291,0,65,27,14,1,107,不合格
20103292,41,50,4,64,73,232,不合格
20103293,58,65,24,52,19,218,不合格
20103294,0,36,45,58,98,237,不合格
20103295,4,21,49,31,88,193,不合格
20103296,1,39,85,4,79,208,不合格
20103297,5,98,89,63,34,289,不合格
20103298,29,88,68,39,98,322,合格
20103299,62,33,23,62,33,213,不合格
20103300,76,57,83,88,83,387,合格
20103301,31,90,69,94,79,363,合格
20103302,36,86,31,38,21,212,不合格
20103303,34,65,55,76,40,270,不合格
20103304,49,31,44,7,8,139,不合格
20103305,52,51,89,25,99,316,合格
20103306,21,23,44,18,96,202,不合格
20103307,11,23,41,32,87,194,不合格
20103308,6,52,83,76,31,248,不合格
20103309,73,29,29,75,62,268,不合格
20103310,48,15,94,59,19,235,不合格
20103311,42,74,61,74,79,330,合格
20103312,17,37,86,81,68,289,不合格
20103313,91,87,33,89,11,311,合格
20103314,6,58,39,42,62,207,不合格
20103315,71,89,18,98,99,375,合格
20103316,3,2,33,98,65,201,不合格
20103317,51,99,88,38,14,290,不合格
20103318,58,88,56,60,56,318,合格
20103319,83,47,16,91,18,255,不合格
20103320,21,77,48,77,26,249,不合格
20103321,95,3,44,49,21,212,不合格
20103322,90,47,80,16,90,323,合格
20103323,44,86,83,85,5,303,合格
20103324,75,55,27,50,5,212,不合格
20103325,63,19,19,71,4,176,不合格
20103326,2,84,25,33,29,173,不合格
20103327,13,10,10,92,71,196,不合格
20103328,13,60,81,70,95,319,合格
20103329,50,48,95,96,72,361,合格
20103330,33,32,54,71,94,284,不合格
20103331,28,92,32,46,1,199,不合格
20103332,7,57,55,48,72,239,不合格
20103333,86,22,74,55,40,277,不合格
20103334,56,82,61,90,82,371,合格
20103335,11,0,38,27,7,83,不合格
20103336,10,11,70,5,9,105,不合格
20103337,24,31,55,96,94,300,合格
20103338,91,93,15,40,83,322,合格
20103339,71,37,85,67,26,286,不合格
20103340,95,96,96,86,86,459,合格
20103341,35,19,76,53,74,257,不合格
20103342,8,71,40,44,1,164,不合格
20103343,85,23,27,85,31,251,不合格
20103344,64,73,85,20,65,307,合格
20103345,26,83,72,58,69,308,合格
20103346,72,43,93,1,90,299,不合格
20103347,10,19,62,81,91,263,不合格
20103348,87,3,57,9,52,208,不合格
20103349,83,41,60,36,56,276,不合格
20103350,55,93,57,46,7,258,不合格
20103351,32,58,61,58,75,284,不合格
20103352,51,95,53,16,4,219,不合格
20103353,47,0,52,5,51,155,不合格
20103354,50,66,71,70,14,271,不合格
20103355,38,36,80,27,88,269,不合格
20103356,47,47,35,36,20,185,不合格
20103357,1,43,62,57,87,250,不合格
20103358,52,21,57,86,74,290,不合格
20103359,91,96,81,50,79,397,合格
20103360,72,76,6,79,71,304,合格
20103361,33,58,34,43,1,169,不合格
20103362,67,81,46,69,84,347,合格
20103363,32,79,44,69,87,311,合格
20103364,6,8,20,85,57,176,不合格
20103365,61,89,15,63,45,273,不合格
20103366,85,95,76,56,88,400,合格
20103367,49,3,75,29,22,178,不合格
20103368,81,50,14,86,17,248,不合格
20103369,5,57,93,17,8,180,不合格
20103370,10,83,90,16,13,212,不合格
20103371,6,75,75,48,79,283,不合格
20103372,82,51,55,64,87,339,合格
20103373,71,63,22,74,84,314,合格
20103374,11,95,1,1,76,184,不合格
20103375,53,87,40,19,31,230,不合格
20103376,0,10,59,34,48,151,不合格
20103377,74,46,75,90,70,355,合格
20103378,5,16,82,69,68,240,不合格
20103379,29,46,98,68,16,257,不合格
20103380,31,21,31,30,34,147,不合格
20103381,67,91,7,10,31,206,不合格
20103382,75,96,28,48,39,286,不合格
20103383,87,81,81,86,4,339,合格
20103384,7,49,28,3,72,159,不合格
20103385,47,37,92,84,14,274,不合格
20103386,21,2,80,97,37,237,不合格
20103387,30,81,64,55,83,313,合格
20103388,99,42,91,64,58,354,合格
20103389,32,46,11,29,54,172,不合格
20103390,47,17,2,40,68,174,不合格
20103391,72,86,45,53,88,344,合格
20103392,53,17,49,30,12,161,不合格
20103393,49,11,70,98,81,309,合格
20103394,36,6,15,46,98,201,不合格
20103395,22,39,44,33,88,226,不合格
20103396,45,90,53,61,6,255,不合格
20103397,1,28,1,5,32,67,不合格
20103398,85,55,15,56,52,263,不合格
20103399,11,22,68,80,21,202,不合格
20103400,78,50,54,94,87,363,合格
20103401,56,94,0,96,88,334,合格
20103402,57,20,27,31,3,138,不合格
20103403,39,70,78,62,76,325,合格
20103404,95,55,75,73,33,331,合格
20103405,52,96,44,40,77,309,合格
20103406,39,94,86,14,52,285,不合格
20103407,69,17,34,86,39,245,不合格
20103408,29,23,34,36,78,200,不合格
20103409,14,97,99,78,15,303,合格
20103410,1,42,13,27,10,93,不合格
20103411,91,43,61,4,27,226,不合格
20103412,26,86,53,26,52,243,不合格
20103413,96,29,15,21,80,241,不合格
20103414,25,37,71,32,57,222,不合格
20103415,61,72,75,95,49,352,合格
20103416,39,19,77,66,38,239,不合格
20103417,20,18,3,88,83,212,不合格
20103418,6,31,79,92,94,302,合格
20103419,62,22,4,86,59,233,不合格
20103420,88,36,16,57,46,243,不合格
20103421,83,1,66,57,39,246,不合格
20103422,84,69,94,50,76,373,合格
20103423,79,91,54,87,95,406,合格
20103424,88,56,56,47,69,316,合格
20103425,72,75,56,77,78,358,合格
20103426,19,85,6,74,9,193,不合格
20103427,86,60,3,67,70,286,不合格
20103428,78,34,45,93,78,328,合格
20103429,79,67,48,16,46,256,不合格
20103430,72,66,76,49,58,321,合格
20103431,90,35,10,12,15,162,不合格
20103432,34,31,17,71,58,211,不合格
20103433,46,19,0,82,48,195,不合格
20103434,89,32,52,39,26,238,不合格
20103435,49,92,4,67,28,240,不合格
20103436,86,93,98,24,67,368,合格
20103437,16,60,50,64,42,232,不合格
20103438,93,24,94,8,19,238,不合格
20103439,35,97,6,41,79,258,不合格
20103440,49,6,11,16,99,181,不合格
20103441,20,95,73,50,36,274,不合格
20103442,8,70,57,89,2,226,不合格
20103443,1,83,62,74,47,267,不合格
20103444,75,10,2,89,10,186,不合格
20103445,36,15,57,37,26,171,不合格
20103446,32,36,59,73,88,288,不合格
20103447,54,8,33,68,74,237,不合格
20103448,7,21,41,82,42,193,不合格
20103449,78,65,44,89,31,307,合格
20103450,57,60,26,13,36,192,不合格
20103451,13,85,60,27,5,190,不合格
20103452,96,93,96,17,56,358,合格
20103453,23,40,73,43,22,201,不合格
20103454,96,77,38,70,93,374,合格
20103455,1,10,85,24,86,206,不合格
20103456,69,26,81,42,48,266,不合格
20103457,27,81,86,33,10,237,不合格
20103458,29,39,69,36,58,231,不合格
20103459,13,74,93,82,2,264,不合格
20103460,92,64,99,9,87,351,合格
20103461,94,94,33,23,38,282,不合格
20103462,11,22,48,80,65,226,不合格
20103463,17,97,76,50,12,252,不合格
20103464,79,90,78,31,29,307,合格
20103465,99,26,85,51,72,333,合格
20103466,31,54,14,83,6,188,不合格
20103467,21,77,16,62,41,217,不合格
20103468,97,87,10,39,62,295,不合格
20103469,80,97,15,68,33,293,不合格
20103470,68,10,6,16,20,120,不合格
20103471,57,8,56,9,98,228,不合格
20103472,31,72,11,59,85,258,不合格
20103473,78,93,98,23,96,388,合格
20103474,57,42,75,86,18,278,不合格
20103475,55,40,0,49,30,174,不合格
20103476,17,25,33,85,16,176,不合格
20103477,20,99,37,3,28,187,不合格
20103478,84,18,61,48,70,281,不合格
20103479,62,63,36,68,93,322,合格
20103480,30,26,1,59,74,190,不合格
20103481,4,80,50,62,12,208,不合格
20103482,68,98,37,57,44,304,合格
20103483,23,6,92,89,0,210,不合格
20103484,79,56,35,77,50,297,不合格
20103485,29,81,17,2,21,150,不合格
20103486,40,96,76,14,31,257,不合格
20103487,14,37,29,69,88,237,不合格
20103488,21,37,71,66,84,279,不合格
20103489,71,15,64,80,99,329,合格
20103490,74,99,88,99,46,406,合格
20103491,31,20,56,88,21,216,不合格
20103492,57,41,81,31,65,275,不合格
20103493,97,71,56,94,42,360,合格
20103494,45,82,47,30,37,241,不合格
20103495,28,42,91,57,60,278,不合格
20103496,22,22,44,71,16,175,不合格
20103497,0,30,30,91,27,178,不合格
20103498,39,8,61,12,98,218,不合格
20103499,19,12,71,86,35,223,不合格
20103500,99,14,7,72,99,291,不合格
20103501,32,51,88,90,65,326,合格
20103502,18,75,81,98,63,335,合格
20103503,5,18,74,64,40,201,不合格
20103504,92,89,51,21,97,350,合格
20103505,41,61,94,64,63,323,合格
20103506,97,88,7,94,69,355,合格
20103507,80,30,29,58,5,202,不合格
20103508,37,86,27,24,84,258,不合格
20103509,1,55,52,96,40,244,不合格
20103510,87,91,16,94,65,353,合格
20103511,5,54,8,75,9,151,不合格
20103512,30,48,3,41,7,129,不合格
20103513,39,37,66,63,83,288,不合格
20103514,93,17,76,69,61,316,合格
20103515,53,65,96,40,14,268,不合格
20103516,88,8,45,38,17,196,不合格
20103517,94,41,71,67,33,306,合格
20103518,81,43,75,88,26,313,合格
20103519,2,59,82,10,23,176,不合格
20103520,31,81,65,4,40,221,不合格
20103521,56,79,94,34,86,349,合格
20103522,88,62,51,64,0,265,不合格
20103523,23,50,26,25,49,173,不合格
20103524,64,88,4,15,48,219,不合格
20103525,38,1,36,29,40,144,不合格
20103526,28,19,97,85,93,322,合格
20103527,53,97,83,15,94,342,合格
20103528,60,8,3,18,5,94,不合格
20103529,99,90,65,44,21,319,合格
20103530,30,57,80,46,29,242,不合格
20103531,70,89,33,8,7,207,不合格
20103532,91,56,16,96,42,301,合格
20103533,68,79,96,98,44,385,合格
20103534,33,73,20,68,99,293,不合格
20103535,47,90,22,94,26,279,不合格
20103536,80,3,56,24,15,178,不合格
20103537,30,75,70,44,71,290,不合格
20103538,12,20,78,87,6,203,不合格
20103539,47,9,58,75,66,255,不合格
20103540,30,46,97,37,40,250,不合格
20103541,9,31,75,3,4,122,不合格
20103542,68,92,16,59,84,319,合格
20103543,84,41,52,18,76,271,不合格
20103544,99,47,51,98,7,302,合格
20103545,2,42,66,58,82,250,不合格
20103546,42,55,51,41,6,195,不合格
20103547,34,96,57,22,90,299,不合格
20103548,89,78,60,8,70,305,合格
20103549,41,2,56,2,46,147,不合格
20103550,55,36,48,76,84,299,不合格
20103551,62,50,22,26,88,248,不合格
20103552,51,56,88,97,25,317,合格
20103553,83,61,62,80,81,367,合格
20103554,97,37,13,70,22,239,不合格
20103555,67,77,14,4,25,187,不合格
20103556,64,33,17,51,24,189,不合格
20103557,97,16,39,25,98,275,不合格
20103558,18,82,69,53,4,226,不合格
20103559,64,2,82,13,24,185,不合格
20103560,3,28,97,25,9,162,不合格
20103561,43,88,18,38,68,255,不合格
20103562,33,43,81,28,28,213,不合格
20103563,93,41,44,46,49,273,不合格
20103564,8,88,10,95,56,257,不合格
20103565,33,34,8,30,75,180,不合格
20103566,13,49,49,64,37,212,不合格
20103567,75,44,28,4,45,196,不合格
20103568,94,62,4,13,40,213,不合格
20103569,68,81,29,33,24,235,不合格
20103570,94,83,82,23,59,341,合格
20103571,61,47,55,4,84,251,不合格
20103572,12,99,1,24,12,148,不合格
20103573,8,57,59,47,75,246,不合格
20103574,7,94,26,10,36,173,不合格
20103575,70,65,16,98,42,291,不合格
20103576,67,20,38,98,47,270,不合格
20103577,58,49,55,91,94,347,合格
20103578,96,13,23,32,11,175,不合格
20103579,75,20,72,72,25,264,不合格
20103580,2,15,61,16,57,151,不合格
20103581,51,22,23,98,86,280,不合格
20103582,15,79,31,11,26,162,不合格
20103583,21,93,42,82,75,313,合格
20103584,68,41,86,50,44,289,不合格
20103585,68,94,97,75,97,431,合格
20103586,31,86,20,22,42,201,不合格
20103587,29,13,52,95,4,193,不合格
20103588,83,90,68,91,62,394,合格
20103589,14,79,84,60,69,306,合格
20103590,10,82,72,98,6,268,不合格
20103591,7,19,92,30,85,233,不合格
20103592,59,47,23,33,29,191,不合格
20103593,0,35,26,82,17,160,不合格
20103594,72,64,36,24,22,218,不合格
20103595,97,24,80,37,5,243,不合格
20103596,5,76,78,36,67,262,不合格
20103597,38,57,11,34,50,190,不合格
20103598,66,98,82,85,54,385,合格
20103599,7,81,64,74,41,267,不合格
20103600,59,86,95,73,43,356,合格
20103601,76,16,85,34,35,246,不合格
20103602,45,40,18,85,20,208,不合格
20103603,37,29,43,74,6,189,不合格
20103604,31,41,3,97,24,196,不合格
20103605,5,54,39,55,87,240,不合格
20103606,44,64,7,50,56,221,不合格
20103607,89,88,34,91,87,389,合格
20103608,67,68,98,88,75,396,合格
20103609,10,81,51,91,61,294,不合格
20103610,22,12,88,65,43,230,不合格
20103611,34,2,10,87,87,220,不合格
20103612,82,73,5,26,50,236,不合格
20103613,45,88,39,2,74,248,不合格
20103614,64,2,17,83,93,259,不合格
20103615,75,67,29,8,6,185,不合格
20103616,66,88,21,91,40,306,合格
20103617,44,31,71,7,20,173,不合格
20103618,15,81,31,56,90,273,不合格
20103619,50,23,41,1,67,182,不合格
20103620,91,45,97,47,31,311,合格
20103621,9,48,95,36,15,203,不合格
20103622,38,19,75,4,9,145,不合格
20103623,7,39,72,74,86,278,不合格
20103624,24,69,71,48,78,290,不合格
20103625,76,95,53,40,54,318,合格
20103626,70,4,60,7,97,238,不合格
20103627,17,44,19,78,12,170,不合格
20103628,25,28,27,96,54,230,不合格
20103629,42,70,69,30,19,230,不合格
20103630,44,93,35,17,32,221,不合格
20103631,6,51,63,42,20,182,不合格
20103632,65,29,34,68,17,213,不合格
20103633,42,21,72,75,41,251,不合格
20103634,97,26,88,78,45,334,合格
20103635,36,82,37,41,26,222,不合格
20103636,5,10,23,70,53,161,不合格
20103637,99,47,7,35,72,260,不合格
20103638,83,69,65,58,6,281,不合格
20103639,76,28,47,25,83,259,不合格
20103640,10,60,26,40,39,175,不合格
20103641,97,9,69,27,66,268,不合格
20103642,71,15,67,88,51,292,不合格
20103643,10,43,85,6,38,182,不合格
20103644,29,33,55,22,81,220,不合格
20103645,60,6,55,96,56,273,不合格
20103646,76,87,84,91,34,372,合格
20103647,2,55,32,41,19,149,不合格
20103648,34,84,43,34,1,196,不合格
20103649,4,52,58,4,74,192,不合格
20103650,71,77,31,78,36,293,不合格
20103651,86,43,57,86,36,308,合格
20103652,6,21,59,8,63,157,不合格
20103653,88,41,40,91,23,283,不合格
20103654,57,55,3,68,34,217,不合格
20103655,41,6,42,60,6,155,不合格
20103656,32,36,35,75,27,205,不合格
20103657,45,76,38,56,42,257,不合格
20103658,94,71,6,10,23,204,不合格
20103659,97,65,96,86,89,433,合格
20103660,96,90,25,82,28,321,合格
20103661,29,28,56,70,70,253,不合格
20103662,63,55,19,91,36,264,不合格
20103663,88,56,6,72,91,313,合格
20103664,70,41,35,96,70,312,合格
20103665,74,83,9,99,5,270,不合格
20103666,24,62,41,64,99,290,不合格
20103667,44,10,49,4,83,190,不合格
20103668,3,94,35,80,87,299,不合格
20103669,75,87,72,74,7,315,合格
20103670,68,34,77,99,42,320,合格
20103671,20,92,72,5,73,262,不合格
20103672,78,62,87,10,21,258,不合格
20103673,11,56,4,45,92,208,不合格
20103674,32,17,20,35,30,134,不合格
20103675,32,39,63,58,19,211,不合格
20103676,5,32,37,48,85,207,不合格
20103677,95,39,75,18,95,322,合格
20103678,26,82,47,59,74,288,不合格
20103679,12,33,9,57,90,201,不合格
20103680,23,86,60,22,66,257,不合格
20103681,94,6,67,93,86,346,合格
20103682,51,2,0,16,57,126,不合格
20103683,95,56,12,92,65,320,合格
20103684,55,3,91,38,10,197,不合格
20103685,73,71,34,63,57,298,不合格
20103686,74,43,39,11,99,266,不合格
20103687,22,56,43,96,53,270,不合格
20103688,50,23,65,20,88,246,不合格
20103689,75,24,4,93,96,292,不合格
20103690,82,36,53,35,71,277,不合格
20103691,56,12,33,0,55,156,不合格
20103692,52,44,35,31,4,166,不合格
20103693,25,91,29,53,16,214,不合格
20103694,6,21,4,89,31,151,不合格
20103695,95,45,14,28,8,190,不合格
20103696,97,86,29,42,4,258,不合格
20103697,54,29,94,20,27,224,不合格
20103698,18,89,77,94,52,330,合格
20103699,34,97,26,45,22,224,不合格
20103700,5,77,24,34,49,189,不合格
20103701,90,72,26,37,71,296,不合格
20103702,85,12,23,64,14,198,不合格
20103703,46,58,3,70,27,204,不合格
20103704,83,43,70,39,42,277,不合格
20103705,92,16,94,8,86,296,不合格
20103706,30,80,79,44,14,247,不合格
20103707,16,74,95,18,7,210,不合格
20103708,56,1,17,13,70,157,不合格
20103709,79,93,46,7,43,268,不合格
20103710,65,36,94,85,5,285,不合格
20103711,12,65,16,20,70,183,不合格
20103712,63,66,40,25,14,208,不合格
20103713,50,36,45,72,74,277,不合格
20103714,95,87,3,57,32,274,不合格
20103715,47,51,94,22,54,268,不合格
20103716,11,7,6,12,71,107,不合格
20103717,17,99,50,75,95,336,合格
20103718,21,32,18,64,83,218,不合格
20103719,5,24,89,11,98,227,不合格
20103720,36,94,64,64,69,327,合格
20103721,24,48,91,47,46,256,不合格
20103722,84,66,14,28,25,217,不合格
20103723,16,81,43,60,53,253,不合格
20103724,20,18,65,96,31,230,不合格
20103725,90,48,62,2,85,287,不合格
20103726,9,75,50,16,47,197,不合格
20103727,55,18,16,45,93,227,不合格
20103728,50,9,0,68,94,221,不合格
20103729,31,84,99,89,37,340,合格
20103730,51,27,4,40,92,214,不合格
20103731,61,19,8,97,2,187,不合格
20103732,61,5,88,30,19,203,不合格
20103733,61,7,70,3,20,161,不合格
20103734,71,95,35,10,13,224,不合格
20103735,55,97,84,88,29,353,合格
20103736,40,70,36,75,88,309,合格
20103737,32,79,36,94,86,327,合格
20103738,15,10,0,30,29,84,不合格
20103739,33,65,52,51,76,277,不合格
20103740,0,2,25,12,7,46,不合格
20103741,15,91,16,86,41,249,不合格
20103742,4,18,12,25,37,96,不合格
20103743,88,77,84,57,17,323,合格
20103744,77,6,58,58,20,219,不合格
20103745,5,74,1,68,78,226,不合格
20103746,82,20,17,22,19,160,不合格
20103747,63,35,59,9,3,169,不合格
20103748,60,67,99,63,1,290,不合格
20103749,42,64,47,50,50,253,不合格
20103750,25,49,92,38,78,282,不合格
20103751,19,22,54,19,32,146,不合格
20103752,24,57,39,41,11,172,不合格
20103753,1,28,67,89,91,276,不合格
20103754,14,66,46,11,19,156,不合格
20103755,83,6,36,56,25,206,不合格
20103756,39,19,35,48,39,180,不合格
20103757,31,23,31,35,19,139,不合格
20103758,89,53,45,10,70,267,不合格
20103759,72,67,57,21,14,231,不合格
20103760,58,87,66,91,34,336,合格
20103761,37,98,80,75,75,365,合格
20103762,64,53,5,74,38,234,不合格
20103763,94,40,42,2,54,232,不合格
20103764,5,56,6,36,99,202,不合格
20103765,1,64,93,54,52,264,不合格
20103766,12,93,95,45,21,266,不合格
20103767,33,21,7,86,78,225,不合格
20103768,12,50,48,23,65,198,不合格
20103769,13,72,68,55,72,280,不合格
20103770,79,59,62,39,7,246,不合格
20103771,57,38,89,79,65,328,合格
20103772,86,27,29,31,68,241,不合格
20103773,94,81,74,10,17,276,不合格
20103774,78,2,2,35,20,137,不合格
20103775,45,64,78,93,60,340,合格
20103776,37,52,0,90,76,255,不合格
20103777,52,89,27,76,24,268,不合格
20103778,85,55,5,91,3,239,不合格
20103779,95,85,53,5,27,265,不合格
20103780,0,19,34,33,40,126,不合格
20103781,34,14,83,41,11,183,不合格
20103782,52,18,50,64,9,193,不合格
20103783,0,33,54,16,22,125,不合格
20103784,52,78,81,72,69,352,合格
20103785,90,62,26,47,53,278,不合格
20103786,7,46,91,64,89,297,不合格
20103787,14,3,90,75,94,276,不合格
20103788,17,14,96,76,43,246,不合格
20103789,64,73,6,88,75,306,合格
20103790,79,94,71,41,0,285,不合格
20103791,19,7,30,83,0,139,不合格
20103792,89,0,45,17,58,209,不合格
20103793,67,38,77,65,58,305,合格
20103794,48,43,46,74,24,235,不合格
20103795,16,56,77,37,90,276,不合格
20103796,71,70,4,58,66,269,不合格
20103797,71,61,96,34,78,340,合格
20103798,70,39,60,61,16,246,不合格
20103799,47,85,99,52,64,347,合格
20103800,81,88,78,2,25,274,不合格
20103801,41,17,91,61,9,219,不合格
20103802,39,19,83,81,98,320,合格
20103803,31,34,6,63,17,151,不合格
20103804,20,78,19,17,15,149,不合格
20103805,32,83,43,85,16,259,不合格
20103806,58,81,79,66,29,313,合格
20103807,31,38,31,66,48,214,不合格
20103808,97,77,2,75,44,295,不合格
20103809,98,57,54,32,15,256,不合格
20103810,12,95,57,4,52,220,不合格
20103811,41,66,7,88,74,276,不合格
20103812,39,66,36,26,99,266,不合格
20103813,86,71,63,8,7,235,不合格
20103814,40,45,79,98,54,316,合格
20103815,11,28,12,24,90,165,不合格
20103816,17,66,67,94,29,273,不合格
20103817,51,43,79,35,2,210,不合格
20103818,26,88,75,9,5,203,不合格
20103819,55,19,34,81,81,270,不合格
20103820,87,81,16,53,29,266,不合格
20103821,75,95,79,22,49,320,合格
20103822,40,2,90,91,85,308,合格
20103823,99,78,11,51,84,323,合格
20103824,26,24,10,17,62,139,不合格
20103825,20,28,79,86,20,233,不合格
20103826,56,18,50,8,35,167,不合格
20103827,46,25,60,13,90,234,不合格
20103828,16,35,99,18,10,178,不合格
20103829,75,6,56,58,31,226,不合格
20103830,25,67,11,75,83,261,不合格
20103831,8,8,98,50,16,180,不合格
20103832,85,78,22,88,59,332,合格
20103833,85,81,12,74,56,308,合格
20103834,3,88,0,11,87,189,不合格
20103835,52,16,97,53,19,237,不合格
20103836,58,57,40,86,57,298,不合格
20103837,31,52,62,62,29,236,不合格
20103838,69,28,82,38,77,294,不合格
20103839,23,86,44,18,82,253,不合格
20103840,97,21,40,32,52,242,不合格
20103841,12,57,76,31,73,249,不合格
20103842,95,40,57,63,79,334,合格
20103843,13,77,20,44,27,181,不合格
20103844,6,97,34,24,48,209,不合格
20103845,36,6,75,39,66,222,不合格
20103846,82,14,28,0,3,127,不合格
20103847,29,85,37,18,5,174,不合格
20103848,79,28,17,36,74,234,不合格
20103849,50,19,29,74,3,175,不合格
20103850,85,6,43,35,6,175,不合格
20103851,93,13,44,60,86,296,不合格
20103852,5,29,38,95,5,172,不合格
20103853,33,24,11,14,9,91,不合格
20103854,31,30,60,88,18,227,不合格
20103855,96,55,29,65,9,254,不合格
20103856,63,76,88,71,89,387,合格
20103857,97,82,8,2,66,255,不合格
20103858,42,55,74,66,6,243,不合格
20103859,73,89,76,13,49,300,合格
20103860,92,49,26,77,20,264,不合格
20103861,24,0,61,53,5,143,不合格
20103862,39,33,93,65,87,317,合格
20103863,44,70,58,73,8,253,不合格
20103864,27,21,87,21,69,225,不合格
20103865,81,55,43,28,4,211,不合格
20103866,44,96,16,48,35,239,不合格
20103867,67,71,83,88,6,315,合格
20103868,60,55,91,92,21,319,合格
20103869,81,97,86,92,32,388,合格
20103870,75,63,22,41,93,294,不合格
20103871,0,18,98,84,9,209,不合格
20103872,65,73,36,82,38,294,不合格
20103873,38,53,16,72,95,274,不合格
20103874,21,32,49,48,53,203,不合格
20103875,75,51,58,34,67,285,不合格
20103876,56,77,13,45,53,244,不合格
20103877,6,77,3,1,19,106,不合格
20103878,38,48,69,54,48,257,不合格
20103879,43,9,87,23,40,202,不合格
20103880,2,49,85,71,97,304,合格
20103881,20,14,8,93,63,198,不合格
20103882,97,64,64,80,12,317,合格
20103883,23,89,52,3,8,175,不合格
20103884,69,47,65,39,34,254,不合格
20103885,50,57,8,87,43,245,不合格
20103886,25,58,99,67,67,316,合格
20103887,6,64,91,71,20,252,不合格
20103888,20,32,93,24,17,186,不合格
20103889,23,44,37,24,88,216,不合格
20103890,75,28,16,54,97,270,不合格
20103891,32,21,14,95,90,252,不合格
20103892,85,23,54,56,87,305,合格
20103893,92,52,30,54,89,317,合格
20103894,46,64,31,40,21,202,不合格
20103895,32,65,37,80,33,247,不合格
20103896,42,52,1,69,93,257,不合格
20103897,88,84,81,62,85,400,合格
20103898,71,20,64,51,73,279,不合格
20103899,92,20,39,84,98,333,合格
20103900,79,84,87,55,2,307,合格
20103901,25,12,30,79,63,209,不合格
20103902,77,67,94,74,54,366,合格
20103903,25,27,26,46,27,151,不合格
20103904,20,27,55,11,71,184,不合格
20103905,33,21,95,61,3,213,不合格
20103906,98,6,71,92,68,335,合格
20103907,96,44,88,96,16,340,合格
20103908,68,59,78,12,21,238,不合格
20103909,29,47,97,30,32,235,不合格
20103910,53,55,44,89,86,327,合格
20103911,2,78,68,93,10,251,不合格
20103912,1,58,56,82,17,214,不合格
20103913,86,1,62,24,37,210,不合格
20103914,82,99,10,31,77,299,不合格
20103915,41,29,11,54,26,161,不合格
20103916,50,74,0,50,71,245,不合格
20103917,86,78,92,7,91,354,合格
20103918,8,93,80,35,85,301,合格
20103919,52,62,35,79,12,240,不合格
20103920,22,53,71,15,33,194,不合格
20103921,46,22,44,69,52,233,不合格
20103922,84,37,0,31,62,214,不合格
20103923,13,62,91,16,60,242,不合格
20103924,99,64,3,15,39,220,不合格
20103925,45,99,62,17,97,320,合格
20103926,88,96,32,28,0,244,不合格
20103927,84,54,32,2,44,216,不合格
20103928,1,97,34,55,61,248,不合格
20103929,10,88,45,37,83,263,不合格
20103930,19,20,80,84,32,235,不合格
20103931,34,26,45,55,76,236,不合格
20103932,89,41,15,67,30,242,不合格
20103933,94,78,47,61,77,357,合格
20103934,25,22,51,67,88,253,不合格
20103935,85,91,30,32,9,247,不合格
20103936,26,56,30,62,90,264,不合格
20103937,6,91,6,57,78,238,不合格
20103938,95,12,98,48,62,315,合格
20103939,99,71,34,22,82,308,合格
20103940,53,60,67,78,87,345,合格
20103941,55,17,79,43,17,211,不合格
20103942,45,37,99,65,72,318,合格
20103943,52,34,19,83,26,214,不合格
20103944,41,71,1,73,44,230,不合格
20103945,23,70,84,71,12,260,不合格
20103946,50,80,92,90,84,396,合格
20103947,12,28,22,31,58,151,不合格
20103948,90,98,55,44,86,373,合格
20103949,10,96,26,52,11,195,不合格
20103950,0,39,49,47,41,176,不合格
20103951,13,64,63,69,49,258,不合格
20103952,67,33,59,96,72,327,合格
20103953,89,46,11,33,15,194,不合格
20103954,92,51,50,55,58,306,合格
20103955,23,8,25,80,99,235,不合格
20103956,43,83,60,93,44,323,合格
20103957,38,32,18,63,97,248,不合格
20103958,80,19,26,48,39,212,不合格
20103959,21,3,12,87,3,126,不合格
20103960,10,35,74,16,96,231,不合格
20103961,84,73,43,87,83,370,合格
20103962,88,55,60,93,74,370,合格
20103963,56,40,77,96,48,317,合格
20103964,28,81,64,63,33,269,不合格
20103965,88,49,43,88,13,281,不合格
20103966,8,88,23,22,89,230,不合格
20103967,6,68,38,40,66,218,不合格
20103968,8,42,42,64,20,176,不合格
20103969,23,58,82,84,55,302,合格
20103970,39,84,32,7,1,163,不合格
20103971,95,68,54,87,95,399,合格
20103972,55,45,69,54,7,230,不合格
20103973,39,39,68,21,62,229,不合格
20103974,92,50,15,68,34,259,不合格
20103975,39,52,50,82,70,293,不合格
20103976,44,43,40,86,60,273,不合格
20103977,35,95,31,70,66,297,不合格
20103978,6,44,9,53,28,140,不合格
20103979,53,47,97,99,69,365,合格
20103980,93,65,79,77,45,359,合格
20103981,19,29,18,30,99,195,不合格
20103982,20,32,71,14,79,216,不合格
20103983,87,59,47,37,10,240,不合格
20103984,30,97,18,10,13,168,不合格
20103985,66,44,16,14,15,155,不合格
20103986,39,56,49,26,63,233,不合格
20103987,81,52,4,48,72,257,不合格
20103988,27,26,18,26,81,178,不合格
20103989,98,20,27,19,18,182,不合格
20103990,33,37,35,23,1,129,不合格
20103991,80,78,1,77,34,270,不合格
20103992,52,1,74,14,81,222,不合格
20103993,78,2,65,68,23,236,不合格
20103994,71,71,57,69,34,302,合格
20103995,38,52,97,63,20,270,不合格
20103996,15,24,3,29,90,161,不合格
20103997,88,54,47,51,25,265,不合格
20103998,69,80,71,85,33,338,合格
20103999,61,29,91,85,88,354,合格
20104000,34,42,95,74,46,291,不合格
20104001,6,87,19,56,27,195,不合格
20104002,89,49,50,72,93,353,合格
20104003,17,51,29,4,52,153,不合格
20104004,51,79,45,69,89,333,合格
20104005,93,20,24,84,10,231,不合格
20104006,16,38,96,50,63,263,不合格
20104007,34,44,18,33,4,133,不合格
20104008,75,98,99,63,61,396,合格
20104009,12,8,78,89,78,265,不合格
20104010,28,12,8,37,65,150,不合格
20104011,14,6,33,57,53,163,不合格
20104012,9,96,0,71,16,192,不合格
20104013,43,64,44,17,66,234,不合格
20104014,56,76,1,42,56,231,不合格
20104015,37,0,59,8,96,200,不合格
20104016,23,94,77,93,84,371,合格
20104017,22,84,32,40,26,204,不合格
20104018,32,8,15,27,74,156,不合格
20104019,49,64,81,28,25,247,不合格
20104020,11,3,68,71,95,248,不合格
20104021,14,19,94,81,11,219,不合格
20104022,90,99,92,64,88,433,合格
20104023,81,16,82,54,21,254,不合格
20104024,2,80,46,99,35,262,不合格
20104025,3,30,9,97,83,222,不合格
20104026,88,88,64,23,34,297,不合格
20104027,62,50,75,34,22,243,不合格
20104028,63,66,83,6,92,310,合格
20104029,66,45,2,38,57,208,不合格
20104030,54,61,6,26,7,154,不合格
20104031,34,43,83,85,31,276,不合格
20104032,94,46,98,16,56,310,合格
20104033,9,33,55,19,4,120,不合格
20104034,83,64,67,6,53,273,不合格
20104035,94,13,48,85,80,320,合格
20104036,96,91,82,15,19,303,合格
20104037,48,14,63,81,16,222,不合格
20104038,28,74,84,61,21,268,不合格
20104039,58,11,90,38,39,236,不合格
20104040,20,78,78,95,14,285,不合格
20104041,67,77,57,8,81,290,不合格
20104042,58,8,12,26,69,173,不合格
20104043,38,18,58,22,65,201,不合格
20104044,15,92,59,83,19,268,不合格
20104045,0,93,38,79,16,226,不合格
20104046,42,16,34,94,45,231,不合格
20104047,75,34,63,94,94,360,合格
20104048,57,47,3,80,49,236,不合格
20104049,39,79,20,93,49,280,不合格
20104050,30,91,62,4,98,285,不合格
20104051,26,38,38,34,54,190,不合格
20104052,90,13,10,96,20,229,不合格
20104053,18,53,6,84,15,176,不合格
20104054,3,5,21,2,94,125,不合格
20104055,58,86,4,54,85,287,不合格
20104056,71,92,28,36,32,259,不合格
20104057,67,59,29,61,56,272,不合格
20104058,59,14,30,65,30,198,不合格
20104059,2,32,12,62,31,139,不合格
20104060,25,10,3,38,31,107,不合格
20104061,51,3,53,21,16,144,不合格
20104062,50,55,25,59,95,284,不合格
20104063,8,47,81,67,31,234,不合格
20104064,74,5,97,53,43,272,不合格
20104065,0,76,5,20,27,128,不合格
20104066,13,82,67,86,15,263,不合格
20104067,82,10,92,49,16,249,不合格
20104068,0,94,23,84,87,288,不合格
20104069,77,97,29,12,70,285,不合格
20104070,45,46,97,92,44,324,合格
20104071,27,73,36,51,57,244,不合格
20104072,33,10,86,14,81,224,不合格
20104073,71,39,50,42,96,298,不合格
20104074,63,46,56,30,8,203,不合格
20104075,16,78,71,72,31,268,不合格
20104076,25,88,43,85,25,266,不合格
20104077,22,69,57,21,94,263,不合格
20104078,94,91,64,83,33,365,合格
20104079,82,99,21,47,83,332,合格
20104080,82,61,0,24,84,251,不合格
20104081,48,89,38,34,73,282,不合格
20104082,40,57,21,34,72,224,不合格
20104083,45,23,33,58,33,192,不合格
20104084,65,73,40,51,39,268,不合格
20104085,48,14,33,58,21,174,不合格
20104086,50,17,57,2,70,196,不合格
20104087,95,98,21,62,63,339,合格
20104088,55,47,28,10,31,171,不合格
20104089,17,76,93,1,65,252,不合格
20104090,52,89,47,98,34,320,合格
20104091,0,2,4,2,61,69,不合格
20104092,1,34,84,44,49,212,不合格
20104093,56,95,14,33,37,235,不合格
20104094,36,45,81,81,82,325,合格
20104095,58,82,50,48,90,328,合格
20104096,24,81,87,52,78,322,合格
20104097,89,63,69,44,58,323,合格
20104098,67,86,62,91,42,348,合格
20104099,30,39,62,99,63,293,不合格
20104100,39,8,49,43,83,222,不合格
20104101,13,10,76,54,2,155,不合格
20104102,89,93,88,68,91,429,合格
20104103,76,0,97,49,76,298,不合格
20104104,35,64,57,8,40,204,不合格
20104105,89,20,84,77,30,300,合格
20104106,83,34,31,94,79,321,合格
20104107,45,0,78,84,17,224,不合格
20104108,99,38,7,94,36,274,不合格
20104109,4,41,81,6,44,176,不合格
20104110,28,9,18,71,28,154,不合格
20104111,36,3,64,31,80,214,不合格
20104112,18,35,60,74,62,249,不合格
20104113,55,40,15,6,79,195,不合格
20104114,60,14,94,77,14,259,不合格
20104115,54,13,63,9,30,169,不合格
20104116,51,61,72,99,59,342,合格
20104117,2,38,3,10,75,128,不合格
20104118,66,41,25,22,12,166,不合格
20104119,50,75,82,36,0,243,不合格
20104120,84,47,44,43,23,241,不合格
20104121,41,12,80,57,64,254,不合格
20104122,41,83,51,30,42,247,不合格
20104123,97,43,85,69,7,301,合格
20104124,94,36,81,82,83,376,合格
20104125,64,15,99,35,21,234,不合格
20104126,8,96,10,89,37,240,不合格
20104127,34,85,92,5,29,245,不合格
20104128,60,37,76,17,66,256,不合格
20104129,24,23,73,26,40,186,不合格
20104130,33,62,3,52,83,233,不合格
20104131,0,34,0,27,24,85,不合格
20104132,95,86,75,64,29,349,合格
20104133,12,63,5,21,33,134,不合格
20104134,80,91,67,45,95,378,合格
20104135,48,72,62,83,26,291,不合格
20104136,41,26,93,45,97,302,合格
20104137,97,8,30,89,26,250,不合格
20104138,28,84,89,75,42,318,合格
20104139,85,82,31,76,10,284,不合格
20104140,65,92,39,42,45,283,不合格
20104141,99,68,86,0,9,262,不合格
20104142,0,12,93,58,74,237,不合格
20104143,12,90,16,40,49,207,不合格
20104144,7,48,13,27,15,110,不合格
20104145,91,21,80,29,16,237,不合格
20104146,25,96,94,38,17,270,不合格
20104147,50,34,49,90,48,271,不合格
20104148,60,45,15,30,82,232,不合格
20104149,39,8,80,66,30,223,不合格
20104150,25,21,9,14,41,110,不合格
20104151,63,79,26,96,15,279,不合格
20104152,11,38,12,45,43,149,不合格
20104153,78,37,30,82,51,278,不合格
20104154,20,30,75,24,56,205,不合格
20104155,55,50,82,19,17,223,不合格
20104156,48,10,84,79,51,272,不合格
20104157,67,56,36,85,49,293,不合格
20104158,44,88,1,98,31,262,不合格
20104159,18,86,78,36,27,245,不合格
20104160,87,35,75,64,43,304,合格
20104161,89,73,1,48,22,233,不合格
20104162,44,11,35,77,18,185,不合格
20104163,32,95,10,49,73,259,不合格
20104164,7,43,71,49,61,231,不合格
20104165,93,65,48,87,54,347,合格
20104166,32,32,49,8,38,159,不合格
20104167,2,55,63,4,90,214,不合格
20104168,39,38,17,41,55,190,不合格
20104169,89,72,82,41,65,349,合格
20104170,11,34,90,48,70,253,不合格
20104171,96,33,28,86,83,326,合格
20104172,94,0,65,29,18,206,不合格
20104173,19,76,94,19,34,242,不合格
20104174,11,53,32,40,95,231,不合格
20104175,90,72,63,73,93,391,合格
20104176,26,65,87,1,41,220,不合格
20104177,68,58,13,14,19,172,不合格
20104178,14,0,70,76,93,253,不合格
20104179,83,6,88,30,36,243,不合格
20104180,32,39,20,90,25,206,不合格
20104181,9,43,66,83,90,291,不合格
20104182,51,84,72,45,81,333,合格
20104183,31,23,7,55,35,151,不合格
20104184,39,66,24,28,56,213,不合格
20104185,99,63,44,28,46,280,不合格
20104186,0,75,55,97,79,306,合格
20104187,26,73,48,38,41,226,不合格
20104188,8,79,54,43,90,274,不合格
20104189,19,2,6,57,11,95,不合格
20104190,11,61,17,39,59,187,不合格
20104191,24,51,24,21,13,133,不合格
20104192,71,77,45,36,71,300,合格
20104193,21,99,52,28,87,287,不合格
20104194,16,8,41,54,5,124,不合格
20104195,64,90,15,36,29,234,不合格
20104196,10,74,64,5,36,189,不合格
20104197,69,3,46,56,65,239,不合格
20104198,79,64,22,45,1,211,不合格
20104199,1,70,2,90,39,202,不合格
20104200,24,66,31,79,27,227,不合格
20104201,6,45,22,85,4,162,不合格
20104202,47,68,74,22,0,211,不合格
20104203,96,44,8,47,5,200,不合格
20104204,53,96,45,18,79,291,不合格
20104205,87,68,70,77,65,367,合格
20104206,80,3,23,75,26,207,不合格
20104207,40,73,68,83,81,345,合格
20104208,27,79,3,77,99,285,不合格
20104209,80,87,37,4,52,260,不合格
20104210,98,21,70,39,67,295,不合格
20104211,76,47,77,61,2,263,不合格
20104212,20,55,73,47,63,258,不合格
20104213,31,17,33,85,5,171,不合格
20104214,57,17,82,88,39,283,不合格
20104215,17,92,59,68,38,274,不合格
20104216,83,4,41,52,38,218,不合格
20104217,70,86,28,64,58,306,合格
20104218,30,1,92,63,23,209,不合格
20104219,46,13,51,11,56,177,不合格
20104220,96,21,6,90,26,239,不合格
20104221,91,91,47,40,78,347,合格
20104222,76,1,50,52,85,264,不合格
20104223,39,69,14,62,51,235,不合格
20104224,52,12,85,42,35,226,不合格
20104225,96,55,56,31,33,271,不合格
20104226,79,74,54,55,94,356,合格
20104227,70,19,6,7,70,172,不合格
20104228,30,52,31,31,99,243,不合格
20104229,39,6,29,56,90,220,不合格
20104230,62,26,6,94,78,266,不合格
20104231,70,99,97,47,93,406,合格
20104232,67,15,29,68,86,265,不合格
20104233,27,33,13,68,80,221,不合格
20104234,43,51,37,14,98,243,不合格
20104235,90,26,18,51,84,269,不合格
20104236,11,84,15,39,60,209,不合格
20104237,3,7,27,75,66,178,不合格
20104238,23,24,55,72,57,231,不合格
20104239,42,82,18,10,90,242,不合格
20104240,97,84,50,75,21,327,合格
20104241,60,50,11,46,73,240,不合格
20104242,61,55,96,66,6,284,不合格
20104243,17,73,12,75,77,254,不合格
20104244,99,91,60,57,80,387,合格
20104245,14,73,32,27,96,242,不合格
20104246,85,35,89,69,43,321,合格
20104247,54,51,86,32,59,282,不合格
20104248,22,24,42,24,83,195,不合格
20104249,88,10,45,39,63,245,不合格
20104250,52,78,38,7,87,262,不合格
20104251,88,60,74,65,90,377,合格
20104252,50,89,51,86,33,309,合格
20104253,58,32,20,36,35,181,不合格
20104254,63,77,2,81,48,271,不合格
20104255,71,52,46,48,3,220,不合格
20104256,62,51,24,83,44,264,不合格
20104257,93,1,69,80,48,291,不合格
20104258,25,53,30,18,18,144,不合格
20104259,49,1,58,71,54,233,不合格
20104260,78,12,3,30,20,143,不合格
20104261,99,93,72,76,46,386,合格
20104262,57,38,6,45,63,209,不合格
20104263,80,36,30,27,95,268,不合格
20104264,75,10,98,65,72,320,合格
20104265,46,25,74,73,90,308,合格
20104266,7,77,28,32,14,158,不合格
20104267,9,20,49,72,24,174,不合格
20104268,80,17,83,38,19,237,不合格
20104269,78,46,88,37,72,321,合格
20104270,39,40,46,27,59,211,不合格
20104271,36,80,56,99,35,306,合格
20104272,33,58,84,5,33,213,不合格
20104273,20,73,65,41,99,298,不合格
20104274,94,61,81,88,68,392,合格
20104275,53,33,82,77,16,261,不合格
20104276,67,29,60,91,40,287,不合格
20104277,85,26,3,52,17,183,不合格
20104278,80,68,47,41,46,282,不合格
20104279,94,86,31,45,71,327,合格
20104280,56,93,14,87,80,330,合格
20104281,8,25,86,21,38,178,不合格
20104282,71,74,87,8,5,245,不合格
20104283,80,98,58,13,17,266,不合格
20104284,59,52,75,88,97,371,合格
20104285,41,98,71,44,19,273,不合格
20104286,53,93,99,10,98,353,合格
20104287,45,39,0,91,49,224,不合格
20104288,40,97,2,98,75,312,合格
20104289,60,29,17,40,24,170,不合格
20104290,82,62,18,90,84,336,合格
20104291,84,2,33,49,82,250,不合格
20104292,95,92,1,96,98,382,合格
20104293,63,12,57,56,36,224,不合格
20104294,65,85,99,91,22,362,合格
20104295,44,41,47,68,11,211,不合格
20104296,23,54,51,22,25,175,不合格
20104297,26,26,3,63,18,136,不合格
20104298,0,36,12,53,69,170,不合格
20104299,26,35,4,28,41,134,不合格
20104300,12,70,30,30,21,163,不合格
20104301,63,94,74,32,71,334,合格
20104302,15,1,31,22,8,77,不合格
20104303,65,2,92,89,96,344,合格
20104304,83,10,23,13,79,208,不合格
20104305,34,0,83,91,3,211,不合格
20104306,75,5,59,25,6,170,不合格
20104307,62,22,85,81,0,250,不合格
20104308,19,54,55,75,54,257,不合格
20104309,51,3,76,73,2,205,不合格
20104310,72,48,6,30,47,203,不合格
20104311,56,52,54,99,73,334,合格
20104312,85,16,8,1,88,198,不合格
20104313,37,76,57,72,35,277,不合格
20104314,77,85,46,49,23,280,不合格
20104315,16,97,42,55,88,298,不合格
20104316,22,70,27,97,18,234,不合格
20104317,5,81,55,51,84,276,不合格
20104318,24,47,77,99,99,346,合格
20104319,60,96,45,27,95,323,合格
20104320,23,4,81,29,91,228,不合格
20104321,72,98,54,61,23,308,合格
20104322,62,97,6,89,40,294,不合格
20104323,48,93,27,84,71,323,合格
20104324,6,94,52,55,72,279,不合格
20104325,21,48,51,46,93,259,不合格
20104326,66,79,84,10,82,321,合格
20104327,0,92,31,42,52,217,不合格
20104328,46,75,55,51,72,299,不合格
20104329,36,61,25,61,40,223,不合格
20104330,5,75,61,93,16,250,不合格
20104331,54,39,1,61,95,250,不合格
20104332,23,97,75,73,93,361,合格
20104333,50,94,95,15,65,319,合格
20104334,81,48,36,6,86,257,不合格
20104335,7,5,50,78,54,194,不合格
20104336,46,64,20,59,36,225,不合格
20104337,9,52,92,17,9,179,不合格
20104338,93,70,12,67,53,295,不合格
20104339,11,23,1,5,89,129,不合格
20104340,89,10,88,23,12,222,不合格
20104341,72,84,53,46,94,349,合格
20104342,40,79,66,21,57,263,不合格
20104343,30,43,15,66,80,234,不合格
20104344,16,10,64,4,52,146,不合格
20104345,18,58,70,66,10,222,不合格
20104346,5,12,53,12,94,176,不合格
20104347,20,29,5,69,82,205,不合格
20104348,70,25,53,48,51,247,不合格
20104349,18,54,35,51,96,254,不合格
20104350,24,95,86,43,89,337,合格
20104351,7,39,7,90,94,237,不合格
20104352,70,53,13,28,35,199,不合格
20104353,19,83,29,97,19,247,不合格
20104354,98,90,48,5,52,293,不合格
20104355,69,38,13,64,24,208,不合格
20104356,74,98,24,48,46,290,不合格
20104357,18,28,65,6,50,167,不合格
20104358,84,46,3,70,61,264,不合格
20104359,31,95,25,49,62,262,不合格
20104360,20,9,3,7,75,114,不合格
20104361,6,61,8,58,87,220,不合格
20104362,97,51,68,62,40,318,合格
20104363,26,16,67,72,36,217,不合格
20104364,67,82,95,33,73,350,合格
20104365,21,10,17,65,24,137,不合格
20104366,89,67,66,65,11,298,不合格
20104367,63,86,77,44,86,356,合格
20104368,94,92,90,87,66,429,合格
20104369,30,57,44,61,90,282,不合格
20104370,44,35,60,53,75,267,不合格
20104371,45,72,63,20,73,273,不合格
20104372,85,84,88,17,15,289,不合格
20104373,54,57,11,18,8,148,不合格
20104374,73,53,14,25,54,219,不合格
20104375,20,14,38,77,26,175,不合格
20104376,3,8,73,93,18,195,不合格
20104377,85,28,29,72,68,282,不合格
20104378,48,33,38,52,23,194,不合格
20104379,50,62,12,27,45,196,不合格
20104380,87,84,62,26,86,345,合格
20104381,18,13,81,59,40,211,不合格
20104382,64,87,20,95,51,317,合格
20104383,83,61,44,40,95,323,合格
20104384,33,43,74,69,60,279,不合格
20104385,62,80,53,61,56,312,合格
20104386,24,23,88,58,74,267,不合格
20104387,28,18,57,18,88,209,不合格
20104388,5,69,69,14,43,200,不合格
20104389,10,13,7,17,11,58,不合格
20104390,33,14,79,59,92,277,不合格
20104391,11,55,20,47,23,156,不合格
20104392,85,46,3,0,97,231,不合格
20104393,84,60,69,60,9,282,不合格
20104394,55,30,41,4,72,202,不合格
20104395,12,43,29,86,47,217,不合格
20104396,9,4,63,94,43,213,不合格
20104397,91,59,44,20,21,235,不合格
20104398,65,58,73,15,13,224,不合格
20104399,5,72,13,7,92,189,不合格
20104400,80,66,27,42,45,260,不合格
20104401,92,22,77,3,92,286,不合格
20104402,94,67,88,51,53,353,合格
20104403,85,42,95,2,36,260,不合格
20104404,76,29,12,63,34,214,不合格
20104405,59,22,22,89,87,279,不合格
20104406,35,97,91,83,64,370,合格
20104407,22,38,52,64,16,192,不合格
20104408,5,42,11,34,81,173,不合格
20104409,72,41,29,8,45,195,不合格
20104410,62,33,32,42,36,205,不合格
20104411,65,64,31,19,82,261,不合格
20104412,43,14,88,9,17,171,不合格
20104413,16,36,38,27,55,172,不合格
20104414,0,24,75,72,14,185,不合格
20104415,26,59,75,63,16,239,不合格
20104416,80,0,31,92,57,260,不合格
20104417,37,42,24,76,10,189,不合格
20104418,20,65,95,57,42,279,不合格
20104419,66,61,0,79,26,232,不合格
20104420,63,6,96,65,88,318,合格
20104421,94,19,97,49,18,277,不合格
20104422,23,29,21,66,67,206,不合格
20104423,41,84,74,97,26,322,合格
20104424,66,81,4,37,73,261,不合格
20104425,54,49,80,51,53,287,不合格
20104426,54,26,11,78,69,238,不合格
20104427,6,12,80,62,69,229,不合格
20104428,80,69,69,49,72,339,合格
20104429,98,69,7,41,12,227,不合格
20104430,46,16,81,96,51,290,不合格
20104431,19,76,23,5,7,130,不合格
20104432,26,94,48,97,11,276,不合格
20104433,57,73,5,5,20,160,不合格
20104434,99,11,32,0,95,237,不合格
20104435,9,89,15,66,90,269,不合格
20104436,75,23,47,76,23,244,不合格
20104437,98,38,79,7,51,273,不合格
20104438,49,91,79,85,38,342,合格
20104439,69,81,93,25,49,317,合格
20104440,57,2,60,51,14,184,不合格
20104441,10,8,80,32,86,216,不合格
20104442,76,71,19,7,53,226,不合格
20104443,6,13,72,93,74,258,不合格
20104444,72,99,4,85,10,270,不合格
20104445,59,70,19,54,66,268,不合格
20104446,3,39,68,64,54,228,不合格
20104447,91,73,51,60,27,302,合格
20104448,59,58,52,65,96,330,合格
20104449,56,19,68,34,31,208,不合格
20104450,92,94,74,19,45,324,合格
20104451,77,3,91,53,68,292,不合格
20104452,55,64,83,70,36,308,合格
20104453,96,6,93,69,74,338,合格
20104454,65,85,54,39,16,259,不合格
20104455,99,33,31,62,49,274,不合格
20104456,69,29,13,90,22,223,不合格
20104457,75,89,0,18,82,264,不合格
20104458,85,98,67,77,55,382,合格
20104459,44,63,87,6,46,246,不合格
20104460,51,18,11,78,67,225,不合格
20104461,62,33,52,55,34,236,不合格
20104462,72,9,86,68,88,323,合格
20104463,79,80,5,17,71,252,不合格
20104464,73,81,27,77,13,271,不合格
20104465,52,3,51,13,52,171,不合格
20104466,78,41,56,14,5,194,不合格
20104467,74,64,51,82,63,334,合格
20104468,63,17,16,14,55,165,不合格
20104469,34,37,61,10,93,235,不合格
20104470,99,81,16,11,17,224,不合格
20104471,98,82,87,13,90,370,合格
20104472,53,55,83,32,10,233,不合格
20104473,75,14,20,22,42,173,不合格
20104474,40,20,22,57,68,207,不合格
20104475,69,22,6,12,29,138,不合格
20104476,99,0,49,60,57,265,不合格
20104477,71,12,2,75,68,228,不合格
20104478,59,38,77,9,39,222,不合格
20104479,76,65,53,90,21,305,合格
20104480,54,65,22,2,68,211,不合格
20104481,93,88,34,47,26,288,不合格
20104482,70,85,13,72,29,269,不合格
20104483,28,33,41,23,91,216,不合格
20104484,71,41,5,2,87,206,不合格
20104485,35,47,43,51,84,260,不合格
20104486,31,26,52,8,27,144,不合格
20104487,64,87,32,97,71,351,合格
20104488,23,82,22,71,60,258,不合格
20104489,10,91,0,57,38,196,不合格
20104490,47,30,20,25,21,143,不合格
20104491,28,94,0,91,66,279,不合格
20104492,85,36,18,41,14,194,不合格
20104493,45,96,17,22,4,184,不合格
20104494,14,18,16,75,52,175,不合格
20104495,65,68,6,24,4,167,不合格
20104496,12,44,92,10,20,178,不合格
20104497,88,77,57,64,21,307,合格
20104498,28,66,72,18,37,221,不合格
20104499,46,42,18,3,38,147,不合格
20104500,2,16,5,23,89,135,不合格
20104501,44,70,60,63,18,255,不合格
20104502,95,10,80,61,20,266,不合格
20104503,9,86,74,54,41,264,不合格
20104504,83,88,34,9,84,298,不合格
20104505,89,79,78,40,76,362,合格
20104506,99,83,98,10,29,319,合格
20104507,48,35,9,22,9,123,不合格
20104508,98,51,22,50,69,290,不合格
20104509,74,54,55,11,45,239,不合格
20104510,13,95,91,0,90,289,不合格
20104511,82,28,8,53,90,261,不合格
20104512,4,18,97,84,87,290,不合格
20104513,4,9,86,40,72,211,不合格
20104514,44,28,64,22,60,218,不合格
20104515,78,82,78,97,12,347,合格
20104516,44,42,11,99,75,271,不合格
20104517,18,34,1,50,99,202,不合格
20104518,78,41,83,81,88,371,合格
20104519,78,80,12,36,58,264,不合格
20104520,2,15,56,32,28,133,不合格
20104521,22,49,50,71,73,265,不合格
20104522,42,11,28,20,67,168,不合格
20104523,68,16,8,66,56,214,不合格
20104524,74,60,45,47,52,278,不合格
20104525,59,28,79,34,26,226,不合格
20104526,80,91,12,14,46,243,不合格
20104527,98,81,98,58,82,417,合格
20104528,83,25,49,11,78,246,不合格
20104529,37,86,49,65,12,249,不合格
20104530,10,32,59,73,78,252,不合格
20104531,85,51,31,33,22,222,不合格
20104532,58,11,10,18,19,116,不合格
20104533,47,69,0,81,43,240,不合格
20104534,47,48,69,98,13,275,不合格
20104535,60,73,48,92,42,315,合格
20104536,75,74,94,42,16,301,合格
20104537,49,51,25,65,86,276,不合格
20104538,36,20,56,16,74,202,不合格
20104539,95,59,81,97,75,407,合格
20104540,39,99,51,35,44,268,不合格
20104541,58,80,87,70,96,391,合格
20104542,14,38,92,54,54,252,不合格
20104543,7,67,22,17,69,182,不合格
20104544,18,43,84,40,91,276,不合格
20104545,25,53,67,9,56,210,不合格
20104546,3,98,94,92,69,356,合格
20104547,67,58,49,17,35,226,不合格
20104548,64,72,74,88,75,373,合格
20104549,2,50,45,5,65,167,不合格
20104550,96,23,84,5,4,212,不合格
20104551,30,91,35,28,50,234,不合格
20104552,28,69,96,40,31,264,不合格
20104553,65,97,26,57,18,263,不合格
20104554,21,22,25,91,37,196,不合格
20104555,52,0,88,53,17,210,不合格
20104556,86,30,36,3,77,232,不合格
20104557,46,3,38,6,65,158,不合格
20104558,65,13,4,80,53,215,不合格
20104559,12,64,86,81,43,286,不合格
20104560,11,36,29,31,40,147,不合格
20104561,3,14,25,61,36,139,不合格
20104562,21,97,12,81,29,240,不合格
20104563,91,21,35,5,70,222,不合格
20104564,24,88,80,87,5,284,不合格
20104565,61,77,71,9,80,298,不合格
20104566,34,70,18,75,21,218,不合格
20104567,72,56,80,13,16,237,不合格
20104568,74,35,74,99,77,359,合格
20104569,90,54,44,24,57,269,不合格
20104570,74,58,4,27,0,163,不合格
20104571,91,68,68,31,85,343,合格
20104572,99,1,25,94,14,233,不合格
20104573,45,65,32,3,99,244,不合格
20104574,83,8,36,86,98,311,合格
20104575,96,59,57,36,3,251,不合格
20104576,45,99,86,51,9,290,不合格
20104577,20,66,47,73,40,246,不合格
20104578,60,53,78,12,60,263,不合格
20104579,25,17,89,46,45,222,不合格
20104580,21,13,1,71,39,145,不合格
20104581,13,67,48,59,87,274,不合格
20104582,44,7,41,39,10,141,不合格
20104583,81,6,43,69,86,285,不合格
20104584,79,1,58,63,66,267,不合格
20104585,63,80,77,27,87,334,合格
20104586,63,43,34,27,85,252,不合格
20104587,14,45,0,50,43,152,不合格
20104588,3,85,15,25,59,187,不合格
20104589,20,82,19,40,1,162,不合格
20104590,3,45,96,73,56,273,不合格
20104591,44,71,8,33,78,234,不合格
20104592,9,25,61,81,62,238,不合格
20104593,47,26,98,50,82,303,合格
20104594,55,74,10,44,80,263,不合格
20104595,6,63,84,72,75,300,合格
20104596,52,0,5,26,34,117,不合格
20104597,87,51,0,94,69,301,合格
20104598,86,71,87,48,62,354,合格
20104599,7,65,65,44,99,280,不合格
20104600,12,28,30,35,56,161,不合格
20104601,72,46,95,94,11,318,合格
20104602,59,29,81,73,51,293,不合格
20104603,76,54,41,69,2,242,不合格
20104604,30,55,10,65,48,208,不合格
20104605,53,80,43,22,96,294,不合格
20104606,41,85,76,91,16,309,合格
20104607,58,19,8,79,27,191,不合格
20104608,15,4,70,5,37,131,不合格
20104609,54,2,69,56,40,221,不合格
20104610,66,38,81,66,96,347,合格
20104611,34,33,96,72,27,262,不合格
20104612,98,88,75,41,43,345,合格
20104613,56,46,52,37,60,251,不合格
20104614,22,43,86,34,79,264,不合格
20104615,60,12,34,82,12,200,不合格
20104616,42,10,13,71,34,170,不合格
20104617,3,84,57,4,36,184,不合格
20104618,19,41,61,65,83,269,不合格
20104619,69,78,70,41,11,269,不合格
20104620,72,22,24,57,11,186,不合格
20104621,74,37,94,4,20,229,不合格
20104622,10,8,15,53,40,126,不合格
20104623,38,34,74,6,99,251,不合格
20104624,35,24,16,46,81,202,不合格
20104625,40,13,97,31,44,225,不合格
20104626,13,56,28,89,12,198,不合格
20104627,44,34,9,94,18,199,不合格
20104628,23,13,96,45,38,215,不合格
20104629,43,89,99,29,2,262,不合格
20104630,19,74,55,82,90,320,合格
20104631,30,31,72,87,35,255,不合格
20104632,31,19,98,94,58,300,合格
20104633,28,22,47,6,61,164,不合格
20104634,28,80,55,46,91,300,合格
20104635,66,21,81,23,67,258,不合格
20104636,63,72,48,59,82,324,合格
20104637,48,55,25,29,66,223,不合格
20104638,21,70,23,94,6,214,不合格
20104639,5,20,82,78,57,242,不合格
20104640,48,85,55,53,3,244,不合格
20104641,8,65,97,53,5,228,不合格
20104642,83,18,84,51,12,248,不合格
20104643,70,22,96,86,45,319,合格
20104644,27,39,2,54,79,201,不合格
20104645,80,74,65,85,29,333,合格
20104646,19,28,70,60,29,206,不合格
20104647,54,81,31,90,34,290,不合格
20104648,37,50,80,57,46,270,不合格
20104649,47,42,45,74,3,211,不合格
20104650,90,80,96,83,83,432,合格
20104651,44,36,81,33,51,245,不合格
20104652,25,65,94,75,51,310,合格
20104653,35,96,74,56,69,330,合格
20104654,6,72,69,8,67,222,不合格
20104655,0,62,25,17,50,154,不合格
20104656,17,22,48,82,90,259,不合格
20104657,35,71,86,78,95,365,合格
20104658,58,11,74,96,22,261,不合格
20104659,24,3,82,99,79,287,不合格
20104660,52,66,3,20,11,152,不合格
20104661,59,15,66,1,44,185,不合格
20104662,54,69,82,31,63,299,不合格
20104663,8,47,96,41,41,233,不合格
20104664,15,45,66,88,36,250,不合格
20104665,47,29,48,49,28,201,不合格
20104666,51,88,30,80,68,317,合格
20104667,52,37,44,70,42,245,不合格
20104668,77,12,81,97,68,335,合格
20104669,2,95,29,79,70,275,不合格
20104670,21,84,16,63,69,253,不合格
20104671,90,9,92,87,16,294,不合格
20104672,71,3,20,8,29,131,不合格
20104673,47,68,95,60,26,296,不合格
20104674,84,2,18,36,14,154,不合格
20104675,58,73,67,63,62,323,合格
20104676,66,97,41,61,93,358,合格
20104677,2,72,96,30,11,211,不合格
20104678,42,99,62,82,80,365,合格
20104679,76,72,84,86,14,332,合格
20104680,27,99,81,69,96,372,合格
20104681,16,76,16,57,48,213,不合格
20104682,98,55,69,51,25,298,不合格
20104683,95,97,29,23,10,254,不合格
20104684,20,32,66,75,23,216,不合格
20104685,69,33,44,77,7,230,不合格
20104686,55,23,9,70,10,167,不合格
20104687,77,58,67,24,58,284,不合格
20104688,96,11,60,27,54,248,不合格
20104689,22,14,11,41,99,187,不合格
20104690,36,73,74,25,1,209,不合格
20104691,42,13,29,57,79,220,不合格
20104692,45,95,42,39,91,312,合格
20104693,50,62,96,80,93,381,合格
20104694,89,9,64,45,31,238,不合格
20104695,19,77,45,26,32,199,不合格
20104696,10,58,46,81,68,263,不合格
20104697,14,64,11,80,17,186,不合格
20104698,47,12,16,19,67,161,不合格
20104699,91,4,43,76,75,289,不合格
20104700,76,60,93,80,73,382,合格
20104701,24,47,86,81,55,293,不合格
20104702,85,77,25,21,99,307,合格
20104703,3,86,83,22,28,222,不合格
20104704,57,91,66,68,29,311,合格
20104705,68,54,3,23,98,246,不合格
20104706,56,26,7,30,81,200,不合格
20104707,43,61,61,95,87,347,合格
20104708,2,26,79,17,14,138,不合格
20104709,30,57,0,35,86,208,不合格
20104710,95,95,91,38,31,350,合格
20104711,92,76,46,52,6,272,不合格
20104712,89,30,66,40,30,255,不合格
20104713,15,68,78,68,39,268,不合格
20104714,16,86,49,39,85,275,不合格
20104715,75,66,28,27,22,218,不合格
20104716,30,95,37,1,66,229,不合格
20104717,50,19,49,12,52,182,不合格
20104718,92,61,44,28,78,303,合格
20104719,26,64,47,45,39,221,不合格
20104720,94,44,42,6,82,268,不合格
20104721,14,45,49,7,72,187,不合格
20104722,64,10,58,56,95,283,不合格
20104723,40,32,56,39,51,218,不合格
20104724,22,57,16,20,60,175,不合格
20104725,36,7,62,58,61,224,不合格
20104726,38,34,74,36,64,246,不合格
20104727,73,67,87,75,50,352,合格
20104728,65,35,15,97,93,305,合格
20104729,52,47,2,56,97,254,不合格
20104730,68,81,41,20,22,232,不合格
20104731,55,65,19,56,67,262,不合格
20104732,59,69,92,40,92,352,合格
20104733,51,70,78,62,94,355,合格
20104734,76,77,64,42,25,284,不合格
20104735,28,94,29,28,55,234,不合格
20104736,74,35,46,70,33,258,不合格
20104737,1,71,59,93,75,299,不合格
20104738,20,37,93,9,87,246,不合格
20104739,30,28,48,71,29,206,不合格
20104740,52,30,96,33,48,259,不合格
20104741,23,20,62,76,72,253,不合格
20104742,18,99,67,95,17,296,不合格
20104743,7,38,23,49,35,152,不合格
20104744,44,0,42,96,20,202,不合格
20104745,28,47,75,76,1,227,不合格
20104746,51,81,39,64,25,260,不合格
20104747,71,28,87,21,39,246,不合格
20104748,32,78,29,6,8,153,不合格
20104749,38,24,52,46,12,172,不合格
20104750,13,29,58,33,68,201,不合格
20104751,18,61,69,33,76,257,不合格
20104752,79,72,96,90,43,380,合格
20104753,95,22,37,5,97,256,不合格
20104754,83,74,15,45,1,218,不合格
20104755,79,61,36,16,87,279,不合格
20104756,47,42,41,62,93,285,不合格
20104757,62,42,78,34,3,219,不合格
20104758,98,3,7,12,95,215,不合格
20104759,84,5,56,25,40,210,不合格
20104760,57,92,22,83,18,272,不合格
20104761,59,34,47,3,23,166,不合格
20104762,14,57,12,8,55,146,不合格
20104763,9,32,26,57,9,133,不合格
20104764,62,74,3,84,28,251,不合格
20104765,95,90,0,70,18,273,不合格
20104766,45,29,36,71,56,237,不合格
20104767,92,36,84,83,28,323,合格
20104768,53,43,86,42,35,259,不合格
20104769,54,71,69,65,21,280,不合格
20104770,48,58,58,87,95,346,合格
20104771,63,20,54,71,59,267,不合格
20104772,38,40,43,53,24,198,不合格
20104773,76,23,35,56,39,229,不合格
20104774,58,21,19,9,88,195,不合格
20104775,20,43,5,25,11,104,不合格
20104776,33,50,40,43,26,192,不合格
20104777,15,69,29,0,55,168,不合格
20104778,35,79,29,18,83,244,不合格
20104779,67,90,98,53,16,324,合格
20104780,21,73,48,61,73,276,不合格
20104781,97,88,95,63,28,371,合格
20104782,89,91,16,36,97,329,合格
20104783,21,61,40,87,51,260,不合格
20104784,5,22,79,65,97,268,不合格
20104785,64,80,45,33,79,301,合格
20104786,71,12,39,14,87,223,不合格
20104787,15,15,21,70,74,195,不合格
20104788,3,71,18,74,10,176,不合格
20104789,57,28,8,60,54,207,不合格
20104790,14,83,56,3,82,238,不合格
20104791,71,74,91,77,53,366,合格
20104792,40,54,41,99,39,273,不合格
20104793,6,43,7,25,30,111,不合格
20104794,39,48,67,84,93,331,合格
20104795,46,87,62,45,96,336,合格
20104796,22,21,22,15,95,175,不合格
20104797,38,95,5,36,89,263,不合格
20104798,41,62,46,41,81,271,不合格
20104799,54,40,15,58,6,173,不合格
20104800,8,67,98,24,66,263,不合格
20104801,95,31,96,43,81,346,合格
20104802,71,90,90,39,79,369,合格
20104803,52,70,4,70,7,203,不合格
20104804,12,33,78,24,82,229,不合格
20104805,24,3,79,77,41,224,不合格
20104806,12,74,7,28,80,201,不合格
20104807,21,19,54,57,74,225,不合格
20104808,84,99,23,90,77,373,合格
20104809,13,45,76,42,81,257,不合格
20104810,28,27,83,35,70,243,不合格
20104811,13,14,18,60,28,133,不合格
20104812,7,41,72,35,20,175,不合格
20104813,32,37,8,72,85,234,不合格
20104814,96,32,24,74,47,273,不合格
20104815,66,28,43,37,32,206,不合格
20104816,2,48,45,62,4,161,不合格
20104817,4,65,71,50,24,214,不合格
20104818,91,70,43,77,10,291,不合格
20104819,61,87,90,47,18,303,合格
20104820,9,33,68,68,99,277,不合格
20104821,20,82,20,58,91,271,不合格
20104822,61,22,12,89,33,217,不合格
20104823,10,24,15,77,12,138,不合格
20104824,38,1,45,30,87,201,不合格
20104825,43,74,10,27,46,200,不合格
20104826,94,27,98,23,91,333,合格
20104827,91,30,62,1,96,280,不合格
20104828,82,98,56,9,49,294,不合格
20104829,42,20,43,98,23,226,不合格
20104830,16,24,18,48,80,186,不合格
20104831,36,5,47,43,83,214,不合格
20104832,88,15,70,10,93,276,不合格
20104833,67,58,21,3,51,200,不合格
20104834,9,88,26,9,97,229,不合格
20104835,24,82,19,78,17,220,不合格
20104836,45,15,59,5,72,196,不合格
20104837,23,32,70,98,21,244,不合格
20104838,21,6,89,22,49,187,不合格
20104839,5,97,78,95,90,365,合格
20104840,84,18,59,36,42,239,不合格
20104841,77,74,39,39,1,230,不合格
20104842,89,36,16,16,86,243,不合格
20104843,10,20,18,64,61,173,不合格
20104844,73,46,45,22,46,232,不合格
20104845,47,54,98,32,87,318,合格
20104846,83,20,39,74,1,217,不合格
20104847,19,87,23,4,79,212,不合格
20104848,33,34,16,44,62,189,不合格
20104849,30,4,78,16,65,193,不合格
20104850,36,12,83,49,6,186,不合格
20104851,29,64,93,89,2,277,不合格
20104852,51,51,91,26,53,272,不合格
20104853,61,74,96,46,18,295,不合格
20104854,18,85,94,41,17,255,不合格
20104855,56,13,59,16,50,194,不合格
20104856,64,14,94,84,28,284,不合格
20104857,97,72,91,44,67,371,合格
20104858,45,31,78,17,22,193,不合格
20104859,1,2,82,82,31,198,不合格
20104860,91,65,68,60,12,296,不合格
20104861,47,55,55,65,62,284,不合格
20104862,77,90,69,47,49,332,合格
20104863,38,59,6,75,16,194,不合格
20104864,51,15,98,17,39,220,不合格
20104865,88,86,47,87,81,389,合格
20104866,61,62,29,7,25,184,不合格
20104867,16,65,27,60,84,252,不合格
20104868,77,1,58,13,7,156,不合格
20104869,6,35,83,33,70,227,不合格
20104870,19,16,80,72,54,241,不合格
20104871,74,32,28,61,66,261,不合格
20104872,68,15,72,81,14,250,不合格
20104873,41,66,59,74,80,320,合格
20104874,11,43,41,91,29,215,不合格
20104875,15,40,57,77,45,234,不合格
20104876,49,52,8,39,82,230,不合格
20104877,24,9,22,38,28,121,不合格
20104878,23,36,21,95,51,226,不合格
20104879,96,23,14,74,80,287,不合格
20104880,19,17,77,13,79,205,不合格
20104881,85,29,4,37,66,221,不合格
20104882,66,27,14,86,61,254,不合格
20104883,28,77,45,78,99,327,合格
20104884,54,57,67,10,6,194,不合格
20104885,56,84,52,9,17,218,不合格
20104886,93,99,84,67,90,433,合格
20104887,4,34,25,15,23,101,不合格
20104888,29,70,99,17,85,300,合格
20104889,66,92,33,18,35,244,不合格
20104890,15,86,76,67,78,322,合格
20104891,75,45,82,5,51,258,不合格
20104892,74,30,8,58,90,260,不合格
20104893,1,63,88,12,42,206,不合格
20104894,46,20,22,86,73,247,不合格
20104895,67,88,98,27,39,319,合格
20104896,25,34,9,31,74,173,不合格
20104897,60,68,29,83,97,337,合格
20104898,33,50,77,8,43,211,不合格
20104899,10,5,23,77,99,214,不合格
20104900,35,53,28,12,91,219,不合格
20104901,63,98,88,64,22,335,合格
20104902,63,42,71,22,14,212,不合格
20104903,41,62,68,50,42,263,不合格
20104904,70,49,6,45,75,245,不合格
20104905,50,19,29,68,25,191,不合格
20104906,74,63,33,10,61,241,不合格
20104907,79,89,21,15,55,259,不合格
20104908,78,50,30,15,61,234,不合格
20104909,88,14,40,63,89,294,不合格
20104910,92,89,85,62,80,408,合格
20104911,77,97,6,7,55,242,不合格
20104912,84,23,97,91,81,376,合格
20104913,15,30,86,32,3,166,不合格
20104914,96,8,17,85,64,270,不合格
20104915,31,42,7,68,97,245,不合格
20104916,55,7,89,26,36,213,不合格
20104917,15,87,46,15,29,192,不合格
20104918,43,51,36,82,11,223,不合格
20104919,22,43,58,58,97,278,不合格
20104920,6,42,24,99,75,246,不合格
20104921,41,39,53,83,57,273,不合格
20104922,82,93,99,68,33,375,合格
20104923,14,8,37,46,51,156,不合格
20104924,33,71,53,2,21,180,不合格
20104925,59,56,41,32,7,195,不合格
20104926,93,78,0,21,42,234,不合格
20104927,39,62,56,3,9,169,不合格
20104928,30,3,89,0,68,190,不合格
20104929,2,79,17,30,71,199,不合格
20104930,16,44,66,4,74,204,不合格
20104931,37,23,17,55,50,182,不合格
20104932,92,90,12,1,98,293,不合格
20104933,84,76,8,17,14,199,不合格
20104934,76,38,26,42,38,220,不合格
20104935,3,42,19,14,56,134,不合格
20104936,34,37,85,32,60,248,不合格
20104937,68,62,44,37,10,221,不合格
20104938,74,28,41,44,97,284,不合格
20104939,24,67,49,61,39,240,不合格
20104940,74,13,53,9,40,189,不合格
20104941,14,40,51,92,8,205,不合格
20104942,68,5,97,69,97,336,合格
20104943,45,30,43,55,49,222,不合格
20104944,23,35,10,43,73,184,不合格
20104945,1,88,3,66,87,245,不合格
20104946,30,5,38,90,47,210,不合格
20104947,21,75,44,69,55,264,不合格
20104948,26,93,67,22,62,270,不合格
20104949,39,70,45,61,89,304,合格
20104950,29,53,68,69,60,279,不合格
20104951,13,82,54,24,48,221,不合格
20104952,18,58,33,92,92,293,不合格
20104953,72,38,25,15,73,223,不合格
20104954,79,56,97,10,42,284,不合格
20104955,96,25,17,67,23,228,不合格
20104956,93,2,54,20,70,239,不合格
20104957,94,57,63,17,57,288,不合格
20104958,98,3,48,91,46,286,不合格
20104959,16,61,1,71,58,207,不合格
20104960,65,9,73,92,61,300,合格
20104961,22,5,76,32,65,200,不合格
20104962,76,23,1,50,86,236,不合格
20104963,97,30,61,27,64,279,不合格
20104964,5,88,51,49,65,258,不合格
20104965,87,19,51,38,63,258,不合格
20104966,73,56,71,61,13,274,不合格
20104967,53,98,55,60,88,354,合格
20104968,20,60,14,13,89,196,不合格
20104969,80,35,76,0,45,236,不合格
20104970,0,26,64,56,97,243,不合格
20104971,46,66,39,91,50,292,不合格
20104972,91,74,15,24,88,292,不合格
20104973,17,68,94,79,60,318,合格
20104974,28,97,36,43,23,227,不合格
20104975,58,70,92,39,93,352,合格
20104976,28,95,28,25,23,199,不合格
20104977,19,66,64,60,49,258,不合格
20104978,11,74,91,18,69,263,不合格
20104979,34,74,70,66,28,272,不合格
20104980,46,34,66,57,57,260,不合格
20104981,3,0,61,62,26,152,不合格
20104982,76,34,25,90,27,252,不合格
20104983,26,79,16,81,87,289,不合格
20104984,85,25,36,20,67,233,不合格
20104985,22,66,94,58,68,308,合格
20104986,64,19,19,2,16,120,不合格
20104987,68,55,10,15,50,198,不合格
20104988,23,27,94,73,93,310,合格
20104989,73,93,74,86,72,398,合格
20104990,80,36,35,23,51,225,不合格
20104991,61,61,80,25,65,292,不合格
20104992,38,47,98,30,65,278,不合格
20104993,11,77,75,3,79,245,不合格
20104994,13,61,32,83,75,264,不合格
20104995,68,97,80,28,73,346,合格
20104996,19,44,82,80,80,305,合格
20104997,69,73,33,87,27,289,不合格
20104998,22,74,14,32,13,155,不合格
20104999,90,23,25,13,66,217,不合格
20105000,26,14,59,59,58,216,不合格
20105001,9,74,8,8,5,104,不合格
20105002,7,48,11,41,72,179,不合格
20105003,7,60,96,89,55,307,合格
20105004,49,27,8,44,57,185,不合格
20105005,98,35,6,89,60,288,不合格
20105006,76,23,35,67,9,210,不合格
20105007,59,80,52,58,22,271,不合格
20105008,36,27,76,63,58,260,不合格
20105009,42,40,52,61,71,266,不合格
20105010,57,69,10,4,84,224,不合格
20105011,92,37,34,31,73,267,不合格
20105012,71,20,68,38,56,253,不合格
20105013,69,0,25,81,97,272,不合格
20105014,18,36,70,45,77,246,不合格
20105015,77,11,58,6,39,191,不合格
20105016,3,53,21,94,1,172,不合格
20105017,72,38,64,8,19,201,不合格
20105018,27,75,9,21,5,137,不合格
20105019,60,91,95,57,89,392,合格
20105020,49,48,62,63,39,261,不合格
20105021,16,78,94,99,65,352,合格
20105022,80,62,44,64,37,287,不合格
20105023,4,94,66,88,2,254,不合格
20105024,54,61,46,2,83,246,不合格
20105025,77,14,78,38,54,261,不合格
20105026,85,74,10,42,22,233,不合格
20105027,85,54,48,87,33,307,合格
20105028,72,76,63,80,62,353,合格
20105029,68,95,93,57,31,344,合格
20105030,45,91,69,97,3,305,合格
20105031,56,80,48,72,9,265,不合格
20105032,65,90,72,41,95,363,合格
20105033,1,85,23,55,21,185,不合格
20105034,69,63,41,91,0,264,不合格
20105035,92,78,72,16,87,345,合格
20105036,40,8,57,26,55,186,不合格
20105037,61,42,1,79,15,198,不合格
20105038,74,77,83,21,47,302,合格
20105039,56,14,52,60,17,199,不合格
20105040,63,98,23,45,82,311,合格
20105041,92,25,79,17,18,231,不合格
20105042,41,20,60,10,49,180,不合格
20105043,75,30,9,58,65,237,不合格
20105044,55,96,90,74,90,405,合格
20105045,34,5,55,18,62,174,不合格
20105046,62,29,59,30,23,203,不合格
20105047,16,84,29,47,44,220,不合格
20105048,48,68,51,11,74,252,不合格
20105049,27,53,83,40,95,298,不合格
20105050,12,26,34,72,89,233,不合格
20105051,0,20,44,28,66,158,不合格
20105052,25,37,76,65,45,248,不合格
20105053,17,65,94,71,87,334,合格
20105054,40,60,80,21,20,221,不合格
20105055,6,0,52,37,31,126,不合格
20105056,74,48,21,18,68,229,不合格
20105057,57,31,86,0,74,248,不合格
20105058,74,73,99,9,32,287,不合格
20105059,71,47,20,1,49,188,不合格
20105060,1,17,4,7,57,86,不合格
20105061,50,17,87,13,82,249,不合格
20105062,50,6,55,78,27,216,不合格
20105063,20,6,63,19,7,115,不合格
20105064,26,56,73,76,36,267,不合格
20105065,12,69,36,38,73,228,不合格
20105066,17,50,77,64,20,228,不合格
20105067,54,27,88,55,9,233,不合格
20105068,93,76,34,57,73,333,合格
20105069,93,21,9,74,26,223,不合格
20105070,53,73,27,46,56,255,不合格
20105071,51,70,71,45,35,272,不合格
20105072,69,4,98,30,36,237,不合格
20105073,96,69,78,93,80,416,合格
20105074,94,83,25,84,67,353,合格
20105075,0,2,40,65,92,199,不合格
20105076,88,56,61,11,55,271,不合格
20105077,59,51,72,56,83,321,合格
20105078,8,33,86,76,8,211,不合格
20105079,3,26,22,66,40,157,不合格
20105080,22,8,66,98,51,245,不合格
20105081,91,75,76,43,29,314,合格
20105082,50,53,26,4,5,138,不合格
20105083,16,91,56,9,53,225,不合格
20105084,55,59,95,8,19,236,不合格
20105085,96,75,63,45,68,347,合格
20105086,88,84,39,85,75,371,合格
20105087,54,62,82,23,59,280,不合格
20105088,6,97,52,12,56,223,不合格
20105089,56,31,82,10,89,268,不合格
20105090,51,64,48,23,75,261,不合格
20105091,95,0,59,61,71,286,不合格
20105092,6,7,15,59,8,95,不合格
20105093,40,74,76,38,60,288,不合格
20105094,13,90,81,29,61,274,不合格
20105095,59,0,20,22,98,199,不合格
20105096,27,18,89,8,68,210,不合格
20105097,26,41,98,70,72,307,合格
20105098,92,89,45,98,2,326,合格
20105099,21,49,43,76,82,271,不合格
20105100,11,78,78,29,87,283,不合格
20105101,65,36,47,45,21,214,不合格
20105102,68,50,74,74,16,282,不合格
20105103,95,36,17,28,43,219,不合格
20105104,62,22,15,46,81,226,不合格
20105105,59,84,13,90,55,301,合格
20105106,42,71,22,4,4,143,不合格
20105107,80,43,41,96,61,321,合格
20105108,84,25,89,86,21,305,合格
20105109,97,80,23,18,96,314,合格
20105110,38,41,58,61,42,240,不合格
20105111,93,84,73,49,1,300,合格
20105112,6,98,37,78,14,233,不合格
20105113,54,72,86,98,61,371,合格
20105114,47,41,70,73,94,325,合格
20105115,60,56,35,81,11,243,不合格
20105116,43,58,9,34,52,196,不合格
20105117,71,11,72,59,69,282,不合格
20105118,34,96,80,39,85,334,合格
20105119,49,26,29,55,60,219,不合格
20105120,79,78,94,81,30,362,合格
20105121,22,40,5,22,15,104,不合格
20105122,19,28,58,42,78,225,不合格
20105123,76,11,0,21,50,158,不合格
20105124,93,94,40,21,11,259,不合格
20105125,10,39,88,36,52,225,不合格
20105126,3,1,45,3,8,60,不合格
20105127,81,59,75,77,25,317,合格
20105128,94,23,8,65,30,220,不合格
20105129,13,95,0,58,93,259,不合格
20105130,47,7,22,43,71,190,不合格
20105131,91,46,93,64,61,355,合格
20105132,82,35,8,33,38,196,不合格
20105133,94,24,78,83,15,294,不合格
20105134,56,81,86,83,31,337,合格
20105135,81,51,42,28,42,244,不合格
20105136,91,1,93,73,96,354,合格
20105137,46,50,0,78,24,198,不合格
20105138,0,17,56,4,66,143,不合格
20105139,23,97,51,11,15,197,不合格
20105140,16,25,76,72,83,272,不合格
20105141,85,19,2,38,37,181,不合格
20105142,98,87,58,69,93,405,合格
20105143,8,4,75,59,61,207,不合格
20105144,68,94,7,43,81,293,不合格
20105145,20,37,48,65,9,179,不合格
20105146,94,70,4,58,66,292,不合格
20105147,68,33,43,70,45,259,不合格
20105148,94,49,92,82,15,332,合格
20105149,91,83,56,93,79,402,合格
20105150,9,98,43,60,13,223,不合格
20105151,84,1,61,4,74,224,不合格
20105152,59,85,50,51,24,269,不合格
20105153,48,51,24,92,57,272,不合格
20105154,64,29,14,52,85,244,不合格
20105155,5,64,90,99,25,283,不合格
20105156,21,6,62,74,73,236,不合格
20105157,54,70,86,93,52,355,合格
20105158,36,55,72,5,19,187,不合格
20105159,75,27,88,87,43,320,合格
20105160,64,81,36,97,96,374,合格
20105161,5,82,98,12,97,294,不合格
20105162,40,60,94,48,29,271,不合格
20105163,73,32,16,14,95,230,不合格
20105164,66,48,70,59,67,310,合格
20105165,9,91,61,17,84,262,不合格
20105166,79,32,72,60,94,337,合格
20105167,47,80,47,28,99,301,合格
20105168,73,22,98,46,25,264,不合格
20105169,0,2,82,57,80,221,不合格
20105170,32,21,4,0,87,144,不合格
20105171,86,26,92,89,11,304,合格
20105172,9,39,12,73,60,193,不合格
20105173,48,56,60,45,21,230,不合格
20105174,98,31,77,75,7,288,不合格
20105175,82,47,29,72,20,250,不合格
20105176,89,36,62,7,65,259,不合格
20105177,94,68,54,71,76,363,合格
20105178,36,69,75,71,48,299,不合格
20105179,10,75,2,24,84,195,不合格
20105180,72,29,28,6,99,234,不合格
20105181,19,44,70,86,58,277,不合格
20105182,4,57,59,18,79,217,不合格
20105183,71,46,20,72,67,276,不合格
20105184,42,30,69,1,25,167,不合格
20105185,37,25,55,24,32,173,不合格
20105186,17,84,81,86,94,362,合格
20105187,3,94,49,54,60,260,不合格
20105188,36,64,42,39,11,192,不合格
20105189,96,38,3,6,6,149,不合格
20105190,69,68,99,66,97,399,合格
20105191,41,12,24,77,21,175,不合格
20105192,53,51,65,73,5,247,不合格
20105193,30,38,96,10,78,252,不合格
20105194,47,38,88,98,21,292,不合格
20105195,20,6,93,41,2,162,不合格
20105196,14,20,82,72,34,222,不合格
20105197,15,80,41,84,15,235,不合格
20105198,33,11,19,83,87,233,不合格
20105199,42,9,60,56,86,253,不合格
20105200,87,6,73,28,39,233,不合格
20105201,20,84,98,17,25,244,不合格
20105202,7,41,11,76,90,225,不合格
20105203,96,35,47,66,33,277,不合格
20105204,10,31,67,2,23,133,不合格
20105205,28,50,46,65,59,248,不合格
20105206,79,76,64,86,3,308,合格
20105207,34,61,37,41,40,213,不合格
20105208,53,51,42,37,69,252,不合格
20105209,36,81,30,0,19,166,不合格
20105210,3,88,92,93,59,335,合格
20105211,70,38,41,45,27,221,不合格
20105212,26,20,44,50,45,185,不合格
20105213,48,26,50,64,0,188,不合格
20105214,76,42,40,30,54,242,不合格
20105215,99,85,84,22,36,326,合格
20105216,95,56,81,79,85,396,合格
20105217,45,70,90,85,99,389,合格
20105218,29,84,29,74,98,314,合格
20105219,50,87,17,82,65,301,合格
20105220,18,93,33,14,67,225,不合格
20105221,15,18,88,57,69,247,不合格
20105222,76,53,82,42,31,284,不合格
20105223,79,83,31,54,39,286,不合格
20105224,78,59,5,35,87,264,不合格
20105225,62,72,75,24,45,278,不合格
20105226,83,94,4,64,41,286,不合格
20105227,14,88,9,85,4,200,不合格
20105228,19,48,77,39,65,248,不合格
20105229,83,39,78,37,3,240,不合格
20105230,79,97,38,3,76,293,不合格
20105231,93,22,9,96,27,247,不合格
20105232,70,77,51,88,84,370,合格
20105233,27,8,73,6,49,163,不合格
20105234,89,51,96,94,62,392,合格
20105235,35,79,56,25,76,271,不合格
20105236,41,98,28,50,3,220,不合格
20105237,51,44,31,77,63,266,不合格
20105238,83,86,68,93,2,332,合格
20105239,20,66,83,29,84,282,不合格
20105240,21,79,38,83,85,306,合格
20105241,50,19,93,3,53,218,不合格
20105242,47,82,31,95,72,327,合格
20105243,51,66,78,37,71,303,合格
20105244,16,19,76,2,61,174,不合格
20105245,73,56,11,96,83,319,合格
20105246,3,88,29,60,64,244,不合格
20105247,49,65,5,41,20,180,不合格
20105248,68,34,10,7,45,164,不合格
20105249,76,29,53,26,47,231,不合格
20105250,63,60,40,28,77,268,不合格
20105251,19,12,74,33,89,227,不合格
20105252,25,33,45,99,70,272,不合格
20105253,12,12,69,44,13,150,不合格
20105254,10,35,14,59,5,123,不合格
20105255,9,79,27,45,25,185,不合格
20105256,64,46,79,4,2,195,不合格
20105257,30,46,53,58,33,220,不合格
20105258,68,82,18,77,92,337,合格
20105259,48,86,95,51,33,313,合格
20105260,82,18,84,20,65,269,不合格
20105261,6,22,52,73,64,217,不合格
20105262,96,28,24,43,67,258,不合格
20105263,80,78,56,82,98,394,合格
20105264,35,38,87,1,25,186,不合格
20105265,9,43,41,15,95,203,不合格
20105266,50,41,59,85,44,279,不合格
20105267,64,59,49,11,7,190,不合格
20105268,68,72,60,33,99,332,合格
20105269,56,68,72,55,85,336,合格
20105270,2,89,94,67,50,302,合格
20105271,41,87,51,9,25,213,不合格
20105272,72,1,86,16,17,192,不合格
20105273,77,67,40,8,13,205,不合格
20105274,0,27,36,57,69,189,不合格
20105275,41,89,65,51,3,249,不合格
20105276,80,28,52,56,28,244,不合格
20105277,85,55,1,17,57,215,不合格
20105278,41,75,70,4,15,205,不合格
20105279,56,56,97,26,85,320,合格
20105280,98,94,54,42,39,327,合格
20105281,54,41,89,47,30,261,不合格
20105282,31,97,86,99,78,391,合格
20105283,10,88,71,4,83,256,不合格
20105284,16,31,12,19,49,127,不合格
20105285,24,99,64,0,42,229,不合格
20105286,6,63,52,10,98,229,不合格
20105287,19,9,77,18,26,149,不合格
20105288,79,89,43,66,17,294,不合格
20105289,68,36,76,6,64,250,不合格
20105290,77,1,83,23,7,191,不合格
20105291,10,73,42,79,59,263,不合格
20105292,69,93,59,13,29,263,不合格
20105293,21,23,79,11,25,159,不合格
20105294,10,98,63,1,40,212,不合格
20105295,32,81,80,61,77,331,合格
20105296,45,88,36,2,69,240,不合格
20105297,4,49,76,68,6,203,不合格
20105298,13,66,61,44,68,252,不合格
20105299,56,80,52,44,58,290,不合格
20105300,10,97,76,34,50,267,不合格
20105301,55,76,54,98,14,297,不合格
20105302,33,13,3,21,16,86,不合格
20105303,50,67,90,29,84,320,合格
20105304,62,93,62,35,89,341,合格
20105305,76,59,21,57,59,272,不合格
20105306,80,19,7,12,14,132,不合格
20105307,49,22,4,78,77,230,不合格
20105308,51,48,91,7,75,272,不合格
20105309,87,77,78,2,64,308,合格
20105310,22,20,96,25,62,225,不合格
20105311,98,70,39,69,40,316,合格
20105312,34,94,17,46,3,194,不合格
20105313,10,30,73,65,82,260,不合格
20105314,67,24,21,23,61,196,不合格
20105315,7,75,83,77,42,284,不合格
20105316,34,7,14,75,76,206,不合格
20105317,65,19,54,95,86,319,合格
20105318,27,37,14,79,63,220,不合格
20105319,51,52,82,0,71,256,不合格
20105320,6,14,80,79,61,240,不合格
20105321,27,39,42,58,24,190,不合格
20105322,32,18,83,18,18,169,不合格
20105323,82,20,78,99,89,368,合格
20105324,94,86,98,36,72,386,合格
20105325,14,3,43,64,45,169,不合格
20105326,50,17,22,47,42,178,不合格
20105327,34,49,44,70,78,275,不合格
20105328,57,65,64,16,85,287,不合格
20105329,20,99,62,58,48,287,不合格
20105330,3,94,83,15,89,284,不合格
20105331,5,26,51,16,51,149,不合格
20105332,85,95,39,76,82,377,合格
20105333,49,36,19,98,76,278,不合格
20105334,78,91,32,45,24,270,不合格
20105335,23,97,23,6,73,222,不合格
20105336,63,43,13,76,40,235,不合格
20105337,46,54,95,19,42,256,不合格
20105338,73,40,19,35,70,237,不合格
20105339,81,95,43,7,43,269,不合格
20105340,11,46,88,22,6,173,不合格
20105341,85,2,1,60,25,173,不合格
20105342,3,4,99,84,39,229,不合格
20105343,83,43,59,28,9,222,不合格
20105344,38,55,67,9,78,247,不合格
20105345,71,3,93,86,90,343,合格
20105346,91,19,62,83,74,329,合格
20105347,25,17,3,95,26,166,不合格
20105348,32,51,60,10,45,198,不合格
20105349,38,47,97,46,24,252,不合格
20105350,9,51,33,8,5,106,不合格
20105351,54,56,48,76,17,251,不合格
20105352,43,42,57,72,60,274,不合格
20105353,73,93,62,73,52,353,合格
20105354,48,44,52,99,74,317,合格
20105355,74,95,84,66,41,360,合格
20105356,52,6,83,82,94,317,合格
20105357,19,44,92,13,79,247,不合格
20105358,68,19,41,95,19,242,不合格
20105359,18,89,20,49,41,217,不合格
20105360,24,89,94,97,18,322,合格
20105361,93,76,32,46,53,300,合格
20105362,5,19,63,62,47,196,不合格
20105363,25,46,17,47,34,169,不合格
20105364,94,12,60,12,41,219,不合格
20105365,29,36,33,14,15,127,不合格
20105366,1,91,38,67,66,263,不合格
20105367,51,31,75,95,27,279,不合格
20105368,34,81,11,49,49,224,不合格
20105369,61,21,97,44,66,289,不合格
20105370,64,3,87,19,85,258,不合格
20105371,28,10,33,67,21,159,不合格
20105372,71,46,83,97,52,349,合格
20105373,17,55,35,92,55,254,不合格
20105374,60,72,85,79,22,318,合格
20105375,29,93,93,50,7,272,不合格
20105376,94,10,94,11,61,270,不合格
20105377,80,70,38,77,31,296,不合格
20105378,75,43,6,2,78,204,不合格
20105379,49,91,44,74,12,270,不合格
20105380,36,86,42,90,63,317,合格
20105381,58,38,62,57,73,288,不合格
20105382,69,54,53,55,9,240,不合格
20105383,91,7,19,96,22,235,不合格
20105384,52,1,52,20,90,215,不合格
20105385,88,76,33,19,79,295,不合格
20105386,57,43,43,44,90,277,不合格
20105387,31,65,46,87,29,258,不合格
20105388,65,41,89,43,15,253,不合格
20105389,7,89,23,96,69,284,不合格
20105390,95,49,81,5,25,255,不合格
20105391,23,67,19,97,9,215,不合格
20105392,74,1,55,35,57,222,不合格
20105393,20,68,30,90,36,244,不合格
20105394,61,38,68,6,6,179,不合格
20105395,63,6,42,26,19,156,不合格
20105396,16,64,13,7,98,198,不合格
20105397,13,94,53,87,80,327,合格
20105398,97,31,64,62,30,284,不合格
20105399,75,96,88,75,26,360,合格
20105400,52,97,28,23,21,221,不合格
20105401,88,33,28,82,0,231,不合格
20105402,69,78,18,41,7,213,不合格
20105403,66,27,90,91,27,301,合格
20105404,62,4,23,33,77,199,不合格
20105405,76,56,36,53,62,283,不合格
20105406,7,55,14,57,41,174,不合格
20105407,34,23,9,84,27,177,不合格
20105408,13,49,73,63,33,231,不合格
20105409,79,83,98,28,92,380,合格
20105410,0,3,26,29,67,125,不合格
20105411,10,42,42,0,56,150,不合格
20105412,91,44,15,27,18,195,不合格
20105413,35,39,72,52,86,284,不合格
20105414,43,83,56,53,24,259,不合格
20105415,31,10,58,81,92,272,不合格
20105416,53,27,39,7,11,137,不合格
20105417,99,61,54,40,56,310,合格
20105418,89,98,66,65,97,415,合格
20105419,80,25,53,42,48,248,不合格
20105420,61,82,80,41,87,351,合格
20105421,72,16,29,16,31,164,不合格
20105422,82,94,15,91,48,330,合格
20105423,86,47,43,76,21,273,不合格
20105424,54,80,64,60,50,308,合格
20105425,10,58,46,35,98,247,不合格
20105426,24,11,98,43,75,251,不合格
20105427,79,1,16,28,82,206,不合格
20105428,74,6,52,56,47,235,不合格
20105429,56,77,69,26,75,303,合格
20105430,78,37,13,2,3,133,不合格
20105431,79,21,48,39,45,232,不合格
20105432,64,34,57,37,3,195,不合格
20105433,37,52,54,82,22,247,不合格
20105434,79,40,39,96,41,295,不合格
20105435,67,23,5,9,21,125,不合格
20105436,0,24,30,94,35,183,不合格
20105437,62,30,92,97,61,342,合格
20105438,37,68,3,70,84,262,不合格
20105439,94,10,78,29,18,229,不合格
20105440,13,24,43,53,62,195,不合格
20105441,52,90,34,26,67,269,不合格
20105442,88,51,25,78,13,255,不合格
20105443,58,52,75,80,81,346,合格
20105444,10,26,84,82,5,207,不合格
20105445,87,8,40,47,65,247,不合格
20105446,91,15,22,34,45,207,不合格
20105447,0,42,0,73,92,207,不合格
20105448,60,31,87,28,42,248,不合格
20105449,9,58,72,12,95,246,不合格
20105450,39,94,4,60,54,251,不合格
20105451,25,40,6,76,75,222,不合格
20105452,22,1,82,41,37,183,不合格
20105453,61,36,67,69,72,305,合格
20105454,62,70,32,77,80,321,合格
20105455,23,79,25,54,31,212,不合格
20105456,51,73,87,61,22,294,不合格
20105457,56,33,84,1,78,252,不合格
20105458,72,60,1,10,52,195,不合格
20105459,78,72,63,62,16,291,不合格
20105460,7,54,55,12,38,166,不合格
20105461,51,19,55,95,40,260,不合格
20105462,80,41,12,84,30,247,不合格
20105463,33,59,17,38,49,196,不合格
20105464,21,79,16,88,27,231,不合格
20105465,43,88,15,78,22,246,不合格
20105466,10,49,0,88,81,228,不合格
20105467,39,24,19,70,44,196,不合格
20105468,66,50,53,2,22,193,不合格
20105469,18,67,61,85,66,297,不合格
20105470,48,62,26,25,75,236,不合格
20105471,35,6,2,65,47,155,不合格
20105472,53,99,38,25,3,218,不合格
20105473,17,36,11,22,76,162,不合格
20105474,73,32,35,44,82,266,不合格
20105475,66,25,50,16,47,204,不合格
20105476,56,37,8,87,54,242,不合格
20105477,64,5,79,86,56,290,不合格
20105478,17,74,50,13,90,244,不合格
20105479,38,57,1,79,46,221,不合格
20105480,38,94,84,42,27,285,不合格
20105481,46,20,45,53,83,247,不合格
20105482,62,36,71,89,24,282,不合格
20105483,65,20,97,35,55,272,不合格
20105484,61,67,59,30,0,217,不合格
20105485,88,4,57,35,31,215,不合格
20105486,15,38,25,41,68,187,不合格
20105487,20,78,47,66,47,258,不合格
20105488,71,29,5,12,69,186,不合格
20105489,49,79,73,67,41,309,合格
20105490,68,72,94,46,82,362,合格
20105491,61,84,38,28,74,285,不合格
20105492,75,77,97,52,32,333,合格
20105493,56,60,44,72,57,289,不合格
20105494,74,17,38,82,17,228,不合格
20105495,81,25,6,19,33,164,不合格
20105496,64,96,48,50,4,262,不合格
20105497,78,15,86,38,94,311,合格
20105498,97,15,16,60,43,231,不合格
20105499,53,4,23,61,56,197,不合格
20105500,23,57,5,30,21,136,不合格
