ID,国語,数学,英語,理科,社会,合計,判定
20110001,67,81,60,81,46,335,合格
20110002,79,91,59,12,91,332,合格
20110003,2,81,53,43,49,228,不合格
20110004,63,98,96,69,30,356,合格
20110005,28,96,74,98,97,393,合格
20110006,14,35,27,98,49,223,不合格
20110007,73,55,87,30,29,274,不合格
20110008,30,82,60,68,74,314,合格
20110009,46,60,32,52,54,244,不合格
20110010,6,29,39,44,42,160,不合格
20110011,8,21,22,29,54,134,不合格
20110012,31,27,27,94,50,229,不合格
20110013,87,40,39,53,51,270,不合格
20110014,65,15,12,54,86,232,不合格
20110015,33,76,20,49,20,198,不合格
20110016,94,21,23,67,2,207,不合格
20110017,15,98,58,39,64,274,不合格
20110018,95,47,27,56,48,273,不合格
20110019,26,17,22,13,28,106,不合格
20110020,70,7,98,46,42,263,不合格
20110021,24,51,6,54,65,200,不合格
20110022,81,53,6,79,91,310,合格
20110023,75,60,65,69,75,344,合格
20110024,92,82,72,38,0,284,不合格
20110025,98,42,49,73,49,311,合格
20110026,75,72,86,63,52,348,合格
20110027,31,3,22,30,2,88,不合格
20110028,44,64,16,80,71,275,不合格
20110029,27,68,90,69,2,256,不合格
20110030,30,90,54,13,56,243,不合格
20110031,68,93,16,38,14,229,不合格
20110032,24,94,67,9,35,229,不合格
20110033,8,91,77,91,21,288,不合格
20110034,98,8,28,12,87,233,不合格
20110035,28,67,13,20,69,197,不合格
20110036,80,20,89,81,46,316,合格
20110037,35,98,21,62,89,305,合格
20110038,39,95,78,75,13,300,合格
20110039,46,83,67,28,58,282,不合格
20110040,88,54,96,60,9,307,合格
20110041,82,66,93,87,89,417,合格
20110042,42,3,83,85,45,258,不合格
20110043,36,13,35,38,71,193,不合格
20110044,84,97,60,96,40,377,合格
20110045,47,16,82,1,83,229,不合格
20110046,41,5,47,26,17,136,不合格
20110047,5,56,37,4,32,134,不合格
20110048,27,69,15,35,20,166,不合格
20110049,30,71,46,50,55,252,不合格
20110050,33,51,65,50,29,228,不合格
20110051,69,67,15,21,63,235,不合格
20110052,76,0,27,34,43,180,不合格
20110053,30,92,88,40,0,250,不合格
20110054,59,85,17,24,51,236,不合格
20110055,56,41,91,27,78,293,不合格
20110056,56,65,27,21,13,182,不合格
20110057,72,10,12,27,8,129,不合格
20110058,40,54,68,17,52,231,不合格
20110059,16,94,63,77,39,289,不合格
20110060,18,68,55,85,82,308,合格
20110061,45,20,38,13,95,211,不合格
20110062,14,84,11,90,16,215,不合格
20110063,85,30,65,77,23,280,不合格
20110064,49,81,74,55,60,319,合格
20110065,14,42,38,60,94,248,不合格
20110066,2,55,9,28,96,190,不合格
20110067,79,37,8,60,77,261,不合格
20110068,4,93,6,24,73,200,不合格
20110069,18,30,58,47,19,172,不合格
20110070,76,87,16,6,19,204,不合格
20110071,94,30,46,76,26,272,不合格
20110072,48,51,29,54,36,218,不合格
20110073,53,77,53,53,99,335,合格
20110074,13,60,95,99,21,288,不合格
20110075,62,87,10,51,40,250,不合格
20110076,58,98,97,90,40,383,合格
20110077,84,72,46,78,81,361,合格
20110078,22,5,39,83,5,154,不合格
20110079,38,76,19,36,25,194,不合格
20110080,82,58,4,84,5,233,不合格
20110081,96,81,35,5,46,263,不合格
20110082,88,75,45,11,80,299,不合格
20110083,66,43,70,55,47,281,不合格
20110084,75,19,58,24,76,252,不合格
20110085,39,79,82,38,35,273,不合格
20110086,47,36,64,80,98,325,合格
20110087,70,73,97,19,97,356,合格
20110088,40,67,11,77,16,211,不合格
20110089,99,23,54,87,33,296,不合格
20110090,60,64,2,89,49,264,不合格
20110091,54,2,33,79,89,257,不合格
20110092,67,75,9,95,9,255,不合格
20110093,87,30,11,46,57,231,不合格
20110094,86,24,6,95,59,270,不合格
20110095,27,51,92,45,34,249,不合格
20110096,8,69,10,46,74,207,不合格
20110097,39,1,5,20,59,124,不合格
20110098,7,61,34,55,7,164,不合格
20110099,65,58,47,31,75,276,不合格
20110100,35,32,34,43,85,229,不合格
20110101,97,73,93,24,78,365,合格
20110102,88,18,23,44,77,250,不合格
20110103,9,30,94,64,42,239,不合格
20110104,75,73,89,88,77,402,合格
20110105,38,86,48,62,59,293,不合格
20110106,75,65,74,70,7,291,不合格
20110107,9,30,93,44,8,184,不合格
20110108,47,86,7,19,55,214,不合格
20110109,45,7,12,28,89,181,不合格
20110110,80,68,23,43,97,311,合格
20110111,79,32,60,61,13,245,不合格
20110112,74,62,36,91,43,306,合格
20110113,20,53,5,38,54,170,不合格
20110114,44,88,40,51,27,250,不合格
20110115,25,81,24,83,84,297,不合格
20110116,46,97,79,59,41,322,合格
20110117,91,74,10,37,92,304,合格
20110118,64,47,21,30,59,221,不合格
20110119,34,70,96,63,83,346,合格
20110120,68,41,86,41,91,327,合格
20110121,38,46,69,76,82,311,合格
20110122,95,1,10,27,67,200,不合格
20110123,5,62,19,85,70,241,不合格
20110124,91,70,0,30,90,281,不合格
20110125,93,34,60,71,47,305,合格
20110126,25,58,87,66,81,317,合格
20110127,16,14,15,16,75,136,不合格
20110128,75,76,47,79,22,299,不合格
20110129,97,90,45,72,84,388,合格
20110130,85,59,1,81,26,252,不合格
20110131,90,84,27,90,78,369,合格
20110132,13,97,88,23,91,312,合格
20110133,11,80,22,97,8,218,不合格
20110134,80,0,1,5,81,167,不合格
20110135,61,20,9,65,72,227,不合格
20110136,99,97,92,81,74,443,合格
20110137,89,95,23,88,58,353,合格
20110138,83,9,58,75,6,231,不合格
20110139,47,75,68,91,86,367,合格
20110140,85,16,31,2,79,213,不合格
20110141,73,54,25,59,20,231,不合格
20110142,27,78,10,12,41,168,不合格
20110143,2,4,96,2,21,125,不合格
20110144,78,25,19,61,57,240,不合格
20110145,44,1,67,26,19,157,不合格
20110146,22,58,3,29,40,152,不合格
20110147,55,99,52,10,89,305,合格
20110148,98,37,29,55,71,290,不合格
20110149,2,39,71,54,21,187,不合格
20110150,5,31,28,33,31,128,不合格
20110151,70,91,88,88,86,423,合格
20110152,86,95,31,59,3,274,不合格
20110153,75,22,38,14,75,224,不合格
20110154,1,64,28,33,35,161,不合格
20110155,68,2,35,94,62,261,不合格
20110156,6,21,7,5,87,126,不合格
20110157,26,34,29,65,62,216,不合格
20110158,11,42,2,79,81,215,不合格
20110159,79,75,78,2,91,325,合格
20110160,99,36,90,41,85,351,合格
20110161,16,44,35,58,67,220,不合格
20110162,87,39,58,39,93,316,合格
20110163,80,86,34,81,32,313,合格
20110164,19,64,83,74,71,311,合格
20110165,16,12,3,47,92,170,不合格
20110166,84,87,64,27,70,332,合格
20110167,3,9,15,65,48,140,不合格
20110168,34,98,44,27,6,209,不合格
20110169,19,94,79,1,57,250,不合格
20110170,66,97,30,29,16,238,不合格
20110171,15,6,82,86,67,256,不合格
20110172,55,75,51,13,95,289,不合格
20110173,76,38,29,37,91,271,不合格
20110174,38,0,0,92,42,172,不合格
20110175,81,52,45,25,44,247,不合格
20110176,18,40,93,75,62,288,不合格
20110177,39,5,1,1,3,49,不合格
20110178,27,67,21,79,39,233,不合格
20110179,24,42,86,8,71,231,不合格
20110180,48,52,48,22,35,205,不合格
20110181,73,51,38,32,9,203,不合格
20110182,19,59,28,66,31,203,不合格
20110183,32,48,7,16,28,131,不合格
20110184,21,83,12,45,76,237,不合格
20110185,46,21,44,90,52,253,不合格
20110186,92,33,24,65,92,306,合格
20110187,63,53,55,42,39,252,不合格
20110188,76,25,57,49,74,281,不合格
20110189,44,59,77,52,60,292,不合格
20110190,97,46,46,74,37,300,合格
20110191,88,80,8,78,45,299,不合格
20110192,26,11,80,38,8,163,不合格
20110193,70,88,46,70,19,293,不合格
20110194,20,10,22,3,39,94,不合格
20110195,54,38,70,97,39,298,不合格
20110196,10,90,61,28,0,189,不合格
20110197,86,83,82,0,62,313,合格
20110198,6,53,32,96,77,264,不合格
20110199,44,35,10,2,2,93,不合格
20110200,66,39,11,81,81,278,不合格
20110201,28,24,51,93,30,226,不合格
20110202,92,56,49,10,88,295,不合格
20110203,65,35,25,79,71,275,不合格
20110204,61,24,13,51,66,215,不合格
20110205,32,36,6,16,34,124,不合格
20110206,45,10,28,31,15,129,不合格
20110207,33,70,91,52,62,308,合格
20110208,14,66,6,79,80,245,不合格
20110209,65,15,1,64,79,224,不合格
20110210,74,14,50,68,4,210,不合格
20110211,59,68,45,84,54,310,合格
20110212,41,23,55,53,12,184,不合格
20110213,40,22,56,69,78,265,不合格
20110214,74,24,19,79,93,289,不合格
20110215,24,6,63,69,4,166,不合格
20110216,12,80,99,67,6,264,不合格
20110217,76,90,13,47,62,288,不合格
20110218,69,64,28,96,99,356,合格
20110219,34,48,73,29,33,217,不合格
20110220,52,49,53,8,24,186,不合格
20110221,55,92,56,26,19,248,不合格
20110222,68,76,2,69,71,286,不合格
20110223,47,63,90,94,70,364,合格
20110224,94,63,64,99,18,338,合格
20110225,30,51,19,18,82,200,不合格
20110226,22,34,90,30,82,258,不合格
20110227,64,62,10,19,95,250,不合格
20110228,8,45,12,0,18,83,不合格
20110229,56,15,22,19,56,168,不合格
20110230,9,81,14,62,36,202,不合格
20110231,35,65,94,16,80,290,不合格
20110232,80,40,21,63,54,258,不合格
20110233,32,48,90,60,14,244,不合格
20110234,45,70,16,38,10,179,不合格
20110235,11,46,94,98,25,274,不合格
20110236,35,12,67,46,86,246,不合格
20110237,47,68,67,8,50,240,不合格
20110238,30,52,72,74,5,233,不合格
20110239,38,31,47,50,4,170,不合格
20110240,70,9,1,30,88,198,不合格
20110241,71,25,8,80,66,250,不合格
20110242,65,21,61,35,88,270,不合格
20110243,84,4,65,62,43,258,不合格
20110244,46,2,66,58,8,180,不合格
20110245,10,17,94,80,77,278,不合格
20110246,51,22,74,36,69,252,不合格
20110247,18,35,40,14,73,180,不合格
20110248,13,41,90,31,66,241,不合格
20110249,43,31,30,50,5,159,不合格
20110250,64,21,41,96,60,282,不合格
20110251,90,75,45,25,5,240,不合格
20110252,64,40,78,81,27,290,不合格
20110253,65,92,65,81,68,371,合格
20110254,20,50,42,59,53,224,不合格
20110255,31,57,24,44,24,180,不合格
20110256,38,71,19,21,95,244,不合格
20110257,43,71,70,23,39,246,不合格
20110258,0,31,2,5,90,128,不合格
20110259,71,24,28,48,23,194,不合格
20110260,44,68,89,24,79,304,合格
20110261,55,25,9,39,48,176,不合格
20110262,18,56,79,86,25,264,不合格
20110263,79,71,7,75,47,279,不合格
20110264,7,43,72,93,34,249,不合格
20110265,70,62,83,10,23,248,不合格
20110266,85,56,38,25,4,208,不合格
20110267,76,89,45,59,97,366,合格
20110268,32,35,21,5,16,109,不合格
20110269,43,66,46,39,67,261,不合格
20110270,60,21,46,56,92,275,不合格
20110271,15,83,82,56,51,287,不合格
20110272,7,81,57,47,56,248,不合格
20110273,5,8,57,67,18,155,不合格
20110274,79,62,22,38,37,238,不合格
20110275,90,67,96,83,29,365,合格
20110276,86,22,77,35,12,232,不合格
20110277,30,2,38,47,69,186,不合格
20110278,60,57,8,77,53,255,不合格
20110279,2,69,13,43,58,185,不合格
20110280,79,1,3,9,43,135,不合格
20110281,97,58,72,64,15,306,合格
20110282,45,74,77,5,33,234,不合格
20110283,41,84,47,92,55,319,合格
20110284,54,97,53,47,70,321,合格
20110285,90,4,88,75,75,332,合格
20110286,4,80,21,75,1,181,不合格
20110287,10,55,24,39,8,136,不合格
20110288,34,19,9,55,33,150,不合格
20110289,77,23,41,83,19,243,不合格
20110290,43,24,3,49,35,154,不合格
20110291,94,98,15,94,37,338,合格
20110292,50,42,9,67,36,204,不合格
20110293,76,82,95,89,56,398,合格
20110294,11,40,24,88,58,221,不合格
20110295,29,80,12,78,67,266,不合格
20110296,78,68,84,35,86,351,合格
20110297,25,69,89,56,59,298,不合格
20110298,92,45,6,12,7,162,不合格
20110299,51,0,34,60,7,152,不合格
20110300,91,26,72,84,4,277,不合格
20110301,12,92,70,69,1,244,不合格
20110302,89,89,52,26,2,258,不合格
20110303,60,44,58,95,21,278,不合格
20110304,95,87,96,84,54,416,合格
20110305,47,36,46,16,0,145,不合格
20110306,23,81,58,15,96,273,不合格
20110307,18,15,82,42,68,225,不合格
20110308,34,64,85,49,70,302,合格
20110309,25,43,23,79,88,258,不合格
20110310,74,84,47,54,26,285,不合格
20110311,79,18,16,96,75,284,不合格
20110312,54,8,39,39,12,152,不合格
20110313,2,84,74,27,12,199,不合格
20110314,88,2,37,94,83,304,合格
20110315,47,80,13,30,37,207,不合格
20110316,8,28,17,21,86,160,不合格
20110317,51,65,41,99,49,305,合格
20110318,29,60,51,90,82,312,合格
20110319,77,47,75,51,59,309,合格
20110320,7,14,55,93,3,172,不合格
20110321,2,39,70,93,28,232,不合格
20110322,77,10,28,27,92,234,不合格
20110323,74,8,87,57,41,267,不合格
20110324,93,45,56,90,27,311,合格
20110325,81,7,54,80,99,321,合格
20110326,40,10,36,74,16,176,不合格
20110327,43,57,46,4,10,160,不合格
20110328,87,13,76,79,68,323,合格
20110329,32,33,61,7,51,184,不合格
20110330,42,87,57,2,69,257,不合格
20110331,53,58,94,72,84,361,合格
20110332,53,95,84,15,64,311,合格
20110333,46,91,98,52,88,375,合格
20110334,11,66,15,66,55,213,不合格
20110335,19,70,47,94,53,283,不合格
20110336,72,19,90,90,79,350,合格
20110337,34,84,54,84,30,286,不合格
20110338,99,51,54,89,99,392,合格
20110339,95,21,52,33,75,276,不合格
20110340,13,64,32,58,73,240,不合格
20110341,92,46,11,76,57,282,不合格
20110342,65,17,97,67,71,317,合格
20110343,75,58,21,71,58,283,不合格
20110344,33,57,90,99,91,370,合格
20110345,42,62,65,12,35,216,不合格
20110346,10,63,8,54,52,187,不合格
20110347,86,74,38,62,75,335,合格
20110348,45,24,37,56,34,196,不合格
20110349,91,74,19,73,45,302,合格
20110350,70,68,22,14,5,179,不合格
20110351,81,26,48,84,10,249,不合格
20110352,69,0,35,69,37,210,不合格
20110353,3,94,97,90,40,324,合格
20110354,81,44,15,10,83,233,不合格
20110355,99,23,78,40,17,257,不合格
20110356,45,64,11,22,95,237,不合格
20110357,20,29,20,68,88,225,不合格
20110358,80,12,76,72,21,261,不合格
20110359,60,18,75,15,77,245,不合格
20110360,54,15,2,51,56,178,不合格
20110361,18,89,69,22,74,272,不合格
20110362,45,61,60,27,71,264,不合格
20110363,59,92,27,5,12,195,不合格
20110364,87,30,81,54,20,272,不合格
20110365,14,82,89,54,77,316,合格
20110366,18,5,3,18,99,143,不合格
20110367,74,14,86,33,96,303,合格
20110368,10,10,50,23,59,152,不合格
20110369,89,67,56,68,15,295,不合格
20110370,54,98,67,1,59,279,不合格
20110371,18,84,65,0,32,199,不合格
20110372,75,92,27,98,39,331,合格
20110373,25,55,42,0,53,175,不合格
20110374,53,1,39,10,67,170,不合格
20110375,82,88,93,3,59,325,合格
20110376,12,43,97,78,51,281,不合格
20110377,28,22,75,4,91,220,不合格
20110378,63,57,70,9,38,237,不合格
20110379,57,70,28,78,33,266,不合格
20110380,4,73,90,92,12,271,不合格
20110381,48,50,89,40,62,289,不合格
20110382,24,61,12,36,78,211,不合格
20110383,11,26,15,89,60,201,不合格
20110384,1,41,87,66,1,196,不合格
20110385,18,13,14,91,82,218,不合格
20110386,78,31,7,85,92,293,不合格
20110387,97,85,43,42,56,323,合格
20110388,66,86,97,77,63,389,合格
20110389,11,62,84,14,77,248,不合格
20110390,25,5,44,37,91,202,不合格
20110391,75,44,1,20,69,209,不合格
20110392,95,41,30,72,25,263,不合格
20110393,77,0,6,98,99,280,不合格
20110394,98,55,77,72,57,359,合格
20110395,89,9,37,27,69,231,不合格
20110396,14,47,48,45,76,230,不合格
20110397,76,90,57,65,17,305,合格
20110398,38,48,70,31,11,198,不合格
20110399,34,11,79,99,99,322,合格
20110400,51,11,98,33,50,243,不合格
20110401,78,6,88,20,37,229,不合格
20110402,61,46,1,57,66,231,不合格
20110403,76,78,89,85,70,398,合格
20110404,61,61,49,62,35,268,不合格
20110405,25,4,48,19,24,120,不合格
20110406,46,98,39,11,12,206,不合格
20110407,15,83,28,36,52,214,不合格
20110408,62,59,94,25,91,331,合格
20110409,77,13,73,27,40,230,不合格
20110410,15,61,42,67,85,270,不合格
20110411,63,37,67,52,41,260,不合格
20110412,90,72,95,96,69,422,合格
20110413,17,20,15,16,37,105,不合格
20110414,15,11,21,54,9,110,不合格
20110415,23,6,31,11,89,160,不合格
20110416,90,53,3,71,51,268,不合格
20110417,96,44,7,65,83,295,不合格
20110418,76,30,80,56,39,281,不合格
20110419,66,98,82,30,35,311,合格
20110420,83,66,24,88,41,302,合格
20110421,24,57,74,18,50,223,不合格
20110422,37,53,19,88,33,230,不合格
20110423,24,69,63,89,96,341,合格
20110424,16,36,90,27,41,210,不合格
20110425,67,24,73,89,94,347,合格
20110426,34,7,68,30,49,188,不合格
20110427,1,56,94,60,89,300,合格
20110428,3,97,89,3,87,279,不合格
20110429,33,11,76,36,88,244,不合格
20110430,49,42,75,50,28,244,不合格
20110431,6,80,71,73,54,284,不合格
20110432,17,2,4,68,75,166,不合格
20110433,29,17,0,22,14,82,不合格
20110434,5,65,53,53,9,185,不合格
20110435,18,40,12,45,49,164,不合格
20110436,14,50,16,84,77,241,不合格
20110437,18,84,8,75,8,193,不合格
20110438,55,89,37,91,43,315,合格
20110439,99,74,31,48,39,291,不合格
20110440,55,47,10,40,68,220,不合格
20110441,82,80,58,17,4,241,不合格
20110442,89,48,18,68,21,244,不合格
20110443,35,68,23,42,18,186,不合格
20110444,13,39,57,8,86,203,不合格
20110445,37,79,11,12,22,161,不合格
20110446,50,62,52,98,54,316,合格
20110447,50,68,6,32,62,218,不合格
20110448,94,90,64,17,65,330,合格
20110449,39,39,45,81,33,237,不合格
20110450,60,43,68,7,78,256,不合格
20110451,68,92,51,0,85,296,不合格
20110452,86,73,84,17,39,299,不合格
20110453,38,66,22,34,64,224,不合格
20110454,21,39,0,11,0,71,不合格
20110455,49,90,79,70,66,354,合格
20110456,71,95,22,49,62,299,不合格
20110457,64,2,66,13,86,231,不合格
20110458,94,40,78,18,99,329,合格
20110459,91,74,98,32,32,327,合格
20110460,16,35,94,38,24,207,不合格
20110461,81,12,4,48,48,193,不合格
20110462,5,92,51,75,48,271,不合格
20110463,51,36,43,46,46,222,不合格
20110464,0,1,97,92,31,221,不合格
20110465,36,81,80,48,81,326,合格
20110466,66,73,40,65,79,323,合格
20110467,67,75,17,63,51,273,不合格
20110468,19,83,69,92,96,359,合格
20110469,97,67,98,7,26,295,不合格
20110470,40,91,22,47,61,261,不合格
20110471,58,81,11,1,79,230,不合格
20110472,94,70,11,9,12,196,不合格
20110473,55,46,99,74,91,365,合格
20110474,70,61,97,84,8,320,合格
20110475,47,31,8,72,15,173,不合格
20110476,57,9,93,5,0,164,不合格
20110477,88,74,70,59,44,335,合格
20110478,72,98,63,55,29,317,合格
20110479,86,42,63,39,59,289,不合格
20110480,54,12,63,53,47,229,不合格
20110481,14,22,97,69,86,288,不合格
20110482,14,68,23,41,98,244,不合格
20110483,58,67,59,83,68,335,合格
20110484,57,27,43,29,20,176,不合格
20110485,75,20,53,33,91,272,不合格
20110486,40,81,44,59,46,270,不合格
20110487,61,41,20,97,85,304,合格
20110488,19,37,80,33,32,201,不合格
20110489,80,54,40,11,43,228,不合格
20110490,44,59,91,88,81,363,合格
20110491,76,93,66,37,76,348,合格
20110492,59,58,6,47,29,199,不合格
20110493,66,28,61,42,38,235,不合格
20110494,45,75,96,90,85,391,合格
20110495,87,86,88,33,93,387,合格
20110496,2,24,82,58,31,197,不合格
20110497,14,52,20,65,6,157,不合格
20110498,16,37,95,48,17,213,不合格
20110499,69,34,22,30,49,204,不合格
20110500,43,27,36,31,2,139,不合格
20110501,65,64,20,54,50,253,不合格
20110502,54,21,69,85,3,232,不合格
20110503,97,71,15,65,86,334,合格
20110504,68,98,94,36,64,360,合格
20110505,75,57,17,8,20,177,不合格
20110506,52,32,99,66,53,302,合格
20110507,55,97,45,52,34,283,不合格
20110508,57,91,8,47,15,218,不合格
20110509,88,83,87,64,55,377,合格
20110510,84,46,18,15,2,165,不合格
20110511,52,15,66,66,5,204,不合格
20110512,24,88,67,45,27,251,不合格
20110513,62,98,64,24,62,310,合格
20110514,44,81,95,31,87,338,合格
20110515,37,52,28,42,6,165,不合格
20110516,63,28,26,48,90,255,不合格
20110517,84,48,26,81,97,336,合格
20110518,29,6,39,83,35,192,不合格
20110519,47,75,86,94,83,385,合格
20110520,31,53,88,13,29,214,不合格
20110521,47,78,35,14,85,259,不合格
20110522,4,28,45,86,82,245,不合格
20110523,2,18,62,43,60,185,不合格
20110524,90,71,40,64,98,363,合格
20110525,57,51,66,30,52,256,不合格
20110526,59,23,52,36,50,220,不合格
20110527,33,3,32,93,55,216,不合格
20110528,48,22,23,4,87,184,不合格
20110529,41,3,88,96,17,245,不合格
20110530,71,20,37,60,89,277,不合格
20110531,65,20,42,34,44,205,不合格
20110532,68,34,67,95,52,316,合格
20110533,22,55,49,18,78,222,不合格
20110534,61,77,7,75,90,310,合格
20110535,80,48,26,48,35,237,不合格
20110536,16,96,42,62,68,284,不合格
20110537,69,97,31,80,45,322,合格
20110538,5,41,50,1,82,179,不合格
20110539,7,98,48,28,13,194,不合格
20110540,42,8,98,77,30,255,不合格
20110541,51,16,28,38,54,187,不合格
20110542,89,8,98,85,49,329,合格
20110543,15,55,4,56,56,186,不合格
20110544,41,73,91,95,16,316,合格
20110545,81,74,1,17,67,240,不合格
20110546,17,68,79,49,89,302,合格
20110547,92,16,89,31,45,273,不合格
20110548,71,84,37,33,76,301,合格
20110549,94,47,19,98,47,305,合格
20110550,94,19,51,75,63,302,合格
20110551,71,55,92,63,82,363,合格
20110552,53,20,94,40,22,229,不合格
20110553,45,81,74,68,82,350,合格
20110554,39,40,26,14,10,129,不合格
20110555,82,82,42,77,95,378,合格
20110556,33,54,5,3,18,113,不合格
20110557,59,93,29,10,0,191,不合格
20110558,59,59,74,44,56,292,不合格
20110559,61,71,30,25,65,252,不合格
20110560,49,75,93,27,62,306,合格
20110561,94,36,0,12,29,171,不合格
20110562,26,36,55,65,44,226,不合格
20110563,80,53,96,53,30,312,合格
20110564,43,65,1,83,87,279,不合格
20110565,43,7,47,76,16,189,不合格
20110566,21,60,28,33,92,234,不合格
20110567,63,57,93,48,94,355,合格
20110568,21,2,81,3,6,113,不合格
20110569,58,49,57,49,69,282,不合格
20110570,69,21,81,30,79,280,不合格
20110571,1,15,91,88,23,218,不合格
20110572,47,13,36,86,14,196,不合格
20110573,50,44,88,98,69,349,合格
20110574,67,13,29,5,75,189,不合格
20110575,16,87,99,67,33,302,合格
20110576,39,20,33,31,31,154,不合格
20110577,51,86,39,70,15,261,不合格
20110578,63,84,20,79,74,320,合格
20110579,4,10,97,6,23,140,不合格
20110580,44,3,1,65,75,188,不合格
20110581,39,15,1,25,91,171,不合格
20110582,50,41,83,2,92,268,不合格
20110583,49,84,37,73,71,314,合格
20110584,95,59,58,35,55,302,合格
20110585,99,71,44,71,55,340,合格
20110586,33,19,6,65,65,188,不合格
20110587,49,31,86,40,44,250,不合格
20110588,87,37,74,22,11,231,不合格
20110589,60,69,61,15,12,217,不合格
20110590,27,13,47,66,21,174,不合格
20110591,18,4,40,7,9,78,不合格
20110592,18,78,99,40,49,284,不合格
20110593,59,44,22,29,59,213,不合格
20110594,2,42,65,48,72,229,不合格
20110595,99,89,65,66,60,379,合格
20110596,7,29,48,46,3,133,不合格
20110597,36,58,45,47,6,192,不合格
20110598,10,94,88,90,22,304,合格
20110599,5,33,73,35,63,209,不合格
20110600,67,9,76,76,2,230,不合格
20110601,67,11,19,63,31,191,不合格
20110602,81,56,98,64,39,338,合格
20110603,85,39,99,2,58,283,不合格
20110604,97,54,61,38,94,344,合格
20110605,5,71,88,5,22,191,不合格
20110606,2,67,37,83,42,231,不合格
20110607,62,94,12,37,89,294,不合格
20110608,59,77,12,83,76,307,合格
20110609,79,34,35,42,77,267,不合格
20110610,84,74,44,72,6,280,不合格
20110611,69,51,95,59,84,358,合格
20110612,54,72,49,30,94,299,不合格
20110613,31,74,55,4,69,233,不合格
20110614,10,20,21,38,70,159,不合格
20110615,50,39,89,77,95,350,合格
20110616,44,57,80,26,72,279,不合格
20110617,31,46,37,26,79,219,不合格
20110618,37,85,6,31,14,173,不合格
20110619,24,70,65,59,53,271,不合格
20110620,54,19,42,92,8,215,不合格
20110621,8,38,11,83,71,211,不合格
20110622,81,20,54,32,76,263,不合格
20110623,67,65,33,5,60,230,不合格
20110624,5,65,2,87,18,177,不合格
20110625,9,6,35,68,79,197,不合格
20110626,87,97,33,56,91,364,合格
20110627,55,6,94,38,94,287,不合格
20110628,73,9,98,37,81,298,不合格
20110629,66,95,2,73,81,317,合格
20110630,66,60,72,6,83,287,不合格
20110631,89,45,69,9,72,284,不合格
20110632,87,68,2,77,27,261,不合格
20110633,67,60,36,15,75,253,不合格
20110634,57,23,32,63,1,176,不合格
20110635,65,99,24,51,8,247,不合格
20110636,9,13,73,48,36,179,不合格
20110637,85,62,11,73,8,239,不合格
20110638,24,18,55,31,30,158,不合格
20110639,82,45,45,62,33,267,不合格
20110640,17,41,53,73,98,282,不合格
20110641,13,32,46,79,19,189,不合格
20110642,85,44,93,6,66,294,不合格
20110643,77,90,55,83,31,336,合格
20110644,61,50,64,81,39,295,不合格
20110645,44,35,40,64,84,267,不合格
20110646,59,78,10,17,13,177,不合格
20110647,39,94,21,32,49,235,不合格
20110648,80,95,90,27,77,369,合格
20110649,9,91,86,27,65,278,不合格
20110650,59,39,44,56,89,287,不合格
20110651,9,80,65,18,42,214,不合格
20110652,29,57,74,28,2,190,不合格
20110653,42,15,32,49,54,192,不合格
20110654,42,24,73,15,57,211,不合格
20110655,83,15,69,45,86,298,不合格
20110656,88,97,0,85,37,307,合格
20110657,68,39,32,70,44,253,不合格
20110658,97,20,46,52,17,232,不合格
20110659,23,24,35,76,74,232,不合格
20110660,61,45,2,13,92,213,不合格
20110661,80,9,15,86,53,243,不合格
20110662,29,64,29,15,61,198,不合格
20110663,59,13,49,81,80,282,不合格
20110664,1,1,17,84,31,134,不合格
20110665,48,19,39,6,47,159,不合格
20110666,99,72,4,70,9,254,不合格
20110667,50,86,42,42,77,297,不合格
20110668,19,63,37,17,71,207,不合格
20110669,65,74,80,89,31,339,合格
20110670,72,34,49,42,64,261,不合格
20110671,4,91,92,55,74,316,合格
20110672,7,87,67,14,90,265,不合格
20110673,68,31,1,47,7,154,不合格
20110674,34,31,1,27,78,171,不合格
20110675,9,48,98,6,62,223,不合格
20110676,31,23,39,35,37,165,不合格
20110677,16,47,53,20,88,224,不合格
20110678,22,5,13,73,32,145,不合格
20110679,92,13,78,70,50,303,合格
20110680,71,54,58,93,41,317,合格
20110681,13,65,29,91,52,250,不合格
20110682,78,95,9,90,66,338,合格
20110683,47,70,79,11,55,262,不合格
20110684,73,49,9,71,71,273,不合格
20110685,1,62,29,91,49,232,不合格
20110686,53,23,69,86,39,270,不合格
20110687,3,88,21,28,53,193,不合格
20110688,66,86,7,13,0,172,不合格
20110689,56,86,48,95,79,364,合格
20110690,27,75,99,6,49,256,不合格
20110691,90,69,48,15,38,260,不合格
20110692,69,1,27,64,12,173,不合格
20110693,12,63,21,72,42,210,不合格
20110694,68,15,12,0,22,117,不合格
20110695,70,79,39,86,56,330,合格
20110696,92,47,35,42,55,271,不合格
20110697,37,1,24,75,44,181,不合格
20110698,85,86,47,65,29,312,合格
20110699,26,42,20,97,20,205,不合格
20110700,24,2,21,67,90,204,不合格
20110701,69,66,95,93,19,342,合格
20110702,28,63,39,46,24,200,不合格
20110703,38,29,74,49,8,198,不合格
20110704,75,96,23,14,10,218,不合格
20110705,56,32,45,69,66,268,不合格
20110706,30,97,12,81,36,256,不合格
20110707,80,60,6,44,85,275,不合格
20110708,34,68,92,13,98,305,合格
20110709,17,6,20,66,73,182,不合格
20110710,22,70,40,11,95,238,不合格
20110711,37,5,33,52,40,167,不合格
20110712,47,34,99,24,86,290,不合格
20110713,74,38,92,43,17,264,不合格
20110714,36,8,71,36,37,188,不合格
20110715,3,45,83,40,44,215,不合格
20110716,44,49,70,23,66,252,不合格
20110717,3,46,92,77,82,300,合格
20110718,64,16,3,21,40,144,不合格
20110719,1,5,11,63,37,117,不合格
20110720,43,15,72,34,72,236,不合格
20110721,60,83,87,6,78,314,合格
20110722,8,23,55,77,87,250,不合格
20110723,81,59,37,68,80,325,合格
20110724,61,41,91,92,31,316,合格
20110725,30,82,81,75,44,312,合格
20110726,62,11,52,26,4,155,不合格
20110727,71,13,17,73,90,264,不合格
20110728,77,51,54,61,16,259,不合格
20110729,96,26,36,31,35,224,不合格
20110730,76,19,20,61,90,266,不合格
20110731,27,41,16,66,40,190,不合格
20110732,32,65,56,76,56,285,不合格
20110733,32,85,62,56,36,271,不合格
20110734,85,31,55,39,97,307,合格
20110735,10,47,73,85,51,266,不合格
20110736,68,73,47,76,36,300,合格
20110737,69,54,14,82,53,272,不合格
20110738,12,64,94,23,36,229,不合格
20110739,67,94,13,68,12,254,不合格
20110740,96,71,50,49,69,335,合格
20110741,3,6,26,25,45,105,不合格
20110742,3,51,81,17,12,164,不合格
20110743,96,75,57,46,60,334,合格
20110744,93,89,60,89,31,362,合格
20110745,29,7,5,12,50,103,不合格
20110746,68,83,1,76,95,323,合格
20110747,51,51,45,78,11,236,不合格
20110748,82,5,27,96,37,247,不合格
20110749,32,59,33,23,18,165,不合格
20110750,64,75,6,49,93,287,不合格
20110751,45,72,29,49,98,293,不合格
20110752,49,57,96,28,74,304,合格
20110753,7,29,82,20,62,200,不合格
20110754,91,86,55,93,50,375,合格
20110755,40,26,59,53,13,191,不合格
20110756,4,57,40,97,85,283,不合格
20110757,81,98,16,99,76,370,合格
20110758,2,20,34,68,75,199,不合格
20110759,92,66,37,91,62,348,合格
20110760,7,38,41,85,54,225,不合格
20110761,90,74,86,40,20,310,合格
20110762,33,33,74,66,37,243,不合格
20110763,58,6,7,87,6,164,不合格
20110764,86,61,90,46,58,341,合格
20110765,32,83,68,76,83,342,合格
20110766,57,40,45,98,77,317,合格
20110767,57,86,49,91,92,375,合格
20110768,96,16,58,4,95,269,不合格
20110769,11,36,5,84,25,161,不合格
20110770,29,68,34,5,92,228,不合格
20110771,71,23,95,2,3,194,不合格
20110772,65,2,62,91,80,300,合格
20110773,96,71,44,14,29,254,不合格
20110774,36,93,6,19,42,196,不合格
20110775,2,68,32,22,53,177,不合格
20110776,65,92,75,50,63,345,合格
20110777,35,44,26,97,61,263,不合格
20110778,72,50,37,68,57,284,不合格
20110779,71,45,93,52,14,275,不合格
20110780,89,1,50,95,55,290,不合格
20110781,27,91,58,87,81,344,合格
20110782,99,62,63,4,86,314,合格
20110783,26,57,82,64,45,274,不合格
20110784,67,47,29,76,79,298,不合格
20110785,14,50,12,38,27,141,不合格
20110786,45,14,50,92,56,257,不合格
20110787,73,22,4,39,3,141,不合格
20110788,1,10,34,94,68,207,不合格
20110789,87,77,11,71,11,257,不合格
20110790,22,55,31,26,20,154,不合格
20110791,37,60,88,11,42,238,不合格
20110792,21,11,4,22,41,99,不合格
20110793,40,56,15,26,27,164,不合格
20110794,49,75,40,56,72,292,不合格
20110795,99,19,59,80,40,297,不合格
20110796,8,40,22,52,95,217,不合格
20110797,50,84,58,28,20,240,不合格
20110798,88,43,31,85,37,284,不合格
20110799,53,9,75,41,75,253,不合格
20110800,63,16,6,94,57,236,不合格
20110801,59,42,27,62,50,240,不合格
20110802,36,0,19,83,9,147,不合格
20110803,1,73,58,63,17,212,不合格
20110804,9,12,46,88,55,210,不合格
20110805,50,95,34,15,43,237,不合格
20110806,31,90,0,32,34,187,不合格
20110807,9,57,97,82,77,322,合格
20110808,30,88,87,42,56,303,合格
20110809,77,45,37,6,91,256,不合格
20110810,17,67,48,57,14,203,不合格
20110811,52,55,82,45,5,239,不合格
20110812,56,8,30,37,64,195,不合格
20110813,93,85,3,76,22,279,不合格
20110814,78,97,54,43,53,325,合格
20110815,78,99,76,53,98,404,合格
20110816,86,55,1,46,62,250,不合格
20110817,84,32,42,85,50,293,不合格
20110818,6,48,94,68,27,243,不合格
20110819,23,24,7,95,31,180,不合格
20110820,57,81,0,67,26,231,不合格
20110821,19,95,58,87,73,332,合格
20110822,97,93,65,96,33,384,合格
20110823,44,82,52,98,43,319,合格
20110824,62,81,22,80,73,318,合格
20110825,27,51,18,93,4,193,不合格
20110826,92,70,95,26,47,330,合格
20110827,21,53,24,9,21,128,不合格
20110828,33,62,51,78,98,322,合格
20110829,39,21,93,79,4,236,不合格
20110830,15,60,85,96,9,265,不合格
20110831,36,10,90,32,9,177,不合格
20110832,97,84,8,33,81,303,合格
20110833,95,31,65,44,41,276,不合格
20110834,41,99,87,30,83,340,合格
20110835,45,95,39,13,7,199,不合格
20110836,56,5,66,44,5,176,不合格
20110837,13,40,34,12,10,109,不合格
20110838,29,89,48,52,4,222,不合格
20110839,41,15,22,91,85,254,不合格
20110840,23,56,55,90,6,230,不合格
20110841,92,81,49,33,5,260,不合格
20110842,49,86,21,9,87,252,不合格
20110843,58,53,19,91,32,253,不合格
20110844,83,32,55,72,89,331,合格
20110845,73,5,43,64,88,273,不合格
20110846,37,48,32,17,87,221,不合格
20110847,71,17,22,96,59,265,不合格
20110848,14,9,3,80,1,107,不合格
20110849,10,28,69,71,90,268,不合格
20110850,96,15,69,45,5,230,不合格
20110851,4,98,56,26,58,242,不合格
20110852,52,37,53,64,1,207,不合格
20110853,27,85,94,43,71,320,合格
20110854,80,86,76,44,92,378,合格
20110855,75,72,17,10,37,211,不合格
20110856,26,93,89,93,74,375,合格
20110857,69,93,30,15,53,260,不合格
20110858,44,93,90,35,52,314,合格
20110859,41,52,7,32,86,218,不合格
20110860,60,55,52,74,82,323,合格
20110861,79,40,24,87,33,263,不合格
20110862,66,21,68,5,11,171,不合格
20110863,50,33,72,40,49,244,不合格
20110864,74,80,48,99,24,325,合格
20110865,92,17,54,81,47,291,不合格
20110866,59,28,73,99,68,327,合格
20110867,29,29,36,39,76,209,不合格
20110868,33,84,82,9,73,281,不合格
20110869,58,38,7,22,29,154,不合格
20110870,77,52,24,52,56,261,不合格
20110871,10,64,90,24,9,197,不合格
20110872,92,44,4,85,38,263,不合格
20110873,96,16,55,85,10,262,不合格
20110874,88,16,90,80,20,294,不合格
20110875,84,60,64,19,84,311,合格
20110876,26,40,52,6,9,133,不合格
20110877,41,11,20,89,74,235,不合格
20110878,66,40,10,74,76,266,不合格
20110879,82,76,82,35,28,303,合格
20110880,32,34,85,12,85,248,不合格
20110881,52,82,80,8,50,272,不合格
20110882,74,83,59,27,21,264,不合格
20110883,36,29,21,79,85,250,不合格
20110884,38,77,86,30,73,304,合格
20110885,7,39,55,36,22,159,不合格
20110886,68,72,1,3,19,163,不合格
20110887,64,35,87,88,65,339,合格
20110888,29,7,50,51,56,193,不合格
20110889,71,4,51,82,97,305,合格
20110890,16,64,86,51,32,249,不合格
20110891,10,91,89,1,9,200,不合格
20110892,58,88,79,63,76,364,合格
20110893,68,57,9,0,53,187,不合格
20110894,77,68,33,12,45,235,不合格
20110895,79,71,99,88,78,415,合格
20110896,76,59,1,75,49,260,不合格
20110897,19,5,17,53,83,177,不合格
20110898,70,36,38,97,29,270,不合格
20110899,71,14,32,37,51,205,不合格
20110900,93,12,1,91,70,267,不合格
20110901,24,74,49,27,94,268,不合格
20110902,39,35,57,21,22,174,不合格
20110903,22,27,77,14,27,167,不合格
20110904,15,52,74,0,58,199,不合格
20110905,47,74,95,45,30,291,不合格
20110906,7,96,75,87,30,295,不合格
20110907,28,54,89,37,89,297,不合格
20110908,67,75,91,53,64,350,合格
20110909,74,39,51,76,20,260,不合格
20110910,87,40,50,84,66,327,合格
20110911,65,24,44,24,87,244,不合格
20110912,63,7,79,70,74,293,不合格
20110913,58,43,58,64,27,250,不合格
20110914,81,20,82,92,22,297,不合格
20110915,2,1,54,43,82,182,不合格
20110916,47,68,67,72,95,349,合格
20110917,14,8,24,41,81,168,不合格
20110918,89,20,93,46,5,253,不合格
20110919,33,91,10,5,48,187,不合格
20110920,41,19,80,72,6,218,不合格
20110921,17,27,6,95,74,219,不合格
20110922,42,51,47,92,17,249,不合格
20110923,51,47,36,56,87,277,不合格
20110924,87,10,24,72,73,266,不合格
20110925,85,29,82,22,37,255,不合格
20110926,50,75,45,83,91,344,合格
20110927,57,11,93,65,89,315,合格
20110928,67,0,80,40,72,259,不合格
20110929,25,67,7,56,88,243,不合格
20110930,21,13,79,46,53,212,不合格
20110931,87,60,32,61,52,292,不合格
20110932,27,23,20,46,77,193,不合格
20110933,28,32,41,2,75,178,不合格
20110934,28,26,6,26,59,145,不合格
20110935,53,67,67,25,51,263,不合格
20110936,9,80,66,36,92,283,不合格
20110937,80,99,76,60,58,373,合格
20110938,56,57,16,67,90,286,不合格
20110939,26,60,14,23,39,162,不合格
20110940,69,73,82,76,68,368,合格
20110941,92,48,93,13,85,331,合格
20110942,24,43,42,6,69,184,不合格
20110943,55,94,17,39,33,238,不合格
20110944,13,43,84,16,70,226,不合格
20110945,41,75,51,76,34,277,不合格
20110946,48,95,76,33,31,283,不合格
20110947,15,83,59,13,32,202,不合格
20110948,39,74,7,15,82,217,不合格
20110949,80,37,61,11,84,273,不合格
20110950,78,50,45,0,70,243,不合格
20110951,36,36,33,58,57,220,不合格
20110952,50,64,42,45,68,269,不合格
20110953,39,71,7,19,44,180,不合格
20110954,28,50,99,27,29,233,不合格
20110955,53,55,31,35,28,202,不合格
20110956,99,43,44,87,22,295,不合格
20110957,44,3,20,14,58,139,不合格
20110958,32,22,29,44,5,132,不合格
20110959,21,60,73,33,18,205,不合格
20110960,5,77,82,50,30,244,不合格
20110961,84,0,82,49,89,304,合格
20110962,83,48,40,40,9,220,不合格
20110963,10,99,16,68,18,211,不合格
20110964,48,5,18,36,30,137,不合格
20110965,61,35,93,13,59,261,不合格
20110966,94,76,14,33,94,311,合格
20110967,79,29,85,59,86,338,合格
20110968,11,26,42,81,10,170,不合格
20110969,3,62,70,64,61,260,不合格
20110970,35,65,29,45,35,209,不合格
20110971,32,88,75,53,34,282,不合格
20110972,35,35,79,85,54,288,不合格
20110973,1,57,94,51,15,218,不合格
20110974,72,23,28,0,0,123,不合格
20110975,32,51,17,77,17,194,不合格
20110976,85,62,67,57,89,360,合格
20110977,76,25,32,98,78,309,合格
20110978,3,34,87,15,45,184,不合格
20110979,22,26,4,8,40,100,不合格
20110980,86,66,24,62,59,297,不合格
20110981,56,44,87,44,22,253,不合格
20110982,64,30,94,7,33,228,不合格
20110983,81,11,81,40,68,281,不合格
20110984,32,1,70,88,90,281,不合格
20110985,10,45,7,90,7,159,不合格
20110986,73,73,99,31,13,289,不合格
20110987,31,74,41,70,61,277,不合格
20110988,39,54,15,41,13,162,不合格
20110989,95,95,26,38,26,280,不合格
20110990,54,42,32,58,90,276,不合格
20110991,13,52,56,19,50,190,不合格
20110992,81,27,34,44,93,279,不合格
20110993,68,58,46,13,90,275,不合格
20110994,81,45,87,78,62,353,合格
20110995,11,28,37,78,47,201,不合格
20110996,31,94,53,22,5,205,不合格
20110997,14,40,36,70,52,212,不合格
20110998,5,60,48,5,19,137,不合格
20110999,38,40,15,91,74,258,不合格
20111000,19,63,15,59,27,183,不合格
20111001,84,84,53,79,70,370,合格
20111002,62,98,95,40,67,362,合格
20111003,31,10,29,88,0,158,不合格
20111004,76,18,26,91,60,271,不合格
20111005,1,51,91,88,67,298,不合格
20111006,29,97,79,47,76,328,合格
20111007,67,64,0,73,72,276,不合格
20111008,32,74,37,53,25,221,不合格
20111009,65,38,48,38,79,268,不合格
20111010,12,76,23,59,52,222,不合格
20111011,32,64,38,16,72,222,不合格
20111012,91,16,85,2,82,276,不合格
20111013,73,44,92,96,76,381,合格
20111014,12,4,67,46,9,138,不合格
20111015,76,28,60,72,16,252,不合格
20111016,91,91,75,97,21,375,合格
20111017,24,60,20,80,21,205,不合格
20111018,67,78,74,60,16,295,不合格
20111019,22,71,72,59,14,238,不合格
20111020,18,36,95,33,23,205,不合格
20111021,75,13,9,93,49,239,不合格
20111022,44,84,41,22,6,197,不合格
20111023,72,79,30,31,94,306,合格
20111024,42,90,33,8,86,259,不合格
20111025,83,93,4,22,35,237,不合格
20111026,29,36,44,16,76,201,不合格
20111027,74,58,43,75,24,274,不合格
20111028,51,12,82,98,93,336,合格
20111029,72,91,27,33,63,286,不合格
20111030,3,17,30,92,81,223,不合格
20111031,83,44,95,30,75,327,合格
20111032,89,32,8,97,28,254,不合格
20111033,59,30,51,33,37,210,不合格
20111034,65,96,67,21,15,264,不合格
20111035,49,83,62,42,49,285,不合格
20111036,60,30,42,73,86,291,不合格
20111037,52,59,0,7,51,169,不合格
20111038,86,9,96,7,90,288,不合格
20111039,62,44,34,80,2,222,不合格
20111040,87,63,88,26,4,268,不合格
20111041,80,41,18,95,87,321,合格
20111042,69,49,89,8,69,284,不合格
20111043,40,42,22,77,47,228,不合格
20111044,17,90,17,98,32,254,不合格
20111045,35,60,78,9,13,195,不合格
20111046,26,34,94,67,93,314,合格
20111047,21,34,78,5,30,168,不合格
20111048,54,23,91,12,87,267,不合格
20111049,53,30,89,15,81,268,不合格
20111050,17,62,41,11,83,214,不合格
20111051,59,55,76,90,61,341,合格
20111052,69,85,44,97,40,335,合格
20111053,52,89,78,25,29,273,不合格
20111054,9,33,96,87,13,238,不合格
20111055,64,72,37,35,45,253,不合格
20111056,92,36,14,47,61,250,不合格
20111057,65,44,69,88,60,326,合格
20111058,22,17,81,94,40,254,不合格
20111059,96,75,7,72,54,304,合格
20111060,85,15,78,71,72,321,合格
20111061,64,80,12,67,23,246,不合格
20111062,81,58,12,66,10,227,不合格
20111063,0,55,12,20,44,131,不合格
20111064,83,63,97,46,45,334,合格
20111065,4,53,66,92,83,298,不合格
20111066,29,86,77,62,73,327,合格
20111067,48,3,4,51,72,178,不合格
20111068,26,66,34,11,93,230,不合格
20111069,89,35,67,83,97,371,合格
20111070,4,85,77,29,56,251,不合格
20111071,37,97,8,23,0,165,不合格
20111072,95,79,26,99,23,322,合格
20111073,75,43,48,69,96,331,合格
20111074,81,81,88,69,80,399,合格
20111075,80,70,90,85,49,374,合格
20111076,2,95,42,44,60,243,不合格
20111077,96,3,36,50,13,198,不合格
20111078,25,15,47,43,55,185,不合格
20111079,55,93,43,36,24,251,不合格
20111080,71,83,20,92,3,269,不合格
20111081,12,15,86,20,46,179,不合格
20111082,23,62,41,40,92,258,不合格
20111083,99,58,15,26,8,206,不合格
20111084,46,50,8,15,63,182,不合格
20111085,80,79,10,77,58,304,合格
20111086,13,31,83,42,14,183,不合格
20111087,23,74,0,22,11,130,不合格
20111088,82,33,51,99,63,328,合格
20111089,92,70,70,36,20,288,不合格
20111090,46,39,35,37,80,237,不合格
20111091,81,79,34,22,59,275,不合格
20111092,83,8,46,75,91,303,合格
20111093,36,82,20,87,92,317,合格
20111094,19,31,90,54,52,246,不合格
20111095,82,88,18,67,2,257,不合格
20111096,25,22,36,60,32,175,不合格
20111097,58,22,3,55,4,142,不合格
20111098,53,40,61,12,50,216,不合格
20111099,65,5,61,14,10,155,不合格
20111100,24,27,92,34,98,275,不合格
20111101,55,28,3,37,65,188,不合格
20111102,0,12,35,56,43,146,不合格
20111103,73,42,9,38,84,246,不合格
20111104,73,43,47,17,98,278,不合格
20111105,34,22,22,33,53,164,不合格
20111106,70,37,44,32,46,229,不合格
20111107,14,22,1,70,11,118,不合格
20111108,43,91,86,27,0,247,不合格
20111109,66,92,95,82,44,379,合格
20111110,75,93,42,96,37,343,合格
20111111,61,16,62,12,29,180,不合格
20111112,10,10,61,68,67,216,不合格
20111113,19,36,89,41,82,267,不合格
20111114,32,76,5,47,9,169,不合格
20111115,61,59,98,10,0,228,不合格
20111116,57,56,23,7,54,197,不合格
20111117,35,29,91,25,91,271,不合格
20111118,87,41,13,7,23,171,不合格
20111119,39,3,63,97,82,284,不合格
20111120,25,93,9,72,97,296,不合格
20111121,40,52,13,67,98,270,不合格
20111122,62,81,8,28,91,270,不合格
20111123,67,42,40,58,87,294,不合格
20111124,0,81,34,34,7,156,不合格
20111125,83,23,90,52,27,275,不合格
20111126,73,80,13,79,80,325,合格
20111127,42,33,88,0,43,206,不合格
20111128,33,47,11,95,3,189,不合格
20111129,28,42,70,93,5,238,不合格
20111130,12,97,67,77,54,307,合格
20111131,86,93,37,53,26,295,不合格
20111132,68,26,68,46,98,306,合格
20111133,50,76,68,65,4,263,不合格
20111134,6,36,28,42,88,200,不合格
20111135,40,33,47,13,54,187,不合格
20111136,28,47,33,29,49,186,不合格
20111137,15,47,23,48,13,146,不合格
20111138,77,27,50,32,80,266,不合格
20111139,31,27,22,40,35,155,不合格
20111140,83,90,84,24,5,286,不合格
20111141,43,2,13,64,37,159,不合格
20111142,59,77,59,66,20,281,不合格
20111143,79,7,32,33,15,166,不合格
20111144,29,61,80,77,90,337,合格
20111145,33,57,29,47,36,202,不合格
20111146,14,52,52,71,33,222,不合格
20111147,60,85,31,21,13,210,不合格
20111148,21,18,41,34,83,197,不合格
20111149,16,40,83,34,78,251,不合格
20111150,79,92,97,33,99,400,合格
20111151,92,71,71,39,70,343,合格
20111152,24,41,35,29,37,166,不合格
20111153,32,55,88,28,51,254,不合格
20111154,39,28,66,89,92,314,合格
20111155,31,96,85,2,51,265,不合格
20111156,73,39,49,39,69,269,不合格
20111157,17,36,95,49,19,216,不合格
20111158,4,67,16,70,89,246,不合格
20111159,85,70,94,82,67,398,合格
20111160,77,56,49,68,64,314,合格
20111161,57,45,18,60,20,200,不合格
20111162,33,45,18,40,18,154,不合格
20111163,70,10,8,43,6,137,不合格
20111164,63,16,66,60,59,264,不合格
20111165,96,94,10,58,93,351,合格
20111166,90,25,65,73,47,300,合格
20111167,50,83,81,12,85,311,合格
20111168,4,95,31,31,63,224,不合格
20111169,27,71,94,24,97,313,合格
20111170,81,54,96,84,16,331,合格
20111171,31,89,71,81,16,288,不合格
20111172,62,5,71,35,7,180,不合格
20111173,33,93,5,92,94,317,合格
20111174,72,28,48,97,12,257,不合格
20111175,28,33,28,44,80,213,不合格
20111176,94,65,67,79,74,379,合格
20111177,86,26,15,63,78,268,不合格
20111178,86,25,74,57,58,300,合格
20111179,91,77,66,95,16,345,合格
20111180,0,44,87,63,75,269,不合格
20111181,29,19,35,1,55,139,不合格
20111182,42,59,2,60,47,210,不合格
20111183,40,76,11,51,20,198,不合格
20111184,18,10,18,55,64,165,不合格
20111185,95,31,79,34,65,304,合格
20111186,54,39,86,37,59,275,不合格
20111187,78,83,25,22,29,237,不合格
20111188,21,29,22,77,95,244,不合格
20111189,72,25,49,79,3,228,不合格
20111190,61,12,57,2,49,181,不合格
20111191,48,36,3,5,96,188,不合格
20111192,81,67,34,0,79,261,不合格
20111193,68,68,70,25,92,323,合格
20111194,26,49,46,10,57,188,不合格
20111195,84,70,70,42,84,350,合格
20111196,58,15,71,1,90,235,不合格
20111197,87,58,1,4,29,179,不合格
20111198,59,15,3,67,17,161,不合格
20111199,0,50,3,91,15,159,不合格
20111200,35,39,47,61,84,266,不合格
20111201,14,15,58,10,79,176,不合格
20111202,91,26,15,45,36,213,不合格
20111203,76,17,94,33,94,314,合格
20111204,54,43,32,85,43,257,不合格
20111205,70,28,53,47,4,202,不合格
20111206,46,87,21,91,1,246,不合格
20111207,44,60,66,75,66,311,合格
20111208,68,5,83,89,58,303,合格
20111209,25,69,45,67,83,289,不合格
20111210,50,21,15,82,6,174,不合格
20111211,98,62,43,38,52,293,不合格
20111212,96,98,22,91,25,332,合格
20111213,25,28,86,98,50,287,不合格
20111214,1,72,34,55,14,176,不合格
20111215,56,47,77,34,6,220,不合格
20111216,4,42,66,62,53,227,不合格
20111217,17,24,82,49,17,189,不合格
20111218,50,86,63,76,15,290,不合格
20111219,17,93,17,81,79,287,不合格
20111220,8,33,31,48,17,137,不合格
20111221,87,92,25,6,13,223,不合格
20111222,91,67,33,0,12,203,不合格
20111223,45,51,41,7,1,145,不合格
20111224,51,79,84,36,60,310,合格
20111225,77,23,80,79,45,304,合格
20111226,87,99,41,30,20,277,不合格
20111227,15,21,56,30,62,184,不合格
20111228,12,56,17,21,66,172,不合格
20111229,16,54,4,68,57,199,不合格
20111230,23,68,74,77,16,258,不合格
20111231,10,79,77,60,3,229,不合格
20111232,30,44,0,24,43,141,不合格
20111233,60,30,27,69,12,198,不合格
20111234,70,40,44,42,18,214,不合格
20111235,8,73,59,64,17,221,不合格
20111236,93,93,51,94,7,338,合格
20111237,48,38,32,95,53,266,不合格
20111238,13,98,96,80,33,320,合格
20111239,66,50,31,4,38,189,不合格
20111240,70,8,89,57,67,291,不合格
20111241,3,87,78,27,63,258,不合格
20111242,71,33,21,95,21,241,不合格
20111243,57,67,52,22,83,281,不合格
20111244,76,27,12,10,16,141,不合格
20111245,81,56,9,95,41,282,不合格
20111246,26,77,70,12,50,235,不合格
20111247,26,1,15,19,42,103,不合格
20111248,23,17,32,35,52,159,不合格
20111249,18,96,8,70,21,213,不合格
20111250,86,65,63,22,68,304,合格
20111251,53,49,22,28,72,224,不合格
20111252,13,14,28,55,0,110,不合格
20111253,17,21,94,9,6,147,不合格
20111254,44,68,98,82,21,313,合格
20111255,48,13,78,21,30,190,不合格
20111256,56,31,7,75,86,255,不合格
20111257,63,52,12,78,15,220,不合格
20111258,69,4,9,71,24,177,不合格
20111259,80,94,68,88,18,348,合格
20111260,29,11,12,13,90,155,不合格
20111261,39,33,86,24,26,208,不合格
20111262,27,35,18,31,35,146,不合格
20111263,28,62,28,67,78,263,不合格
20111264,11,46,10,21,63,151,不合格
20111265,78,4,37,80,86,285,不合格
20111266,69,92,87,42,45,335,合格
20111267,16,48,43,51,37,195,不合格
20111268,39,92,67,17,99,314,合格
20111269,90,46,23,24,80,263,不合格
20111270,87,25,85,60,58,315,合格
20111271,29,36,62,71,55,253,不合格
20111272,25,7,36,24,68,160,不合格
20111273,40,50,98,95,36,319,合格
20111274,84,96,17,2,35,234,不合格
20111275,22,57,48,23,11,161,不合格
20111276,98,88,84,83,62,415,合格
20111277,25,26,26,87,58,222,不合格
20111278,6,45,10,89,22,172,不合格
20111279,51,44,63,62,84,304,合格
20111280,94,54,68,99,45,360,合格
20111281,54,8,45,49,63,219,不合格
20111282,91,82,56,65,68,362,合格
20111283,25,14,0,15,75,129,不合格
20111284,55,13,6,57,79,210,不合格
20111285,23,17,51,87,66,244,不合格
20111286,51,43,90,1,90,275,不合格
20111287,94,16,29,61,34,234,不合格
20111288,38,74,14,28,55,209,不合格
20111289,10,16,89,16,56,187,不合格
20111290,62,21,58,49,83,273,不合格
20111291,76,44,32,8,79,239,不合格
20111292,69,84,76,96,65,390,合格
20111293,38,62,19,25,53,197,不合格
20111294,75,99,49,62,10,295,不合格
20111295,68,0,95,97,72,332,合格
20111296,99,62,53,14,34,262,不合格
20111297,0,19,3,71,73,166,不合格
20111298,17,32,3,38,7,97,不合格
20111299,72,3,54,82,76,287,不合格
20111300,9,44,79,43,49,224,不合格
20111301,56,74,89,70,5,294,不合格
20111302,51,7,50,37,42,187,不合格
20111303,13,3,66,64,89,235,不合格
20111304,27,3,58,47,20,155,不合格
20111305,34,23,73,8,22,160,不合格
20111306,75,22,36,66,70,269,不合格
20111307,3,82,42,99,38,264,不合格
20111308,2,74,65,98,13,252,不合格
20111309,48,39,77,55,90,309,合格
20111310,2,18,3,42,64,129,不合格
20111311,38,80,80,42,50,290,不合格
20111312,76,97,19,98,65,355,合格
20111313,94,85,88,84,39,390,合格
20111314,20,21,35,46,31,153,不合格
20111315,29,39,71,99,78,316,合格
20111316,52,27,39,87,4,209,不合格
20111317,62,17,70,49,61,259,不合格
20111318,3,12,70,68,22,175,不合格
20111319,35,80,25,67,93,300,合格
20111320,83,17,4,10,78,192,不合格
20111321,21,59,63,31,35,209,不合格
20111322,26,0,78,50,42,196,不合格
20111323,23,81,31,80,79,294,不合格
20111324,38,42,14,68,78,240,不合格
20111325,89,6,58,98,1,252,不合格
20111326,52,49,53,72,11,237,不合格
20111327,72,44,25,91,51,283,不合格
20111328,72,61,58,46,28,265,不合格
20111329,45,99,91,61,18,314,合格
20111330,29,49,42,17,15,152,不合格
20111331,32,92,17,38,65,244,不合格
20111332,17,37,18,61,74,207,不合格
20111333,65,21,89,75,14,264,不合格
20111334,60,22,73,88,70,313,合格
20111335,73,44,2,47,5,171,不合格
20111336,65,3,0,13,19,100,不合格
20111337,39,11,13,8,11,82,不合格
20111338,45,22,87,10,74,238,不合格
20111339,95,83,62,87,1,328,合格
20111340,27,56,42,24,48,197,不合格
20111341,37,81,82,15,26,241,不合格
20111342,21,70,91,20,63,265,不合格
20111343,25,44,78,32,70,249,不合格
20111344,26,53,12,90,23,204,不合格
20111345,6,62,84,38,53,243,不合格
20111346,35,53,46,64,37,235,不合格
20111347,48,19,15,91,36,209,不合格
20111348,61,85,36,73,53,308,合格
20111349,31,93,42,52,62,280,不合格
20111350,29,32,13,17,13,104,不合格
20111351,20,70,9,83,43,225,不合格
20111352,16,37,15,82,28,178,不合格
20111353,6,70,95,94,37,302,合格
20111354,3,10,72,63,75,223,不合格
20111355,28,37,30,77,80,252,不合格
20111356,73,68,21,62,31,255,不合格
20111357,71,12,85,37,32,237,不合格
20111358,90,99,57,83,94,423,合格
20111359,36,77,9,73,7,202,不合格
20111360,85,35,28,87,43,278,不合格
20111361,48,74,33,85,26,266,不合格
20111362,70,58,61,69,92,350,合格
20111363,78,92,96,61,41,368,合格
20111364,39,96,51,48,91,325,合格
20111365,5,99,39,93,86,322,合格
20111366,35,76,98,93,15,317,合格
20111367,32,94,34,12,5,177,不合格
20111368,25,43,21,85,72,246,不合格
20111369,72,50,72,66,49,309,合格
20111370,22,44,54,61,88,269,不合格
20111371,81,84,11,82,55,313,合格
20111372,3,94,31,84,47,259,不合格
20111373,41,70,61,59,7,238,不合格
20111374,79,3,2,45,74,203,不合格
20111375,53,24,26,44,5,152,不合格
20111376,8,33,49,43,64,197,不合格
20111377,49,46,4,46,89,234,不合格
20111378,1,95,1,24,31,152,不合格
20111379,6,22,23,26,65,142,不合格
20111380,23,27,95,14,40,199,不合格
20111381,2,66,1,28,55,152,不合格
20111382,33,90,23,25,78,249,不合格
20111383,36,82,3,37,65,223,不合格
20111384,22,38,33,9,9,111,不合格
20111385,35,38,9,68,63,213,不合格
20111386,38,17,68,18,25,166,不合格
20111387,35,89,27,64,88,303,合格
20111388,38,12,14,80,30,174,不合格
20111389,8,38,48,3,60,157,不合格
20111390,68,89,35,75,95,362,合格
20111391,39,66,6,63,43,217,不合格
20111392,7,29,43,90,5,174,不合格
20111393,3,52,95,68,53,271,不合格
20111394,16,90,5,14,25,150,不合格
20111395,43,51,25,74,12,205,不合格
20111396,64,28,66,40,89,287,不合格
20111397,9,60,67,56,43,235,不合格
20111398,31,86,63,83,91,354,合格
20111399,82,2,0,5,3,92,不合格
20111400,85,45,26,3,34,193,不合格
20111401,12,40,48,49,7,156,不合格
20111402,25,97,40,15,59,236,不合格
20111403,32,95,95,79,24,325,合格
20111404,5,81,30,91,96,303,合格
20111405,18,67,66,53,49,253,不合格
20111406,88,35,42,52,69,286,不合格
20111407,55,75,10,32,28,200,不合格
20111408,94,1,86,53,79,313,合格
20111409,59,55,77,36,9,236,不合格
20111410,98,66,36,10,98,308,合格
20111411,78,42,12,33,86,251,不合格
20111412,47,20,83,44,59,253,不合格
20111413,7,70,50,49,78,254,不合格
20111414,3,6,91,9,80,189,不合格
20111415,89,25,81,8,29,232,不合格
20111416,70,24,97,92,55,338,合格
20111417,4,3,52,22,49,130,不合格
20111418,8,40,86,60,40,234,不合格
20111419,75,9,62,81,66,293,不合格
20111420,55,33,18,36,66,208,不合格
20111421,31,5,65,40,4,145,不合格
20111422,40,5,79,14,98,236,不合格
20111423,52,97,55,78,85,367,合格
20111424,16,16,84,98,66,280,不合格
20111425,95,76,25,6,96,298,不合格
20111426,96,44,81,34,94,349,合格
20111427,13,8,52,35,35,143,不合格
20111428,61,75,11,86,43,276,不合格
20111429,25,2,54,69,57,207,不合格
20111430,94,42,91,60,94,381,合格
20111431,81,16,44,39,30,210,不合格
20111432,86,46,24,35,29,220,不合格
20111433,88,95,14,23,50,270,不合格
20111434,94,37,34,16,49,230,不合格
20111435,44,73,20,73,50,260,不合格
20111436,12,52,71,19,18,172,不合格
20111437,90,4,15,16,26,151,不合格
20111438,14,93,37,40,40,224,不合格
20111439,49,48,31,35,64,227,不合格
20111440,66,62,63,80,7,278,不合格
20111441,80,78,37,73,58,326,合格
20111442,78,26,87,14,36,241,不合格
20111443,83,90,21,63,34,291,不合格
20111444,29,36,89,25,33,212,不合格
20111445,11,88,43,19,70,231,不合格
20111446,17,63,90,29,60,259,不合格
20111447,46,29,1,62,29,167,不合格
20111448,86,24,95,37,39,281,不合格
20111449,21,3,77,67,56,224,不合格
20111450,54,69,75,25,60,283,不合格
20111451,89,62,40,30,43,264,不合格
20111452,90,88,88,82,42,390,合格
20111453,22,72,66,60,32,252,不合格
20111454,3,71,85,78,30,267,不合格
20111455,98,54,80,13,74,319,合格
20111456,86,52,46,30,94,308,合格
20111457,2,37,64,10,31,144,不合格
20111458,5,41,83,22,11,162,不合格
20111459,45,98,25,86,67,321,合格
20111460,34,42,49,59,68,252,不合格
20111461,3,52,8,97,34,194,不合格
20111462,21,42,5,7,60,135,不合格
20111463,87,52,67,84,76,366,合格
20111464,35,72,8,88,82,285,不合格
20111465,18,61,10,42,25,156,不合格
20111466,82,36,49,52,81,300,合格
20111467,65,94,75,55,16,305,合格
20111468,16,74,40,3,67,200,不合格
20111469,56,59,58,95,80,348,合格
20111470,18,27,72,77,33,227,不合格
20111471,34,12,56,4,48,154,不合格
20111472,38,49,31,23,70,211,不合格
20111473,20,84,9,65,20,198,不合格
20111474,66,59,65,83,86,359,合格
20111475,77,58,71,3,63,272,不合格
20111476,56,26,85,0,46,213,不合格
20111477,11,73,25,31,55,195,不合格
20111478,79,35,48,23,91,276,不合格
20111479,72,64,95,56,40,327,合格
20111480,66,47,26,68,76,283,不合格
20111481,89,5,1,95,62,252,不合格
20111482,54,54,87,51,66,312,合格
20111483,98,83,28,99,96,404,合格
20111484,74,90,73,22,29,288,不合格
20111485,89,18,99,16,22,244,不合格
20111486,68,94,49,40,9,260,不合格
20111487,37,55,38,76,1,207,不合格
20111488,37,59,96,30,89,311,合格
20111489,98,36,22,87,76,319,合格
20111490,99,89,52,53,23,316,合格
20111491,19,18,3,73,57,170,不合格
20111492,30,24,4,57,24,139,不合格
20111493,13,4,32,90,68,207,不合格
20111494,29,33,75,69,90,296,不合格
20111495,27,96,79,67,35,304,合格
20111496,70,45,77,68,79,339,合格
20111497,38,68,10,21,4,141,不合格
20111498,58,24,58,27,90,257,不合格
20111499,32,36,26,86,94,274,不合格
20111500,17,55,47,64,7,190,不合格
20111501,50,38,28,82,8,206,不合格
20111502,75,41,53,89,0,258,不合格
20111503,88,29,38,17,46,218,不合格
20111504,75,97,67,89,65,393,合格
20111505,29,65,99,20,40,253,不合格
20111506,51,13,77,93,19,253,不合格
20111507,0,23,16,95,78,212,不合格
20111508,59,3,89,33,81,265,不合格
20111509,78,39,21,53,20,211,不合格
20111510,83,8,57,32,18,198,不合格
20111511,5,24,5,25,98,157,不合格
20111512,95,39,82,51,90,357,合格
20111513,21,50,31,5,76,183,不合格
20111514,94,66,94,58,66,378,合格
20111515,70,43,89,67,8,277,不合格
20111516,49,82,98,84,22,335,合格
20111517,36,53,59,32,90,270,不合格
20111518,47,56,28,5,12,148,不合格
20111519,70,47,15,98,97,327,合格
20111520,44,45,5,24,12,130,不合格
20111521,64,53,65,75,91,348,合格
20111522,75,78,20,1,70,244,不合格
20111523,99,51,56,74,60,340,合格
20111524,17,32,33,35,81,198,不合格
20111525,35,66,18,55,54,228,不合格
20111526,17,55,70,47,33,222,不合格
20111527,25,57,17,20,9,128,不合格
20111528,9,92,49,12,47,209,不合格
20111529,55,72,29,72,50,278,不合格
20111530,13,40,10,76,63,202,不合格
20111531,26,18,37,42,66,189,不合格
20111532,85,94,84,78,47,388,合格
20111533,13,10,84,66,17,190,不合格
20111534,91,49,12,29,41,222,不合格
20111535,90,80,24,73,76,343,合格
20111536,39,81,52,60,86,318,合格
20111537,66,29,0,72,45,212,不合格
20111538,83,86,41,8,32,250,不合格
20111539,98,9,14,22,45,188,不合格
20111540,52,97,28,73,31,281,不合格
20111541,33,79,54,62,0,228,不合格
20111542,81,39,72,3,72,267,不合格
20111543,11,34,3,95,40,183,不合格
20111544,30,57,12,50,95,244,不合格
20111545,67,36,55,87,87,332,合格
20111546,24,2,98,36,31,191,不合格
20111547,86,78,25,65,65,319,合格
20111548,60,72,39,25,78,274,不合格
20111549,27,39,83,84,88,321,合格
20111550,45,17,62,36,22,182,不合格
20111551,68,12,75,18,87,260,不合格
20111552,61,85,50,6,41,243,不合格
20111553,9,6,52,60,13,140,不合格
20111554,3,99,42,9,81,234,不合格
20111555,74,86,22,39,56,277,不合格
20111556,65,37,10,39,55,206,不合格
20111557,69,28,28,81,89,295,不合格
20111558,62,5,40,34,43,184,不合格
20111559,35,86,27,23,0,171,不合格
20111560,51,84,59,95,11,300,合格
20111561,22,35,42,97,65,261,不合格
20111562,5,55,13,95,89,257,不合格
20111563,66,95,94,95,56,406,合格
20111564,28,98,3,32,93,254,不合格
20111565,90,4,75,17,52,238,不合格
20111566,63,18,95,75,49,300,合格
20111567,88,27,83,60,11,269,不合格
20111568,13,19,45,14,93,184,不合格
20111569,28,41,54,58,0,181,不合格
20111570,82,32,57,48,14,233,不合格
20111571,91,69,80,62,73,375,合格
20111572,75,73,16,85,90,339,合格
20111573,26,50,10,72,32,190,不合格
20111574,71,2,41,12,36,162,不合格
20111575,34,45,46,87,40,252,不合格
20111576,71,50,44,44,43,252,不合格
20111577,68,20,97,28,12,225,不合格
20111578,88,77,55,52,64,336,合格
20111579,63,77,51,55,11,257,不合格
20111580,96,97,32,3,40,268,不合格
20111581,94,59,44,98,52,347,合格
20111582,49,63,37,65,97,311,合格
20111583,6,52,0,65,91,214,不合格
20111584,36,79,4,77,92,288,不合格
20111585,74,88,75,72,62,371,合格
20111586,41,36,34,28,44,183,不合格
20111587,72,3,15,20,33,143,不合格
20111588,84,70,30,42,28,254,不合格
20111589,97,86,73,22,61,339,合格
20111590,30,88,4,41,67,230,不合格
20111591,36,57,7,52,8,160,不合格
20111592,76,67,9,64,30,246,不合格
20111593,40,94,19,88,66,307,合格
20111594,79,24,89,38,63,293,不合格
20111595,36,96,21,42,73,268,不合格
20111596,82,93,57,28,88,348,合格
20111597,36,76,71,98,36,317,合格
20111598,73,79,92,65,24,333,合格
20111599,61,12,59,22,92,246,不合格
20111600,26,41,98,25,64,254,不合格
20111601,60,53,11,57,97,278,不合格
20111602,85,55,54,73,90,357,合格
20111603,43,54,50,98,51,296,不合格
20111604,59,2,4,55,94,214,不合格
20111605,52,72,83,28,39,274,不合格
20111606,91,57,95,33,0,276,不合格
20111607,21,73,72,61,61,288,不合格
20111608,27,8,87,24,44,190,不合格
20111609,46,81,12,33,97,269,不合格
20111610,82,17,78,38,58,273,不合格
20111611,73,18,96,13,56,256,不合格
20111612,3,45,5,0,60,113,不合格
20111613,75,1,49,19,63,207,不合格
20111614,63,20,67,35,57,242,不合格
20111615,89,99,36,14,28,266,不合格
20111616,32,30,70,26,89,247,不合格
20111617,4,84,13,49,15,165,不合格
20111618,96,71,52,98,58,375,合格
20111619,97,0,67,54,54,272,不合格
20111620,95,89,43,38,81,346,合格
20111621,84,12,13,14,94,217,不合格
20111622,79,91,28,4,74,276,不合格
20111623,35,88,65,37,82,307,合格
20111624,58,1,44,70,20,193,不合格
20111625,22,0,31,45,23,121,不合格
20111626,9,6,14,54,23,106,不合格
20111627,71,75,36,26,82,290,不合格
20111628,52,95,10,73,1,231,不合格
20111629,44,65,2,26,71,208,不合格
20111630,62,14,67,47,54,244,不合格
20111631,8,32,78,6,72,196,不合格
20111632,15,19,79,97,8,218,不合格
20111633,32,38,6,87,84,247,不合格
20111634,37,25,14,67,50,193,不合格
20111635,10,74,74,92,75,325,合格
20111636,29,8,41,24,87,189,不合格
20111637,35,21,72,10,92,230,不合格
20111638,3,9,80,60,54,206,不合格
20111639,63,0,42,4,79,188,不合格
20111640,9,54,15,73,0,151,不合格
20111641,12,8,56,24,52,152,不合格
20111642,18,2,46,61,28,155,不合格
20111643,13,60,16,94,73,256,不合格
20111644,98,9,17,85,83,292,不合格
20111645,84,75,85,51,32,327,合格
20111646,2,74,49,86,80,291,不合格
20111647,77,66,71,71,29,314,合格
20111648,71,48,62,58,6,245,不合格
20111649,66,46,18,40,83,253,不合格
20111650,65,32,27,53,24,201,不合格
20111651,97,77,63,9,46,292,不合格
20111652,25,86,46,89,39,285,不合格
20111653,9,13,73,7,22,124,不合格
20111654,81,32,98,37,56,304,合格
20111655,62,3,7,96,42,210,不合格
20111656,72,43,32,22,51,220,不合格
20111657,70,42,14,68,54,248,不合格
20111658,24,37,87,17,59,224,不合格
20111659,79,69,76,49,82,355,合格
20111660,78,38,74,89,41,320,合格
20111661,83,85,38,99,58,363,合格
20111662,36,92,25,58,87,298,不合格
20111663,9,1,52,45,23,130,不合格
20111664,58,7,52,99,6,222,不合格
20111665,48,76,33,88,20,265,不合格
20111666,53,4,12,72,94,235,不合格
20111667,34,81,87,64,74,340,合格
20111668,51,86,47,3,18,205,不合格
20111669,23,45,37,13,67,185,不合格
20111670,52,7,63,97,65,284,不合格
20111671,58,21,7,62,37,185,不合格
20111672,68,99,19,27,26,239,不合格
20111673,92,28,43,52,36,251,不合格
20111674,81,99,68,10,29,287,不合格
20111675,15,38,42,96,49,240,不合格
20111676,86,30,4,67,27,214,不合格
20111677,26,76,46,4,40,192,不合格
20111678,33,53,85,6,10,187,不合格
20111679,74,28,18,38,87,245,不合格
20111680,68,10,52,27,64,221,不合格
20111681,84,7,23,81,14,209,不合格
20111682,79,27,56,85,17,264,不合格
20111683,90,31,48,17,91,277,不合格
20111684,90,42,23,1,52,208,不合格
20111685,18,49,21,37,52,177,不合格
20111686,46,2,49,40,49,186,不合格
20111687,22,26,95,14,21,178,不合格
20111688,6,98,97,1,65,267,不合格
20111689,53,17,39,6,27,142,不合格
20111690,74,12,34,78,80,278,不合格
20111691,28,21,61,54,37,201,不合格
20111692,39,68,19,19,77,222,不合格
20111693,42,92,33,74,75,316,合格
20111694,93,82,40,19,72,306,合格
20111695,9,91,29,66,7,202,不合格
20111696,89,49,74,70,12,294,不合格
20111697,62,94,46,26,25,253,不合格
20111698,68,77,8,83,88,324,合格
20111699,80,58,90,18,86,332,合格
20111700,17,58,42,25,21,163,不合格
20111701,13,70,95,10,5,193,不合格
20111702,5,38,22,52,99,216,不合格
20111703,99,13,53,4,2,171,不合格
20111704,30,78,30,29,79,246,不合格
20111705,68,24,31,88,85,296,不合格
20111706,38,39,61,27,89,254,不合格
20111707,99,28,70,76,94,367,合格
20111708,23,25,33,63,39,183,不合格
20111709,73,88,46,99,60,366,合格
20111710,85,91,96,33,73,378,合格
20111711,56,19,75,18,38,206,不合格
20111712,55,21,58,42,35,211,不合格
20111713,72,1,55,61,9,198,不合格
20111714,47,97,47,90,21,302,合格
20111715,55,64,4,92,5,220,不合格
20111716,89,63,33,7,19,211,不合格
20111717,39,94,99,78,30,340,合格
20111718,57,92,48,17,66,280,不合格
20111719,22,20,34,73,38,187,不合格
20111720,90,10,37,62,32,231,不合格
20111721,56,85,45,23,73,282,不合格
20111722,57,8,96,40,66,267,不合格
20111723,29,39,44,27,52,191,不合格
20111724,43,19,67,38,74,241,不合格
20111725,29,18,97,98,37,279,不合格
20111726,25,23,36,69,93,246,不合格
20111727,74,61,54,49,86,324,合格
20111728,45,26,92,91,67,321,合格
20111729,16,43,40,67,90,256,不合格
20111730,34,23,28,38,75,198,不合格
20111731,0,55,87,35,88,265,不合格
20111732,1,84,71,8,50,214,不合格
20111733,18,21,10,62,74,185,不合格
20111734,99,16,40,12,91,258,不合格
20111735,60,40,16,83,83,282,不合格
20111736,71,81,33,25,19,229,不合格
20111737,50,71,91,33,44,289,不合格
20111738,43,35,22,40,30,170,不合格
20111739,30,64,81,44,20,239,不合格
20111740,16,19,66,41,16,158,不合格
20111741,58,89,30,13,78,268,不合格
20111742,77,59,30,74,78,318,合格
20111743,14,57,11,29,40,151,不合格
20111744,16,98,47,32,88,281,不合格
20111745,94,12,62,17,0,185,不合格
20111746,47,96,17,63,43,266,不合格
20111747,18,32,16,82,34,182,不合格
20111748,77,68,28,74,59,306,合格
20111749,1,38,49,20,72,180,不合格
20111750,97,98,60,47,24,326,合格
20111751,50,20,66,19,17,172,不合格
20111752,32,49,78,79,13,251,不合格
20111753,18,45,74,66,0,203,不合格
20111754,79,20,43,3,48,193,不合格
20111755,58,96,35,91,73,353,合格
20111756,50,24,18,42,25,159,不合格
20111757,28,30,71,2,29,160,不合格
20111758,80,24,45,23,71,243,不合格
20111759,61,84,41,17,79,282,不合格
20111760,12,84,23,32,42,193,不合格
20111761,78,37,65,18,42,240,不合格
20111762,17,79,40,57,77,270,不合格
20111763,71,89,98,84,74,416,合格
20111764,94,89,56,31,80,350,合格
20111765,86,45,83,56,38,308,合格
20111766,79,38,3,32,16,168,不合格
20111767,84,48,34,84,88,338,合格
20111768,23,64,49,8,78,222,不合格
20111769,82,17,90,50,31,270,不合格
20111770,65,66,1,0,49,181,不合格
20111771,27,68,7,82,93,277,不合格
20111772,33,64,36,47,31,211,不合格
20111773,17,71,97,10,74,269,不合格
20111774,16,6,56,2,63,143,不合格
20111775,79,64,59,4,32,238,不合格
20111776,82,65,38,52,53,290,不合格
20111777,4,52,90,62,96,304,合格
20111778,13,84,84,70,34,285,不合格
20111779,88,14,73,65,94,334,合格
20111780,52,24,19,19,69,183,不合格
20111781,39,57,30,97,15,238,不合格
20111782,22,19,14,81,6,142,不合格
20111783,33,82,95,54,9,273,不合格
20111784,82,56,82,81,1,302,合格
20111785,10,50,64,37,93,254,不合格
20111786,29,9,76,31,62,207,不合格
20111787,2,44,16,62,18,142,不合格
20111788,50,72,85,64,74,345,合格
20111789,19,69,18,1,55,162,不合格
20111790,33,2,69,66,75,245,不合格
20111791,19,75,30,14,22,160,不合格
20111792,11,19,76,21,7,134,不合格
20111793,61,27,25,36,85,234,不合格
20111794,55,25,36,78,90,284,不合格
20111795,70,73,23,30,3,199,不合格
20111796,86,20,34,29,5,174,不合格
20111797,36,3,91,27,87,244,不合格
20111798,49,98,99,87,88,421,合格
20111799,79,37,71,65,98,350,合格
20111800,5,82,29,92,27,235,不合格
20111801,6,72,54,74,51,257,不合格
20111802,98,64,36,49,17,264,不合格
20111803,10,88,0,39,23,160,不合格
20111804,63,40,2,75,79,259,不合格
20111805,17,2,75,62,20,176,不合格
20111806,64,68,11,59,78,280,不合格
20111807,4,76,82,30,65,257,不合格
20111808,49,29,69,35,50,232,不合格
20111809,11,11,94,86,11,213,不合格
20111810,96,92,55,46,58,347,合格
20111811,68,8,83,70,13,242,不合格
20111812,82,46,8,50,48,234,不合格
20111813,69,89,7,52,83,300,合格
20111814,71,59,92,77,27,326,合格
20111815,15,26,25,0,83,149,不合格
20111816,32,62,6,37,89,226,不合格
20111817,43,57,92,11,3,206,不合格
20111818,72,61,30,81,78,322,合格
20111819,1,16,14,34,10,75,不合格
20111820,16,74,14,48,5,157,不合格
20111821,15,30,71,34,55,205,不合格
20111822,63,81,23,42,73,282,不合格
20111823,34,89,68,39,18,248,不合格
20111824,22,11,37,15,9,94,不合格
20111825,64,15,80,11,38,208,不合格
20111826,12,11,52,21,21,117,不合格
20111827,88,64,18,34,26,230,不合格
20111828,36,28,3,74,89,230,不合格
20111829,32,65,80,27,65,269,不合格
20111830,19,41,13,67,86,226,不合格
20111831,39,66,11,72,75,263,不合格
20111832,47,47,33,94,85,306,合格
20111833,84,52,92,31,4,263,不合格
20111834,19,93,71,5,41,229,不合格
20111835,58,58,29,1,3,149,不合格
20111836,59,38,79,44,50,270,不合格
20111837,17,27,93,89,15,241,不合格
20111838,90,50,15,85,10,250,不合格
20111839,70,92,83,30,7,282,不合格
20111840,58,93,68,65,54,338,合格
20111841,91,97,60,94,36,378,合格
20111842,24,67,31,21,92,235,不合格
20111843,31,85,35,62,34,247,不合格
20111844,55,30,56,44,68,253,不合格
20111845,58,92,51,70,62,333,合格
20111846,79,68,32,51,14,244,不合格
20111847,16,26,90,46,57,235,不合格
20111848,44,65,12,86,42,249,不合格
20111849,20,75,58,4,87,244,不合格
20111850,71,80,16,51,9,227,不合格
20111851,75,94,23,13,2,207,不合格
20111852,80,85,66,61,23,315,合格
20111853,27,85,67,32,82,293,不合格
20111854,19,15,21,5,41,101,不合格
20111855,19,23,10,36,10,98,不合格
20111856,41,90,0,83,4,218,不合格
20111857,33,63,49,57,74,276,不合格
20111858,51,37,63,61,42,254,不合格
20111859,27,80,91,75,9,282,不合格
20111860,70,74,13,75,77,309,合格
20111861,23,38,20,2,26,109,不合格
20111862,2,51,96,10,28,187,不合格
20111863,57,22,42,73,62,256,不合格
20111864,57,58,19,59,80,273,不合格
20111865,8,8,80,60,84,240,不合格
20111866,35,52,92,3,73,255,不合格
20111867,69,20,81,32,47,249,不合格
20111868,18,97,16,17,16,164,不合格
20111869,70,11,82,8,69,240,不合格
20111870,85,40,34,96,82,337,合格
20111871,92,26,83,27,26,254,不合格
20111872,49,2,19,24,61,155,不合格
20111873,23,54,2,39,16,134,不合格
20111874,74,26,25,27,21,173,不合格
20111875,1,12,86,18,4,121,不合格
20111876,4,68,68,25,0,165,不合格
20111877,65,43,3,52,88,251,不合格
20111878,49,46,19,58,24,196,不合格
20111879,85,52,35,80,2,254,不合格
20111880,95,56,11,48,79,289,不合格
20111881,59,59,18,25,36,197,不合格
20111882,57,5,88,82,59,291,不合格
20111883,53,62,19,47,83,264,不合格
20111884,20,6,53,86,93,258,不合格
20111885,62,52,35,27,94,270,不合格
20111886,76,32,80,47,82,317,合格
20111887,66,46,22,98,0,232,不合格
20111888,34,50,95,30,27,236,不合格
20111889,37,3,78,32,89,239,不合格
20111890,80,22,98,66,91,357,合格
20111891,73,71,57,1,74,276,不合格
20111892,64,34,35,49,59,241,不合格
20111893,42,98,80,21,21,262,不合格
20111894,61,40,41,38,28,208,不合格
20111895,95,96,52,45,85,373,合格
20111896,79,98,46,62,33,318,合格
20111897,80,77,10,64,7,238,不合格
20111898,60,99,14,58,30,261,不合格
20111899,74,87,36,45,62,304,合格
20111900,25,7,21,4,58,115,不合格
20111901,80,47,12,60,94,293,不合格
20111902,79,77,41,55,7,259,不合格
20111903,86,36,41,35,60,258,不合格
20111904,36,25,29,13,23,126,不合格
20111905,3,94,73,99,58,327,合格
20111906,22,67,59,50,21,219,不合格
20111907,36,10,72,40,94,252,不合格
20111908,64,15,51,71,13,214,不合格
20111909,87,83,71,57,29,327,合格
20111910,21,55,76,11,12,175,不合格
20111911,4,32,77,1,2,116,不合格
20111912,70,67,62,88,13,300,合格
20111913,62,42,86,68,65,323,合格
20111914,15,21,63,84,23,206,不合格
20111915,41,25,50,4,75,195,不合格
20111916,84,61,89,75,38,347,合格
20111917,98,64,13,8,58,241,不合格
20111918,25,11,85,67,70,258,不合格
20111919,75,83,86,11,25,280,不合格
20111920,8,82,23,37,36,186,不合格
20111921,97,26,78,40,74,315,合格
20111922,22,36,78,64,23,223,不合格
20111923,36,73,38,5,85,237,不合格
20111924,85,29,58,14,82,268,不合格
20111925,93,11,82,74,22,282,不合格
20111926,83,51,39,86,25,284,不合格
20111927,76,28,87,11,28,230,不合格
20111928,90,75,6,13,90,274,不合格
20111929,97,29,97,63,27,313,合格
20111930,40,58,22,42,46,208,不合格
20111931,64,46,21,87,31,249,不合格
20111932,11,67,30,94,37,239,不合格
20111933,71,46,65,19,46,247,不合格
20111934,6,78,69,44,2,199,不合格
20111935,64,35,14,21,99,233,不合格
20111936,19,45,67,30,57,218,不合格
20111937,51,35,4,51,16,157,不合格
20111938,8,68,30,52,87,245,不合格
20111939,32,56,91,29,3,211,不合格
20111940,40,46,25,95,76,282,不合格
20111941,56,68,26,43,58,251,不合格
20111942,9,72,91,25,43,240,不合格
20111943,30,24,1,90,62,207,不合格
20111944,95,59,64,34,5,257,不合格
20111945,26,7,55,18,40,146,不合格
20111946,23,55,70,68,93,309,合格
20111947,35,92,57,92,77,353,合格
20111948,94,96,39,5,48,282,不合格
20111949,51,97,55,22,42,267,不合格
20111950,81,12,93,1,54,241,不合格
20111951,68,5,22,61,51,207,不合格
20111952,21,70,17,98,76,282,不合格
20111953,82,72,77,75,8,314,合格
20111954,35,22,43,50,90,240,不合格
20111955,85,11,62,54,44,256,不合格
20111956,15,62,37,88,4,206,不合格
20111957,77,46,79,12,53,267,不合格
20111958,35,5,65,47,99,251,不合格
20111959,55,0,22,75,39,191,不合格
20111960,76,63,44,10,50,243,不合格
20111961,83,46,46,26,12,213,不合格
20111962,16,7,38,52,41,154,不合格
20111963,3,50,50,30,5,138,不合格
20111964,78,33,18,59,26,214,不合格
20111965,39,51,46,89,93,318,合格
20111966,32,54,96,58,96,336,合格
20111967,36,49,42,80,69,276,不合格
20111968,38,92,28,57,1,216,不合格
20111969,11,29,0,18,77,135,不合格
20111970,81,20,4,59,83,247,不合格
20111971,74,26,82,70,98,350,合格
20111972,39,77,2,57,30,205,不合格
20111973,64,89,65,63,72,353,合格
20111974,34,79,93,1,7,214,不合格
20111975,52,47,34,39,26,198,不合格
20111976,36,34,82,27,60,239,不合格
20111977,0,84,72,60,64,280,不合格
20111978,50,76,38,14,93,271,不合格
20111979,90,50,34,60,11,245,不合格
20111980,54,82,14,52,54,256,不合格
20111981,28,56,93,38,82,297,不合格
20111982,25,43,56,55,6,185,不合格
20111983,83,3,46,75,24,231,不合格
20111984,1,71,2,69,69,212,不合格
20111985,22,53,8,66,30,179,不合格
20111986,62,82,12,99,59,314,合格
20111987,6,57,95,38,80,276,不合格
20111988,97,40,44,34,99,314,合格
20111989,36,71,19,29,75,230,不合格
20111990,98,19,80,90,34,321,合格
20111991,85,81,5,57,59,287,不合格
20111992,18,20,75,17,75,205,不合格
20111993,88,97,86,67,9,347,合格
20111994,8,94,76,25,11,214,不合格
20111995,36,84,74,69,74,337,合格
20111996,38,90,87,48,6,269,不合格
20111997,51,86,99,85,7,328,合格
20111998,10,53,81,63,19,226,不合格
20111999,64,66,3,64,60,257,不合格
20112000,26,1,72,65,13,177,不合格
20112001,24,80,88,62,26,280,不合格
20112002,51,81,18,8,75,233,不合格
20112003,91,5,85,54,62,297,不合格
20112004,1,68,80,70,55,274,不合格
20112005,67,10,92,40,97,306,合格
20112006,95,50,65,13,67,290,不合格
20112007,39,92,24,97,61,313,合格
20112008,27,47,26,69,41,210,不合格
20112009,56,19,25,25,33,158,不合格
20112010,49,41,65,33,2,190,不合格
20112011,9,82,14,86,63,254,不合格
20112012,60,60,99,63,75,357,合格
20112013,45,89,54,68,19,275,不合格
20112014,96,9,50,15,90,260,不合格
20112015,68,15,64,84,62,293,不合格
20112016,25,97,16,47,59,244,不合格
20112017,99,11,40,0,53,203,不合格
20112018,95,96,27,47,4,269,不合格
20112019,52,83,60,11,53,259,不合格
20112020,83,75,5,16,85,264,不合格
20112021,60,89,39,60,86,334,合格
20112022,62,97,86,6,5,256,不合格
20112023,8,75,2,28,2,115,不合格
20112024,35,92,40,7,94,268,不合格
20112025,24,56,20,94,6,200,不合格
20112026,37,16,68,95,1,217,不合格
20112027,92,15,15,10,30,162,不合格
20112028,78,56,18,16,76,244,不合格
20112029,61,18,82,5,9,175,不合格
20112030,5,12,15,31,70,133,不合格
20112031,70,27,19,3,48,167,不合格
20112032,67,76,91,62,69,365,合格
20112033,42,22,54,4,50,172,不合格
20112034,55,51,64,81,40,291,不合格
20112035,72,53,1,24,58,208,不合格
20112036,40,72,83,60,3,258,不合格
20112037,1,26,51,69,38,185,不合格
20112038,86,60,22,95,81,344,合格
20112039,51,52,90,92,15,300,合格
20112040,32,53,55,96,42,278,不合格
20112041,38,67,48,94,6,253,不合格
20112042,17,34,20,78,39,188,不合格
20112043,24,45,99,82,69,319,合格
20112044,92,1,89,73,45,300,合格
20112045,58,4,12,89,23,186,不合格
20112046,40,28,69,96,78,311,合格
20112047,99,97,4,63,65,328,合格
20112048,37,79,36,50,42,244,不合格
20112049,25,52,41,46,23,187,不合格
20112050,57,57,26,61,37,238,不合格
20112051,69,31,83,99,35,317,合格
20112052,28,32,5,2,23,90,不合格
20112053,84,32,86,23,62,287,不合格
20112054,97,77,62,51,40,327,合格
20112055,59,50,24,2,38,173,不合格
20112056,87,45,25,92,19,268,不合格
20112057,26,88,4,94,93,305,合格
20112058,52,56,32,41,38,219,不合格
20112059,55,33,57,3,70,218,不合格
20112060,44,61,90,76,65,336,合格
20112061,86,57,28,34,23,228,不合格
20112062,41,86,87,56,75,345,合格
20112063,99,80,3,2,53,237,不合格
20112064,20,5,50,54,7,136,不合格
20112065,21,13,71,28,74,207,不合格
20112066,60,22,83,21,44,230,不合格
20112067,2,31,97,87,47,264,不合格
20112068,42,91,39,21,66,259,不合格
20112069,76,99,94,18,29,316,合格
20112070,81,77,35,82,55,330,合格
20112071,81,26,92,56,23,278,不合格
20112072,7,72,56,61,44,240,不合格
20112073,43,11,40,16,25,135,不合格
20112074,58,84,54,88,27,311,合格
20112075,13,97,17,81,91,299,不合格
20112076,3,36,38,63,44,184,不合格
20112077,14,45,25,26,54,164,不合格
20112078,47,65,37,72,15,236,不合格
20112079,69,93,83,76,15,336,合格
20112080,14,67,76,51,42,250,不合格
20112081,7,84,2,42,37,172,不合格
20112082,31,58,38,88,54,269,不合格
20112083,90,39,41,88,26,284,不合格
20112084,73,73,41,95,29,311,合格
20112085,58,23,58,48,40,227,不合格
20112086,83,12,23,60,56,234,不合格
20112087,83,52,61,30,30,256,不合格
20112088,97,84,3,0,46,230,不合格
20112089,79,1,35,99,91,305,合格
20112090,43,67,18,35,80,243,不合格
20112091,28,21,83,42,89,263,不合格
20112092,16,94,92,20,58,280,不合格
20112093,52,29,43,0,79,203,不合格
20112094,76,17,88,25,11,217,不合格
20112095,40,63,53,20,41,217,不合格
20112096,4,34,30,26,99,193,不合格
20112097,34,65,89,7,57,252,不合格
20112098,47,77,85,52,37,298,不合格
20112099,63,74,99,58,56,350,合格
20112100,23,49,50,11,95,228,不合格
20112101,22,37,75,7,85,226,不合格
20112102,37,76,65,25,85,288,不合格
20112103,11,47,16,92,3,169,不合格
20112104,16,42,66,30,44,198,不合格
20112105,37,91,24,14,22,188,不合格
20112106,90,38,44,42,95,309,合格
20112107,19,62,98,59,8,246,不合格
20112108,88,52,58,27,66,291,不合格
20112109,8,97,16,7,87,215,不合格
20112110,10,68,47,98,63,286,不合格
20112111,81,4,91,19,12,207,不合格
20112112,92,14,4,66,82,258,不合格
20112113,14,14,9,34,11,82,不合格
20112114,16,42,23,21,53,155,不合格
20112115,19,72,23,67,63,244,不合格
20112116,99,49,34,90,81,353,合格
20112117,16,95,61,26,76,274,不合格
20112118,75,86,52,96,99,408,合格
20112119,82,43,59,39,23,246,不合格
20112120,35,34,31,49,42,191,不合格
20112121,68,58,8,69,14,217,不合格
20112122,32,55,85,24,86,282,不合格
20112123,64,68,77,59,56,324,合格
20112124,28,21,65,77,89,280,不合格
20112125,54,91,72,9,23,249,不合格
20112126,22,68,38,7,46,181,不合格
20112127,87,62,27,99,20,295,不合格
20112128,88,43,39,75,38,283,不合格
20112129,43,46,70,64,17,240,不合格
20112130,70,39,42,49,76,276,不合格
20112131,41,48,21,32,31,173,不合格
20112132,22,69,71,3,92,257,不合格
20112133,14,78,35,50,42,219,不合格
20112134,81,56,81,47,46,311,合格
20112135,81,91,65,43,16,296,不合格
20112136,60,53,1,51,4,169,不合格
20112137,27,7,17,59,86,196,不合格
20112138,70,77,33,37,47,264,不合格
20112139,4,11,49,84,77,225,不合格
20112140,34,19,93,81,17,244,不合格
20112141,70,38,17,21,59,205,不合格
20112142,23,86,95,83,0,287,不合格
20112143,19,91,95,7,29,241,不合格
20112144,13,3,56,0,95,167,不合格
20112145,27,60,63,60,2,212,不合格
20112146,3,67,98,12,43,223,不合格
20112147,84,61,71,40,14,270,不合格
20112148,26,38,4,91,47,206,不合格
20112149,29,41,90,92,21,273,不合格
20112150,36,26,54,20,98,234,不合格
20112151,18,93,18,73,9,211,不合格
20112152,12,35,14,79,20,160,不合格
20112153,50,90,12,97,73,322,合格
20112154,38,18,19,2,38,115,不合格
20112155,32,40,31,69,90,262,不合格
20112156,52,98,99,37,56,342,合格
20112157,66,52,71,68,25,282,不合格
20112158,12,64,6,23,91,196,不合格
20112159,45,49,78,18,93,283,不合格
20112160,20,47,96,35,85,283,不合格
20112161,53,4,64,21,48,190,不合格
20112162,48,94,6,24,26,198,不合格
20112163,23,41,92,91,77,324,合格
20112164,22,72,80,27,87,288,不合格
20112165,39,22,54,7,20,142,不合格
20112166,72,24,51,69,18,234,不合格
20112167,21,2,20,15,69,127,不合格
20112168,78,1,81,80,27,267,不合格
20112169,43,54,7,77,53,234,不合格
20112170,4,6,9,33,65,117,不合格
20112171,57,29,17,18,36,157,不合格
20112172,45,8,99,42,85,279,不合格
20112173,49,10,78,93,79,309,合格
20112174,52,71,72,73,8,276,不合格
20112175,20,13,0,64,91,188,不合格
20112176,11,88,55,5,9,168,不合格
20112177,48,58,33,50,1,190,不合格
20112178,97,47,22,65,93,324,合格
20112179,34,82,72,20,7,215,不合格
20112180,19,52,3,14,57,145,不合格
20112181,95,5,22,84,88,294,不合格
20112182,0,5,4,66,57,132,不合格
20112183,67,51,44,97,2,261,不合格
20112184,36,45,66,14,9,170,不合格
20112185,19,26,5,67,98,215,不合格
20112186,8,87,12,25,43,175,不合格
20112187,19,84,25,87,13,228,不合格
20112188,94,84,24,5,55,262,不合格
20112189,75,4,96,52,44,271,不合格
20112190,82,30,36,47,69,264,不合格
20112191,96,99,91,58,30,374,合格
20112192,6,48,50,38,26,168,不合格
20112193,1,72,47,93,2,215,不合格
20112194,45,66,78,33,18,240,不合格
20112195,76,48,80,39,97,340,合格
20112196,98,54,28,0,99,279,不合格
20112197,88,49,46,4,8,195,不合格
20112198,87,79,74,27,95,362,合格
20112199,71,31,91,43,36,272,不合格
20112200,93,85,59,58,19,314,合格
20112201,78,34,45,84,26,267,不合格
20112202,88,77,72,51,93,381,合格
20112203,86,12,5,82,31,216,不合格
20112204,47,80,69,22,15,233,不合格
20112205,48,34,50,77,74,283,不合格
20112206,39,18,97,81,70,305,合格
20112207,90,35,83,6,52,266,不合格
20112208,8,38,58,56,78,238,不合格
20112209,24,93,52,91,32,292,不合格
20112210,47,95,40,6,32,220,不合格
20112211,51,32,68,14,39,204,不合格
20112212,64,14,70,41,66,255,不合格
20112213,90,42,50,64,25,271,不合格
20112214,33,65,14,39,26,177,不合格
20112215,47,54,19,94,83,297,不合格
20112216,77,68,79,94,72,390,合格
20112217,32,72,14,55,22,195,不合格
20112218,90,90,89,76,78,423,合格
20112219,57,90,38,84,62,331,合格
20112220,71,33,43,41,0,188,不合格
20112221,92,7,56,86,0,241,不合格
20112222,1,21,38,13,50,123,不合格
20112223,72,30,15,36,58,211,不合格
20112224,5,48,76,0,67,196,不合格
20112225,91,96,71,27,4,289,不合格
20112226,66,80,65,68,20,299,不合格
20112227,19,43,32,98,31,223,不合格
20112228,46,58,61,67,89,321,合格
20112229,56,3,17,59,98,233,不合格
20112230,95,72,97,32,10,306,合格
20112231,28,37,36,45,72,218,不合格
20112232,71,99,48,26,66,310,合格
20112233,86,13,96,77,11,283,不合格
20112234,23,89,82,98,21,313,合格
20112235,51,49,25,67,69,261,不合格
20112236,68,29,3,4,95,199,不合格
20112237,46,49,86,38,67,286,不合格
20112238,35,30,65,9,56,195,不合格
20112239,20,22,87,2,76,207,不合格
20112240,84,45,38,75,6,248,不合格
20112241,74,23,41,70,24,232,不合格
20112242,88,95,50,88,92,413,合格
20112243,43,83,93,42,24,285,不合格
20112244,40,48,18,10,72,188,不合格
20112245,7,60,29,27,34,157,不合格
20112246,20,73,70,89,66,318,合格
20112247,0,63,76,40,68,247,不合格
20112248,49,68,79,71,53,320,合格
20112249,18,77,93,12,68,268,不合格
20112250,15,34,63,56,43,211,不合格
20112251,60,10,18,57,81,226,不合格
20112252,0,91,16,97,9,213,不合格
20112253,71,4,46,80,43,244,不合格
20112254,17,63,28,35,59,202,不合格
20112255,85,69,26,41,66,287,不合格
20112256,71,60,91,57,56,335,合格
20112257,62,23,63,97,35,280,不合格
20112258,49,50,14,55,35,203,不合格
20112259,62,52,62,83,82,341,合格
20112260,67,73,77,43,11,271,不合格
20112261,96,86,16,19,66,283,不合格
20112262,34,70,63,16,98,281,不合格
20112263,57,33,83,15,5,193,不合格
20112264,3,82,10,10,41,146,不合格
20112265,25,0,31,91,88,235,不合格
20112266,44,4,30,28,91,197,不合格
20112267,21,81,16,91,59,268,不合格
20112268,11,38,76,38,62,225,不合格
20112269,3,73,91,32,41,240,不合格
20112270,59,45,20,30,41,195,不合格
20112271,23,80,31,90,96,320,合格
20112272,63,13,62,97,60,295,不合格
20112273,57,58,7,78,4,204,不合格
20112274,71,8,85,31,28,223,不合格
20112275,80,57,53,66,41,297,不合格
20112276,23,64,72,34,21,214,不合格
20112277,27,45,79,13,8,172,不合格
20112278,56,40,18,49,5,168,不合格
20112279,32,60,91,86,35,304,合格
20112280,52,73,31,52,3,211,不合格
20112281,89,67,33,47,27,263,不合格
20112282,72,84,22,84,44,306,合格
20112283,81,65,9,9,4,168,不合格
20112284,89,69,94,51,58,361,合格
20112285,96,93,81,50,66,386,合格
20112286,35,57,6,51,65,214,不合格
20112287,51,89,36,54,75,305,合格
20112288,26,97,4,35,77,239,不合格
20112289,40,20,96,35,66,257,不合格
20112290,56,57,57,76,25,271,不合格
20112291,76,69,92,49,52,338,合格
20112292,5,39,38,78,51,211,不合格
20112293,56,8,58,84,11,217,不合格
20112294,78,94,80,37,26,315,合格
20112295,45,74,85,37,22,263,不合格
20112296,54,95,50,50,45,294,不合格
20112297,49,37,84,92,56,318,合格
20112298,17,73,41,80,63,274,不合格
20112299,73,95,81,99,18,366,合格
20112300,82,51,17,2,81,233,不合格
20112301,50,80,2,47,0,179,不合格
20112302,84,35,53,18,7,197,不合格
20112303,59,98,5,92,73,327,合格
20112304,39,33,19,43,59,193,不合格
20112305,92,69,14,57,94,326,合格
20112306,47,9,97,77,97,327,合格
20112307,60,70,87,26,46,289,不合格
20112308,51,8,74,69,16,218,不合格
20112309,5,95,23,71,72,266,不合格
20112310,57,20,74,39,56,246,不合格
20112311,75,34,71,80,58,318,合格
20112312,49,93,69,97,59,367,合格
20112313,92,51,92,1,59,295,不合格
20112314,36,41,50,6,30,163,不合格
20112315,88,46,68,25,4,231,不合格
20112316,23,62,3,68,13,169,不合格
20112317,68,7,85,83,46,289,不合格
20112318,39,44,43,37,62,225,不合格
20112319,49,13,20,12,58,152,不合格
20112320,2,91,76,90,90,349,合格
20112321,84,20,63,44,22,233,不合格
20112322,69,55,75,23,62,284,不合格
20112323,73,55,31,70,59,288,不合格
20112324,46,51,42,87,22,248,不合格
20112325,41,50,64,20,95,270,不合格
20112326,28,43,52,77,35,235,不合格
20112327,83,59,79,85,46,352,合格
20112328,18,86,30,26,51,211,不合格
20112329,49,99,59,32,5,244,不合格
20112330,92,55,1,60,12,220,不合格
20112331,59,34,92,9,74,268,不合格
20112332,89,93,64,17,67,330,合格
20112333,40,67,96,60,9,272,不合格
20112334,0,10,15,93,88,206,不合格
20112335,86,80,31,88,92,377,合格
20112336,33,66,75,9,58,241,不合格
20112337,88,82,34,89,23,316,合格
20112338,97,75,25,86,24,307,合格
20112339,6,32,49,46,38,171,不合格
20112340,48,91,28,81,9,257,不合格
20112341,86,98,93,16,99,392,合格
20112342,60,25,69,89,38,281,不合格
20112343,43,40,90,89,54,316,合格
20112344,92,60,59,62,62,335,合格
20112345,82,53,39,4,70,248,不合格
20112346,50,49,94,35,17,245,不合格
20112347,60,58,3,15,31,167,不合格
20112348,89,83,34,22,99,327,合格
20112349,49,47,36,35,67,234,不合格
20112350,92,23,88,84,82,369,合格
20112351,16,9,99,88,98,310,合格
20112352,62,56,30,39,33,220,不合格
20112353,91,59,3,37,2,192,不合格
20112354,95,15,49,20,96,275,不合格
20112355,19,27,90,2,23,161,不合格
20112356,27,13,50,87,18,195,不合格
20112357,9,55,38,80,13,195,不合格
20112358,16,50,71,97,37,271,不合格
20112359,69,54,8,68,11,210,不合格
20112360,76,28,49,90,46,289,不合格
20112361,29,14,12,68,12,135,不合格
20112362,97,49,62,94,49,351,合格
20112363,80,75,77,69,16,317,合格
20112364,80,9,62,86,38,275,不合格
20112365,60,95,72,62,12,301,合格
20112366,10,39,19,88,38,194,不合格
20112367,29,96,25,17,95,262,不合格
20112368,73,95,73,84,99,424,合格
20112369,32,88,72,90,30,312,合格
20112370,2,47,76,30,87,242,不合格
20112371,43,74,77,66,92,352,合格
20112372,80,96,48,49,91,364,合格
20112373,75,0,43,11,17,146,不合格
20112374,3,27,84,28,30,172,不合格
20112375,73,98,66,84,40,361,合格
20112376,70,51,71,56,16,264,不合格
20112377,75,64,58,78,68,343,合格
20112378,45,51,53,89,11,249,不合格
20112379,92,35,71,8,36,242,不合格
20112380,85,42,26,63,60,276,不合格
20112381,77,52,40,1,36,206,不合格
20112382,86,22,98,77,77,360,合格
20112383,94,84,75,14,88,355,合格
20112384,49,68,96,40,72,325,合格
20112385,28,70,27,90,26,241,不合格
20112386,5,56,71,9,77,218,不合格
20112387,42,55,93,41,36,267,不合格
20112388,15,66,22,40,34,177,不合格
20112389,26,88,51,98,84,347,合格
20112390,73,46,9,6,58,192,不合格
20112391,42,80,62,95,53,332,合格
20112392,75,6,66,95,67,309,合格
20112393,55,1,67,46,74,243,不合格
20112394,10,38,40,12,8,108,不合格
20112395,28,80,12,78,93,291,不合格
20112396,5,29,99,68,73,274,不合格
20112397,76,80,56,32,78,322,合格
20112398,65,15,15,58,18,171,不合格
20112399,11,38,90,14,76,229,不合格
20112400,89,22,86,89,25,311,合格
20112401,44,2,41,21,12,120,不合格
20112402,22,9,67,76,93,267,不合格
20112403,73,2,94,46,14,229,不合格
20112404,30,36,63,88,44,261,不合格
20112405,11,69,49,23,14,166,不合格
20112406,77,74,26,25,30,232,不合格
20112407,83,39,95,2,42,261,不合格
20112408,94,53,34,18,14,213,不合格
20112409,28,80,59,32,39,238,不合格
20112410,91,12,65,39,79,286,不合格
20112411,49,52,41,29,71,242,不合格
20112412,9,3,79,75,43,209,不合格
20112413,79,94,42,94,3,312,合格
20112414,72,25,97,9,57,260,不合格
20112415,46,82,50,69,11,258,不合格
20112416,52,85,28,52,43,260,不合格
20112417,63,84,51,13,43,254,不合格
20112418,98,76,99,66,47,386,合格
20112419,68,33,43,24,30,198,不合格
20112420,6,41,84,37,61,229,不合格
20112421,81,85,51,87,33,337,合格
20112422,41,46,1,85,45,218,不合格
20112423,10,34,8,89,79,220,不合格
20112424,33,22,80,44,14,193,不合格
20112425,86,78,88,89,96,437,合格
20112426,69,66,60,52,31,278,不合格
20112427,96,68,78,5,94,341,合格
20112428,72,84,98,80,16,350,合格
20112429,75,60,77,8,99,319,合格
20112430,89,81,30,28,89,317,合格
20112431,39,71,44,28,97,279,不合格
20112432,67,66,6,46,57,242,不合格
20112433,11,68,4,49,66,198,不合格
20112434,97,72,71,0,94,334,合格
20112435,80,50,33,6,4,173,不合格
20112436,61,70,1,15,6,153,不合格
20112437,10,71,13,31,36,161,不合格
20112438,6,42,94,25,30,197,不合格
20112439,90,11,64,87,4,256,不合格
20112440,72,28,85,93,75,353,合格
20112441,91,17,18,89,17,232,不合格
20112442,27,57,7,84,8,183,不合格
20112443,83,19,47,52,59,260,不合格
20112444,51,46,32,46,23,198,不合格
20112445,24,41,10,9,58,142,不合格
20112446,9,48,26,60,23,166,不合格
20112447,81,30,95,57,76,339,合格
20112448,55,7,90,50,40,242,不合格
20112449,36,92,1,2,59,190,不合格
20112450,89,25,60,0,81,255,不合格
20112451,44,63,54,42,3,206,不合格
20112452,21,62,33,1,44,161,不合格
20112453,28,76,86,47,31,268,不合格
20112454,77,96,87,44,56,360,合格
20112455,55,77,21,49,46,248,不合格
20112456,16,36,42,68,97,259,不合格
20112457,66,62,65,79,76,348,合格
20112458,33,54,99,15,63,264,不合格
20112459,90,89,47,38,76,340,合格
20112460,20,72,69,80,63,304,合格
20112461,27,89,26,41,75,258,不合格
20112462,44,85,75,93,96,393,合格
20112463,61,64,36,74,0,235,不合格
20112464,36,74,53,78,38,279,不合格
20112465,56,98,49,98,56,357,合格
20112466,58,50,0,1,79,188,不合格
20112467,47,89,0,37,4,177,不合格
20112468,29,15,20,23,2,89,不合格
20112469,57,35,52,25,16,185,不合格
20112470,69,33,76,54,73,305,合格
20112471,77,82,69,48,5,281,不合格
20112472,69,64,85,15,89,322,合格
20112473,54,84,40,91,39,308,合格
20112474,44,70,25,63,88,290,不合格
20112475,52,62,9,70,92,285,不合格
20112476,85,33,58,23,41,240,不合格
20112477,42,63,12,79,78,274,不合格
20112478,82,27,21,95,71,296,不合格
20112479,73,4,37,49,20,183,不合格
20112480,72,81,26,26,96,301,合格
20112481,73,39,74,75,32,293,不合格
20112482,58,50,93,74,28,303,合格
20112483,35,1,19,48,25,128,不合格
20112484,43,38,51,73,91,296,不合格
20112485,5,55,40,79,18,197,不合格
20112486,89,30,60,72,90,341,合格
20112487,14,55,57,79,50,255,不合格
20112488,24,68,37,92,79,300,合格
20112489,23,80,94,91,31,319,合格
20112490,93,9,53,38,0,193,不合格
20112491,44,79,8,61,15,207,不合格
20112492,21,47,12,14,6,100,不合格
20112493,63,37,32,85,15,232,不合格
20112494,65,61,45,30,83,284,不合格
20112495,31,36,84,9,6,166,不合格
20112496,25,38,92,53,19,227,不合格
20112497,17,81,15,40,80,233,不合格
20112498,10,9,44,87,11,161,不合格
20112499,75,64,43,8,35,225,不合格
20112500,97,99,54,42,25,317,合格
20112501,81,52,12,65,1,211,不合格
20112502,92,74,46,2,95,309,合格
20112503,98,5,59,37,57,256,不合格
20112504,81,53,53,99,73,359,合格
20112505,36,22,82,77,19,236,不合格
20112506,33,33,2,16,56,140,不合格
20112507,48,89,48,53,58,296,不合格
20112508,3,37,55,87,14,196,不合格
20112509,1,18,44,39,88,190,不合格
20112510,63,1,53,44,16,177,不合格
20112511,77,86,99,87,94,443,合格
20112512,24,70,80,66,76,316,合格
20112513,87,76,93,75,70,401,合格
20112514,62,98,80,60,61,361,合格
20112515,51,1,70,10,84,216,不合格
20112516,42,77,57,12,36,224,不合格
20112517,29,17,48,91,39,224,不合格
20112518,2,82,9,27,95,215,不合格
20112519,90,92,25,8,58,273,不合格
20112520,3,19,52,57,76,207,不合格
20112521,22,86,19,20,71,218,不合格
20112522,56,18,79,48,88,289,不合格
20112523,81,82,71,7,20,261,不合格
20112524,32,95,10,89,29,255,不合格
20112525,98,57,4,53,10,222,不合格
20112526,20,39,81,59,39,238,不合格
20112527,59,93,83,45,30,310,合格
20112528,23,19,16,39,97,194,不合格
20112529,33,51,80,9,67,240,不合格
20112530,63,82,48,44,71,308,合格
20112531,69,92,14,59,97,331,合格
20112532,69,52,77,65,15,278,不合格
20112533,70,35,0,98,55,258,不合格
20112534,51,66,64,94,75,350,合格
20112535,40,72,82,11,1,206,不合格
20112536,13,56,49,46,31,195,不合格
20112537,86,97,91,82,3,359,合格
20112538,8,81,53,60,9,211,不合格
20112539,77,92,74,72,92,407,合格
20112540,17,62,10,1,34,124,不合格
20112541,36,68,71,85,68,328,合格
20112542,99,7,47,39,94,286,不合格
20112543,66,47,19,76,67,275,不合格
20112544,10,11,92,98,29,240,不合格
20112545,72,73,86,27,32,290,不合格
20112546,61,30,41,80,6,218,不合格
20112547,94,96,48,73,5,316,合格
20112548,44,4,44,48,58,198,不合格
20112549,62,44,31,73,25,235,不合格
20112550,80,85,56,16,11,248,不合格
20112551,99,79,15,6,10,209,不合格
20112552,31,50,7,52,85,225,不合格
20112553,11,84,31,26,16,168,不合格
20112554,57,79,49,96,99,380,合格
20112555,17,84,34,36,36,207,不合格
20112556,4,57,95,54,53,263,不合格
20112557,14,22,50,65,49,200,不合格
20112558,33,59,92,6,48,238,不合格
20112559,72,91,70,91,7,331,合格
20112560,97,37,11,67,47,259,不合格
20112561,28,11,52,74,91,256,不合格
20112562,53,7,11,19,77,167,不合格
20112563,16,78,2,38,83,217,不合格
20112564,31,83,13,94,82,303,合格
20112565,14,60,80,4,4,162,不合格
20112566,95,75,90,50,16,326,合格
20112567,81,70,52,13,51,267,不合格
20112568,55,65,45,19,60,244,不合格
20112569,18,67,58,1,46,190,不合格
20112570,79,63,61,28,3,234,不合格
20112571,36,54,72,95,68,325,合格
20112572,9,41,74,19,58,201,不合格
20112573,23,32,9,88,38,190,不合格
20112574,68,62,65,77,75,347,合格
20112575,47,53,70,38,3,211,不合格
20112576,0,72,70,29,48,219,不合格
20112577,58,70,91,98,12,329,合格
20112578,39,74,61,53,12,239,不合格
20112579,64,55,67,62,13,261,不合格
20112580,53,41,35,78,77,284,不合格
20112581,81,78,26,8,4,197,不合格
20112582,37,70,38,38,7,190,不合格
20112583,87,30,67,79,55,318,合格
20112584,73,98,75,30,70,346,合格
20112585,35,59,30,93,8,225,不合格
20112586,45,73,10,36,85,249,不合格
20112587,57,17,30,95,99,298,不合格
20112588,20,37,17,83,74,231,不合格
20112589,24,5,91,26,59,205,不合格
20112590,57,57,10,43,61,228,不合格
20112591,51,38,91,35,97,312,合格
20112592,30,88,47,12,90,267,不合格
20112593,81,35,69,99,58,342,合格
20112594,11,6,1,1,13,32,不合格
20112595,15,20,36,62,38,171,不合格
20112596,88,11,87,46,78,310,合格
20112597,90,36,85,55,62,328,合格
20112598,98,39,17,77,35,266,不合格
20112599,34,6,85,82,27,234,不合格
20112600,40,2,74,90,52,258,不合格
20112601,36,46,37,10,24,153,不合格
20112602,99,70,2,47,91,309,合格
20112603,77,22,46,20,0,165,不合格
20112604,68,34,30,95,12,239,不合格
20112605,47,59,83,17,18,224,不合格
20112606,29,58,9,71,19,186,不合格
20112607,87,52,13,67,30,249,不合格
20112608,50,76,12,37,22,197,不合格
20112609,64,25,34,11,49,183,不合格
20112610,88,90,12,2,9,201,不合格
20112611,56,91,53,34,20,254,不合格
20112612,3,98,52,98,22,273,不合格
20112613,57,60,6,2,67,192,不合格
20112614,85,75,45,2,9,216,不合格
20112615,84,45,9,70,83,291,不合格
20112616,39,49,39,25,39,191,不合格
20112617,34,94,50,88,90,356,合格
20112618,74,30,74,86,60,324,合格
20112619,1,59,18,41,58,177,不合格
20112620,10,30,38,11,79,168,不合格
20112621,20,17,54,4,24,119,不合格
20112622,28,90,8,28,16,170,不合格
20112623,87,27,69,0,7,190,不合格
20112624,63,21,22,73,20,199,不合格
20112625,54,29,83,39,48,253,不合格
20112626,9,51,87,76,51,274,不合格
20112627,77,45,50,91,15,278,不合格
20112628,28,8,54,63,54,207,不合格
20112629,4,91,49,69,91,304,合格
20112630,2,71,82,36,28,219,不合格
20112631,52,37,31,32,48,200,不合格
20112632,78,50,39,14,37,218,不合格
20112633,51,68,66,49,4,238,不合格
20112634,78,38,79,63,15,273,不合格
20112635,61,58,66,63,83,331,合格
20112636,1,32,44,56,58,191,不合格
20112637,4,73,42,92,59,270,不合格
20112638,14,91,74,70,11,260,不合格
20112639,52,65,43,52,74,286,不合格
20112640,91,32,23,71,86,303,合格
20112641,49,94,13,11,91,258,不合格
20112642,38,5,57,37,43,180,不合格
20112643,88,18,70,29,66,271,不合格
20112644,45,17,28,43,30,163,不合格
20112645,94,70,34,75,26,299,不合格
20112646,7,68,23,91,3,192,不合格
20112647,99,48,12,38,73,270,不合格
20112648,6,52,56,81,69,264,不合格
20112649,56,2,39,39,60,196,不合格
20112650,93,88,83,46,6,316,合格
20112651,48,64,62,56,99,329,合格
20112652,34,79,40,79,95,327,合格
20112653,17,6,39,92,82,236,不合格
20112654,28,98,24,7,60,217,不合格
20112655,13,0,81,2,57,153,不合格
20112656,50,76,19,50,98,293,不合格
20112657,43,10,38,10,86,187,不合格
20112658,72,75,99,98,31,375,合格
20112659,70,9,54,45,47,225,不合格
20112660,60,58,46,57,49,270,不合格
20112661,11,75,31,16,16,149,不合格
20112662,48,95,10,72,49,274,不合格
20112663,72,14,3,40,92,221,不合格
20112664,17,69,4,5,72,167,不合格
20112665,35,36,60,46,28,205,不合格
20112666,57,14,68,75,57,271,不合格
20112667,63,66,76,92,7,304,合格
20112668,74,30,91,80,82,357,合格
20112669,55,91,62,8,29,245,不合格
20112670,80,47,34,31,44,236,不合格
20112671,28,68,45,52,12,205,不合格
20112672,63,34,73,25,81,276,不合格
20112673,76,65,30,44,64,279,不合格
20112674,27,36,59,80,40,242,不合格
20112675,45,50,79,57,64,295,不合格
20112676,39,32,60,6,83,220,不合格
20112677,11,19,54,34,40,158,不合格
20112678,43,87,75,82,12,299,不合格
20112679,18,68,43,95,35,259,不合格
20112680,77,79,96,43,65,360,合格
20112681,87,94,19,71,32,303,合格
20112682,38,97,79,42,87,343,合格
20112683,88,49,34,36,91,298,不合格
20112684,5,6,49,19,82,161,不合格
20112685,30,8,27,25,81,171,不合格
20112686,34,94,36,30,69,263,不合格
20112687,82,12,95,18,21,228,不合格
20112688,43,9,8,84,73,217,不合格
20112689,56,35,58,40,65,254,不合格
20112690,92,21,44,37,2,196,不合格
20112691,58,38,11,19,30,156,不合格
20112692,0,22,60,71,8,161,不合格
20112693,31,84,36,85,70,306,合格
20112694,70,72,28,96,6,272,不合格
20112695,67,59,23,83,64,296,不合格
20112696,47,50,38,9,60,204,不合格
20112697,79,88,0,11,5,183,不合格
20112698,83,35,59,29,74,280,不合格
20112699,36,67,54,18,99,274,不合格
20112700,41,46,99,90,17,293,不合格
20112701,16,14,4,36,77,147,不合格
20112702,29,35,13,42,33,152,不合格
20112703,26,9,85,46,83,249,不合格
20112704,31,49,98,86,16,280,不合格
20112705,86,99,65,25,21,296,不合格
20112706,73,52,46,37,68,276,不合格
20112707,40,10,47,33,43,173,不合格
20112708,20,52,28,70,49,219,不合格
20112709,91,96,55,8,90,340,合格
20112710,52,32,3,31,30,148,不合格
20112711,76,30,38,22,81,247,不合格
20112712,80,62,1,59,12,214,不合格
20112713,46,8,66,83,1,204,不合格
20112714,40,91,99,76,61,367,合格
20112715,13,30,96,89,58,286,不合格
20112716,51,24,86,32,4,197,不合格
20112717,68,80,40,40,62,290,不合格
20112718,65,1,12,36,1,115,不合格
20112719,98,87,88,65,69,407,合格
20112720,50,64,28,10,2,154,不合格
20112721,94,12,87,59,40,292,不合格
20112722,67,61,37,28,74,267,不合格
20112723,78,95,80,30,31,314,合格
20112724,62,89,50,46,65,312,合格
20112725,24,91,9,16,47,187,不合格
20112726,71,8,43,59,41,222,不合格
20112727,82,95,43,77,40,337,合格
20112728,13,54,25,54,20,166,不合格
20112729,25,79,5,59,49,217,不合格
20112730,60,37,9,41,18,165,不合格
20112731,23,45,30,45,25,168,不合格
20112732,64,33,19,41,63,220,不合格
20112733,9,61,79,13,14,176,不合格
20112734,29,38,0,39,53,159,不合格
20112735,95,57,27,89,2,270,不合格
20112736,60,96,10,61,78,305,合格
20112737,36,88,24,95,24,267,不合格
20112738,36,40,38,11,10,135,不合格
20112739,35,6,76,7,4,128,不合格
20112740,97,54,15,74,31,271,不合格
20112741,50,18,46,40,51,205,不合格
20112742,7,69,83,76,28,263,不合格
20112743,20,60,95,89,91,355,合格
20112744,93,34,26,61,86,300,合格
20112745,68,16,90,10,65,249,不合格
20112746,62,50,57,53,63,285,不合格
20112747,59,64,47,0,40,210,不合格
20112748,37,98,28,72,96,331,合格
20112749,66,54,7,62,48,237,不合格
20112750,14,1,39,5,78,137,不合格
20112751,9,96,68,32,55,260,不合格
20112752,31,86,98,67,93,375,合格
20112753,92,80,11,81,71,335,合格
20112754,76,2,65,14,45,202,不合格
20112755,59,81,42,74,80,336,合格
20112756,70,74,98,62,71,375,合格
20112757,91,83,42,9,48,273,不合格
20112758,64,28,77,73,60,302,合格
20112759,63,48,29,45,64,249,不合格
20112760,76,51,1,99,56,283,不合格
20112761,61,67,1,79,24,232,不合格
20112762,98,22,80,21,74,295,不合格
20112763,32,8,76,13,25,154,不合格
20112764,90,14,36,53,52,245,不合格
20112765,22,62,84,10,91,269,不合格
20112766,87,61,17,59,88,312,合格
20112767,39,20,48,39,94,240,不合格
20112768,5,39,89,63,6,202,不合格
20112769,10,63,67,30,27,197,不合格
20112770,43,37,13,64,32,189,不合格
20112771,59,55,79,1,31,225,不合格
20112772,83,99,84,34,15,315,合格
20112773,11,3,52,26,48,140,不合格
20112774,67,49,18,87,54,275,不合格
20112775,15,10,33,90,23,171,不合格
20112776,91,28,4,61,69,253,不合格
20112777,14,55,5,77,50,201,不合格
20112778,75,45,71,47,2,240,不合格
20112779,36,93,41,81,64,315,合格
20112780,11,1,37,20,13,82,不合格
20112781,55,13,17,79,83,247,不合格
20112782,90,1,95,84,43,313,合格
20112783,28,57,95,94,42,316,合格
20112784,73,5,9,8,22,117,不合格
20112785,95,83,23,99,34,334,合格
20112786,2,84,19,67,54,226,不合格
20112787,88,31,44,99,75,337,合格
20112788,59,44,84,63,67,317,合格
20112789,11,66,9,84,29,199,不合格
20112790,57,44,82,79,95,357,合格
20112791,22,78,81,80,13,274,不合格
20112792,29,36,23,42,36,166,不合格
20112793,98,11,65,39,26,239,不合格
20112794,55,42,49,32,94,272,不合格
20112795,73,78,49,2,55,257,不合格
20112796,24,16,4,94,14,152,不合格
20112797,45,3,89,78,93,308,合格
20112798,78,19,65,57,70,289,不合格
20112799,97,42,72,46,93,350,合格
20112800,12,70,4,71,30,187,不合格
20112801,4,90,25,93,32,244,不合格
20112802,9,80,18,86,96,289,不合格
20112803,83,70,40,38,98,329,合格
20112804,1,5,36,35,91,168,不合格
20112805,45,43,65,27,9,189,不合格
20112806,53,24,62,86,61,286,不合格
20112807,6,80,92,85,80,343,合格
20112808,22,94,88,27,93,324,合格
20112809,49,65,52,0,62,228,不合格
20112810,58,85,33,91,96,363,合格
20112811,63,55,61,17,32,228,不合格
20112812,65,24,31,72,92,284,不合格
20112813,13,79,11,92,66,261,不合格
20112814,95,23,36,91,54,299,不合格
20112815,9,53,70,94,81,307,合格
20112816,29,67,32,6,97,231,不合格
20112817,49,20,92,89,59,309,合格
20112818,28,45,73,83,45,274,不合格
20112819,36,6,39,18,72,171,不合格
20112820,6,52,94,84,68,304,合格
20112821,60,32,71,31,96,290,不合格
20112822,81,25,7,0,64,177,不合格
20112823,65,54,82,51,30,282,不合格
20112824,30,46,69,91,49,285,不合格
20112825,79,27,53,56,76,291,不合格
20112826,64,5,29,18,25,141,不合格
20112827,18,3,71,3,10,105,不合格
20112828,71,8,56,58,9,202,不合格
20112829,23,61,19,72,66,241,不合格
20112830,11,12,59,74,39,195,不合格
20112831,79,89,74,5,25,272,不合格
20112832,52,22,31,72,67,244,不合格
20112833,36,60,44,95,51,286,不合格
20112834,51,62,24,1,94,232,不合格
20112835,18,10,64,36,46,174,不合格
20112836,83,49,16,98,27,273,不合格
20112837,45,61,56,3,76,241,不合格
20112838,9,59,12,63,40,183,不合格
20112839,27,91,66,70,36,290,不合格
20112840,2,57,18,44,36,157,不合格
20112841,47,46,0,97,43,233,不合格
20112842,57,23,8,22,58,168,不合格
20112843,64,14,57,46,78,259,不合格
20112844,51,69,65,61,68,314,合格
20112845,75,48,37,84,37,281,不合格
20112846,96,29,26,53,40,244,不合格
20112847,14,44,43,69,45,215,不合格
20112848,50,89,25,52,17,233,不合格
20112849,55,31,84,71,95,336,合格
20112850,80,51,56,39,60,286,不合格
20112851,28,57,74,57,11,227,不合格
20112852,56,34,82,95,24,291,不合格
20112853,82,33,81,8,23,227,不合格
20112854,80,75,55,66,15,291,不合格
20112855,20,33,84,10,84,231,不合格
20112856,95,63,13,85,13,269,不合格
20112857,46,98,97,1,52,294,不合格
20112858,39,6,53,45,64,207,不合格
20112859,37,15,4,32,40,128,不合格
20112860,6,44,24,74,66,214,不合格
20112861,92,60,34,5,29,220,不合格
20112862,49,65,81,53,58,306,合格
20112863,7,49,96,72,48,272,不合格
20112864,24,34,42,36,3,139,不合格
20112865,31,3,72,4,94,204,不合格
20112866,6,68,33,8,10,125,不合格
20112867,51,17,70,31,48,217,不合格
20112868,22,71,56,17,63,229,不合格
20112869,94,35,27,50,17,223,不合格
20112870,94,40,44,41,21,240,不合格
20112871,81,33,21,34,72,241,不合格
20112872,76,28,44,64,16,228,不合格
20112873,94,75,97,37,36,339,合格
20112874,24,79,61,91,96,351,合格
20112875,36,77,10,11,33,167,不合格
20112876,91,79,92,61,27,350,合格
20112877,31,65,0,48,36,180,不合格
20112878,78,82,19,12,69,260,不合格
20112879,60,76,53,78,32,299,不合格
20112880,64,81,99,41,15,300,合格
20112881,91,0,33,84,3,211,不合格
20112882,80,92,85,33,43,333,合格
20112883,40,45,41,31,2,159,不合格
20112884,96,39,1,49,11,196,不合格
20112885,6,93,21,16,21,157,不合格
20112886,48,69,71,44,24,256,不合格
20112887,77,82,9,19,63,250,不合格
20112888,85,42,97,40,34,298,不合格
20112889,65,37,11,41,38,192,不合格
20112890,34,97,47,57,99,334,合格
20112891,20,77,82,2,77,258,不合格
20112892,76,70,16,77,79,318,合格
20112893,73,76,36,56,60,301,合格
20112894,99,86,80,62,13,340,合格
20112895,56,2,62,36,83,239,不合格
20112896,2,57,51,11,21,142,不合格
20112897,78,65,85,15,66,309,合格
20112898,79,24,25,59,13,200,不合格
20112899,65,70,66,35,9,245,不合格
20112900,85,82,29,84,55,335,合格
20112901,21,4,89,20,12,146,不合格
20112902,52,39,21,43,61,216,不合格
20112903,42,89,35,58,50,274,不合格
20112904,47,27,38,30,41,183,不合格
20112905,63,70,97,30,78,338,合格
20112906,91,97,27,29,70,314,合格
20112907,87,66,51,29,66,299,不合格
20112908,50,84,4,95,97,330,合格
20112909,75,8,26,57,29,195,不合格
20112910,36,69,71,40,93,309,合格
20112911,76,20,85,50,42,273,不合格
20112912,36,16,19,68,94,233,不合格
20112913,40,37,74,14,44,209,不合格
20112914,41,5,80,40,82,248,不合格
20112915,89,92,48,22,97,348,合格
20112916,16,59,6,55,24,160,不合格
20112917,46,70,80,50,76,322,合格
20112918,92,94,54,12,53,305,合格
20112919,0,40,17,50,33,140,不合格
20112920,11,92,84,63,65,315,合格
20112921,88,9,71,93,32,293,不合格
20112922,47,47,92,54,41,281,不合格
20112923,18,1,5,6,96,126,不合格
20112924,77,26,79,24,1,207,不合格
20112925,90,28,2,26,88,234,不合格
20112926,54,12,83,16,7,172,不合格
20112927,35,71,60,37,77,280,不合格
20112928,65,99,18,21,70,273,不合格
20112929,34,54,14,5,1,108,不合格
20112930,96,71,73,15,33,288,不合格
20112931,79,24,17,46,14,180,不合格
20112932,79,79,23,8,53,242,不合格
20112933,79,15,93,93,47,327,合格
20112934,60,24,95,43,40,262,不合格
20112935,8,46,92,0,25,171,不合格
20112936,24,84,41,60,88,297,不合格
20112937,76,55,84,93,83,391,合格
20112938,66,5,28,84,83,266,不合格
20112939,36,1,23,73,67,200,不合格
20112940,21,37,82,20,73,233,不合格
20112941,20,65,48,48,93,274,不合格
20112942,5,74,74,59,92,304,合格
20112943,99,54,58,73,26,310,合格
20112944,65,13,56,43,93,270,不合格
20112945,10,2,41,33,49,135,不合格
20112946,20,57,27,40,12,156,不合格
20112947,1,10,48,51,90,200,不合格
20112948,42,25,25,59,17,168,不合格
20112949,83,3,60,24,16,186,不合格
20112950,79,77,97,76,81,410,合格
20112951,42,35,38,49,8,172,不合格
20112952,26,68,21,39,76,230,不合格
20112953,10,96,36,12,12,166,不合格
20112954,27,49,66,38,22,202,不合格
20112955,24,14,33,44,0,115,不合格
20112956,50,55,45,67,95,312,合格
20112957,89,52,67,46,49,303,合格
20112958,83,80,21,46,15,245,不合格
20112959,83,85,24,60,53,305,合格
20112960,18,43,3,60,43,167,不合格
20112961,56,50,1,8,75,190,不合格
20112962,17,50,41,61,53,222,不合格
20112963,84,90,40,34,65,313,合格
20112964,79,9,24,29,89,230,不合格
20112965,94,41,92,23,37,287,不合格
20112966,51,53,65,1,35,205,不合格
20112967,80,9,73,49,87,298,不合格
20112968,22,37,64,30,14,167,不合格
20112969,9,35,59,84,32,219,不合格
20112970,86,77,92,37,6,298,不合格
20112971,25,27,95,99,28,274,不合格
20112972,24,14,82,79,79,278,不合格
20112973,10,94,68,90,8,270,不合格
20112974,49,60,48,0,44,201,不合格
20112975,7,29,44,85,47,212,不合格
20112976,4,47,8,96,89,244,不合格
20112977,75,67,53,28,76,299,不合格
20112978,21,51,41,64,71,248,不合格
20112979,8,20,58,62,68,216,不合格
20112980,49,67,29,21,38,204,不合格
20112981,65,41,43,50,43,242,不合格
20112982,56,38,12,15,69,190,不合格
20112983,99,71,31,10,65,276,不合格
20112984,50,8,94,53,41,246,不合格
20112985,1,74,66,87,55,283,不合格
20112986,44,50,22,65,92,273,不合格
20112987,11,33,59,4,2,109,不合格
20112988,99,33,5,36,48,221,不合格
20112989,5,61,63,88,37,254,不合格
20112990,13,32,17,37,9,108,不合格
20112991,5,34,84,13,94,230,不合格
20112992,45,61,33,20,11,170,不合格
20112993,77,68,12,89,47,293,不合格
20112994,29,81,68,72,21,271,不合格
20112995,71,11,71,66,86,305,合格
20112996,13,85,74,8,24,204,不合格
20112997,42,9,14,57,8,130,不合格
20112998,65,56,67,19,82,289,不合格
20112999,5,64,85,26,27,207,不合格
20113000,84,67,2,86,40,279,不合格
20113001,64,18,68,94,50,294,不合格
20113002,96,42,24,24,18,204,不合格
20113003,76,42,86,44,8,256,不合格
20113004,37,18,5,15,99,174,不合格
20113005,31,61,5,91,39,227,不合格
20113006,71,60,57,30,92,310,合格
20113007,60,43,12,95,69,279,不合格
20113008,56,22,86,51,54,269,不合格
20113009,27,17,40,86,47,217,不合格
20113010,4,27,90,22,18,161,不合格
20113011,87,32,75,65,84,343,合格
20113012,27,20,82,33,88,250,不合格
20113013,71,52,61,86,53,323,合格
20113014,18,83,84,67,88,340,合格
20113015,75,5,22,50,83,235,不合格
20113016,25,2,44,23,0,94,不合格
20113017,46,20,17,68,36,187,不合格
20113018,89,81,63,2,18,253,不合格
20113019,76,67,51,67,18,279,不合格
20113020,33,42,59,66,33,233,不合格
20113021,46,88,8,76,51,269,不合格
20113022,41,61,56,23,64,245,不合格
20113023,72,88,3,1,54,218,不合格
20113024,86,60,19,2,97,264,不合格
20113025,10,83,87,98,38,316,合格
20113026,42,98,25,12,61,238,不合格
20113027,71,19,8,26,55,179,不合格
20113028,49,26,39,63,96,273,不合格
20113029,5,96,53,18,24,196,不合格
20113030,38,37,62,42,83,262,不合格
20113031,96,25,37,34,82,274,不合格
20113032,75,85,28,77,77,342,合格
20113033,21,86,3,72,61,243,不合格
20113034,69,49,48,71,39,276,不合格
20113035,73,63,0,38,18,192,不合格
20113036,12,26,57,72,88,255,不合格
20113037,8,89,46,38,10,191,不合格
20113038,61,20,64,40,43,228,不合格
20113039,69,66,4,88,50,277,不合格
20113040,24,46,57,34,16,177,不合格
20113041,87,68,58,21,94,328,合格
20113042,77,90,46,61,72,346,合格
20113043,78,66,52,75,86,357,合格
20113044,58,57,16,57,87,275,不合格
20113045,27,92,95,85,64,363,合格
20113046,60,14,35,47,12,168,不合格
20113047,49,26,7,3,55,140,不合格
20113048,19,42,61,69,98,289,不合格
20113049,64,62,16,49,48,239,不合格
20113050,81,77,20,62,28,268,不合格
20113051,44,5,71,22,84,226,不合格
20113052,53,16,8,71,11,159,不合格
20113053,98,91,95,8,94,386,合格
20113054,24,52,16,2,73,167,不合格
20113055,11,69,89,0,18,187,不合格
20113056,66,55,17,5,11,154,不合格
20113057,12,80,30,30,68,220,不合格
20113058,90,55,84,88,40,357,合格
20113059,95,2,17,71,26,211,不合格
20113060,98,23,6,85,85,297,不合格
20113061,12,86,17,84,74,273,不合格
20113062,94,37,31,84,59,305,合格
20113063,20,87,77,7,51,242,不合格
20113064,62,9,1,42,5,119,不合格
20113065,67,48,59,66,31,271,不合格
20113066,82,60,50,98,21,311,合格
20113067,14,20,76,18,43,171,不合格
20113068,92,64,17,56,99,328,合格
20113069,53,15,92,30,0,190,不合格
20113070,91,7,87,17,57,259,不合格
20113071,12,3,69,36,0,120,不合格
20113072,94,44,31,11,71,251,不合格
20113073,94,4,8,35,79,220,不合格
20113074,99,71,9,39,83,301,合格
20113075,26,38,35,25,75,199,不合格
20113076,15,83,44,89,14,245,不合格
20113077,81,16,98,97,17,309,合格
20113078,25,17,5,1,51,99,不合格
20113079,53,81,77,10,53,274,不合格
20113080,81,67,39,19,27,233,不合格
20113081,27,31,58,7,4,127,不合格
20113082,33,6,91,37,34,201,不合格
20113083,66,40,91,10,11,218,不合格
20113084,40,66,71,95,70,342,合格
20113085,4,65,18,75,40,202,不合格
20113086,21,18,41,37,95,212,不合格
20113087,75,20,76,41,44,256,不合格
20113088,4,23,30,81,68,206,不合格
20113089,81,22,68,61,18,250,不合格
20113090,60,85,34,34,42,255,不合格
20113091,39,4,95,54,46,238,不合格
20113092,11,43,50,62,10,176,不合格
20113093,78,58,96,70,52,354,合格
20113094,53,67,78,49,78,325,合格
20113095,19,58,38,28,64,207,不合格
20113096,58,76,92,26,57,309,合格
20113097,45,4,7,31,17,104,不合格
20113098,33,20,53,86,53,245,不合格
20113099,57,9,71,31,45,213,不合格
20113100,7,49,81,21,50,208,不合格
20113101,97,11,48,25,3,184,不合格
20113102,14,36,81,85,21,237,不合格
20113103,99,33,49,72,32,285,不合格
20113104,63,98,87,84,77,409,合格
20113105,73,79,3,33,45,233,不合格
20113106,88,94,37,7,44,270,不合格
20113107,84,30,41,40,15,210,不合格
20113108,83,72,93,59,55,362,合格
20113109,41,93,10,56,98,298,不合格
20113110,41,96,75,2,86,300,合格
20113111,54,21,61,32,22,190,不合格
20113112,31,29,42,63,19,184,不合格
20113113,99,38,20,78,55,290,不合格
20113114,42,91,81,90,70,374,合格
20113115,57,34,97,82,77,347,合格
20113116,77,44,48,84,27,280,不合格
20113117,40,0,37,25,5,107,不合格
20113118,90,81,67,37,82,357,合格
20113119,36,68,60,31,84,279,不合格
20113120,18,7,50,95,72,242,不合格
20113121,4,95,34,26,89,248,不合格
20113122,1,65,39,91,82,278,不合格
20113123,92,52,58,14,27,243,不合格
20113124,26,76,64,50,17,233,不合格
20113125,32,2,54,35,11,134,不合格
20113126,96,44,81,71,32,324,合格
20113127,78,63,22,6,25,194,不合格
20113128,19,85,37,21,29,191,不合格
20113129,4,23,93,29,52,201,不合格
20113130,54,53,76,65,23,271,不合格
20113131,26,60,28,77,13,204,不合格
20113132,93,21,76,26,74,290,不合格
20113133,83,27,95,53,88,346,合格
20113134,27,60,99,81,37,304,合格
20113135,59,5,47,43,79,233,不合格
20113136,65,94,81,44,10,294,不合格
20113137,90,75,29,26,31,251,不合格
20113138,3,31,88,78,5,205,不合格
20113139,99,69,0,56,93,317,合格
20113140,69,82,32,45,54,282,不合格
20113141,35,71,25,66,83,280,不合格
20113142,80,90,90,49,76,385,合格
20113143,56,36,70,92,17,271,不合格
20113144,60,46,23,18,2,149,不合格
20113145,28,91,11,9,14,153,不合格
20113146,17,5,16,80,51,169,不合格
20113147,53,89,36,95,20,293,不合格
20113148,72,32,78,83,72,337,合格
20113149,74,58,16,48,64,260,不合格
20113150,5,97,82,63,61,308,合格
20113151,48,7,31,50,8,144,不合格
20113152,11,97,62,59,24,253,不合格
20113153,63,85,52,76,99,375,合格
20113154,97,84,70,19,28,298,不合格
20113155,56,74,45,40,21,236,不合格
20113156,40,90,82,28,19,259,不合格
20113157,56,64,93,82,34,329,合格
20113158,45,94,10,26,27,202,不合格
20113159,35,39,30,94,2,200,不合格
20113160,69,66,4,12,79,230,不合格
20113161,43,59,47,22,91,262,不合格
20113162,51,13,24,34,30,152,不合格
20113163,92,30,62,43,74,301,合格
20113164,12,63,95,88,30,288,不合格
20113165,22,99,45,75,36,277,不合格
20113166,63,27,86,24,40,240,不合格
20113167,70,58,35,52,33,248,不合格
20113168,57,91,26,63,14,251,不合格
20113169,32,5,61,61,2,161,不合格
20113170,33,40,3,64,94,234,不合格
20113171,77,47,59,84,93,360,合格
20113172,47,5,30,54,96,232,不合格
20113173,38,71,12,81,30,232,不合格
20113174,2,34,88,89,37,250,不合格
20113175,18,86,54,3,12,173,不合格
20113176,45,89,10,63,91,298,不合格
20113177,79,39,23,93,94,328,合格
20113178,89,22,37,85,45,278,不合格
20113179,9,6,13,88,9,125,不合格
20113180,25,40,72,33,62,232,不合格
20113181,79,41,91,96,52,359,合格
20113182,25,3,47,73,95,243,不合格
20113183,43,13,90,19,76,241,不合格
20113184,4,40,23,91,6,164,不合格
20113185,20,33,91,55,45,244,不合格
20113186,35,92,68,14,30,239,不合格
20113187,21,5,73,92,97,288,不合格
20113188,99,55,15,76,50,295,不合格
20113189,63,5,67,98,92,325,合格
20113190,50,76,26,29,58,239,不合格
20113191,22,88,43,39,92,284,不合格
20113192,69,41,23,65,55,253,不合格
20113193,40,90,0,4,93,227,不合格
20113194,44,23,9,38,50,164,不合格
20113195,54,96,9,82,19,260,不合格
20113196,38,32,32,78,65,245,不合格
20113197,80,9,18,14,10,131,不合格
20113198,0,21,82,1,89,193,不合格
20113199,20,72,84,92,86,354,合格
20113200,27,21,74,53,23,198,不合格
20113201,1,69,50,63,19,202,不合格
20113202,94,66,53,84,70,367,合格
20113203,52,97,21,36,10,216,不合格
20113204,81,64,86,2,81,314,合格
20113205,65,42,22,73,2,204,不合格
20113206,38,72,72,91,22,295,不合格
20113207,18,90,67,41,37,253,不合格
20113208,45,84,72,70,40,311,合格
20113209,23,67,60,90,22,262,不合格
20113210,55,97,15,65,99,331,合格
20113211,80,74,12,56,84,306,合格
20113212,78,44,27,98,42,289,不合格
20113213,31,32,30,8,83,184,不合格
20113214,64,95,30,5,38,232,不合格
20113215,97,29,35,96,70,327,合格
20113216,35,81,59,17,20,212,不合格
20113217,25,43,1,82,66,217,不合格
20113218,24,40,26,19,97,206,不合格
20113219,76,31,81,58,86,332,合格
20113220,73,83,98,54,96,404,合格
20113221,52,81,83,65,49,330,合格
20113222,43,72,70,22,6,213,不合格
20113223,12,41,73,96,7,229,不合格
20113224,46,67,53,41,54,261,不合格
20113225,84,30,53,75,58,300,合格
20113226,28,50,91,39,20,228,不合格
20113227,19,37,77,52,7,192,不合格
20113228,67,22,79,59,72,299,不合格
20113229,66,11,87,22,41,227,不合格
20113230,12,31,47,75,62,227,不合格
20113231,88,49,73,5,74,289,不合格
20113232,79,8,11,24,40,162,不合格
20113233,36,61,67,63,17,244,不合格
20113234,39,9,94,26,23,191,不合格
20113235,39,4,7,72,0,122,不合格
20113236,27,1,52,21,78,179,不合格
20113237,99,66,94,51,0,310,合格
20113238,41,41,88,50,64,284,不合格
20113239,41,47,70,75,47,280,不合格
20113240,56,18,35,85,34,228,不合格
20113241,59,16,66,91,61,293,不合格
20113242,36,99,35,88,73,331,合格
20113243,82,18,31,25,37,193,不合格
20113244,19,59,31,65,22,196,不合格
20113245,40,36,63,38,87,264,不合格
20113246,21,2,43,28,0,94,不合格
20113247,1,53,88,99,54,295,不合格
20113248,98,75,93,18,89,373,合格
20113249,5,9,13,41,58,126,不合格
20113250,17,4,67,56,68,212,不合格
20113251,96,93,88,18,86,381,合格
20113252,30,10,25,18,9,92,不合格
20113253,43,83,38,72,31,267,不合格
20113254,36,93,1,24,19,173,不合格
20113255,30,6,15,62,16,129,不合格
20113256,85,25,24,7,57,198,不合格
20113257,35,26,88,31,12,192,不合格
20113258,64,83,51,2,91,291,不合格
20113259,9,51,93,85,8,246,不合格
20113260,90,89,65,33,67,344,合格
20113261,48,17,49,8,53,175,不合格
20113262,74,51,46,15,61,247,不合格
20113263,56,53,89,64,58,320,合格
20113264,50,41,32,41,90,254,不合格
20113265,5,81,74,30,64,254,不合格
20113266,8,33,4,27,59,131,不合格
20113267,23,8,60,97,48,236,不合格
20113268,56,27,71,37,67,258,不合格
20113269,11,26,86,1,84,208,不合格
20113270,12,99,27,98,42,278,不合格
20113271,63,54,84,20,90,311,合格
20113272,58,76,35,38,43,250,不合格
20113273,26,56,1,75,75,233,不合格
20113274,10,38,36,3,6,93,不合格
20113275,29,77,88,5,22,221,不合格
20113276,4,1,29,41,81,156,不合格
20113277,0,6,75,88,36,205,不合格
20113278,53,90,51,42,77,313,合格
20113279,46,71,19,99,72,307,合格
20113280,72,45,72,84,3,276,不合格
20113281,72,48,74,30,85,309,合格
20113282,85,31,46,17,85,264,不合格
20113283,91,34,98,81,35,339,合格
20113284,28,38,42,45,47,200,不合格
20113285,92,94,53,95,81,415,合格
20113286,80,9,78,7,71,245,不合格
20113287,77,26,76,82,7,268,不合格
20113288,65,70,75,84,1,295,不合格
20113289,37,54,84,1,5,181,不合格
20113290,32,16,12,14,30,104,不合格
20113291,76,83,33,41,74,307,合格
20113292,31,37,98,84,35,285,不合格
20113293,39,51,71,75,67,303,合格
20113294,5,13,89,26,62,195,不合格
20113295,90,35,22,68,65,280,不合格
20113296,55,30,86,67,0,238,不合格
20113297,28,0,11,47,95,181,不合格
20113298,24,55,24,66,38,207,不合格
20113299,7,10,60,63,19,159,不合格
20113300,80,46,21,20,59,226,不合格
20113301,39,17,84,83,37,260,不合格
20113302,64,85,52,37,91,329,合格
20113303,43,44,99,3,58,247,不合格
20113304,7,5,31,67,20,130,不合格
20113305,43,28,47,44,79,241,不合格
20113306,95,50,84,28,46,303,合格
20113307,20,10,34,50,82,196,不合格
20113308,20,52,46,42,15,175,不合格
20113309,88,27,98,21,24,258,不合格
20113310,98,79,70,66,86,399,合格
20113311,52,40,16,67,12,187,不合格
20113312,18,3,95,75,24,215,不合格
20113313,50,23,89,21,62,245,不合格
20113314,17,61,0,15,84,177,不合格
20113315,66,90,92,2,43,293,不合格
20113316,17,10,13,7,94,141,不合格
20113317,54,71,31,26,46,228,不合格
20113318,52,78,56,24,9,219,不合格
20113319,48,41,18,58,30,195,不合格
20113320,77,32,68,16,88,281,不合格
20113321,53,79,50,20,34,236,不合格
20113322,36,53,70,57,22,238,不合格
20113323,65,75,99,66,52,357,合格
20113324,32,0,68,96,44,240,不合格
20113325,60,6,49,10,95,220,不合格
20113326,6,25,45,90,41,207,不合格
20113327,65,17,25,47,44,198,不合格
20113328,87,23,69,92,24,295,不合格
20113329,31,15,46,84,36,212,不合格
20113330,36,81,78,61,58,314,合格
20113331,40,9,63,96,33,241,不合格
20113332,61,28,24,27,55,195,不合格
20113333,69,80,61,67,5,282,不合格
20113334,63,87,60,32,3,245,不合格
20113335,23,71,70,2,61,227,不合格
20113336,88,82,70,74,60,374,合格
20113337,56,82,38,68,32,276,不合格
20113338,31,43,62,96,85,317,合格
20113339,27,4,97,47,17,192,不合格
20113340,95,0,82,73,22,272,不合格
20113341,82,56,51,60,51,300,合格
20113342,63,83,8,28,57,239,不合格
20113343,69,23,87,72,51,302,合格
20113344,86,10,32,25,96,249,不合格
20113345,89,38,90,56,63,336,合格
20113346,40,24,51,30,52,197,不合格
20113347,40,5,15,6,51,117,不合格
20113348,13,1,75,96,54,239,不合格
20113349,72,59,83,14,92,320,合格
20113350,8,46,17,7,48,126,不合格
20113351,72,71,77,43,20,283,不合格
20113352,64,95,75,6,81,321,合格
20113353,1,32,99,37,17,186,不合格
20113354,40,50,39,13,33,175,不合格
20113355,77,87,83,49,46,342,合格
20113356,8,54,74,12,57,205,不合格
20113357,7,99,51,73,28,258,不合格
20113358,78,30,42,66,62,278,不合格
20113359,25,2,58,76,29,190,不合格
20113360,21,91,38,71,93,314,合格
20113361,54,4,46,33,4,141,不合格
20113362,3,88,6,21,78,196,不合格
20113363,54,62,98,64,1,279,不合格
20113364,4,57,76,0,7,144,不合格
20113365,51,92,96,31,79,349,合格
20113366,72,16,48,45,17,198,不合格
20113367,18,31,88,68,45,250,不合格
20113368,82,29,42,8,51,212,不合格
20113369,2,81,12,68,20,183,不合格
20113370,49,18,49,29,75,220,不合格
20113371,60,97,36,18,41,252,不合格
20113372,17,4,49,28,53,151,不合格
20113373,23,17,33,88,3,164,不合格
20113374,90,37,54,96,76,353,合格
20113375,55,72,72,61,31,291,不合格
20113376,70,14,38,76,22,220,不合格
20113377,33,61,55,16,98,263,不合格
20113378,93,18,52,33,98,294,不合格
20113379,21,11,22,70,16,140,不合格
20113380,90,91,67,13,25,286,不合格
20113381,24,79,74,88,15,280,不合格
20113382,48,39,10,8,40,145,不合格
20113383,28,53,98,29,90,298,不合格
20113384,44,35,65,45,75,264,不合格
20113385,63,5,10,3,45,126,不合格
20113386,95,93,7,71,93,359,合格
20113387,51,45,25,64,86,271,不合格
20113388,4,51,30,6,98,189,不合格
20113389,27,33,59,31,36,186,不合格
20113390,90,13,67,54,10,234,不合格
20113391,31,49,18,48,64,210,不合格
20113392,0,9,25,48,98,180,不合格
20113393,68,49,71,86,34,308,合格
20113394,59,31,84,82,34,290,不合格
20113395,27,55,32,61,93,268,不合格
20113396,36,26,40,98,85,285,不合格
20113397,21,90,6,14,66,197,不合格
20113398,54,90,54,61,33,292,不合格
20113399,84,48,75,3,10,220,不合格
20113400,93,88,68,96,69,414,合格
20113401,10,53,79,94,61,297,不合格
20113402,98,45,90,42,30,305,合格
20113403,59,2,28,92,99,280,不合格
20113404,75,3,11,67,50,206,不合格
20113405,37,92,20,97,77,323,合格
20113406,82,83,21,28,79,293,不合格
20113407,49,99,81,5,13,247,不合格
20113408,80,53,86,39,54,312,合格
20113409,89,75,68,54,25,311,合格
20113410,13,89,40,94,78,314,合格
20113411,19,12,37,54,19,141,不合格
20113412,82,28,81,49,96,336,合格
20113413,44,73,48,8,39,212,不合格
20113414,27,68,20,24,83,222,不合格
20113415,73,75,48,89,85,370,合格
20113416,76,94,59,89,27,345,合格
20113417,25,15,70,87,92,289,不合格
20113418,18,8,67,60,88,241,不合格
20113419,35,61,3,92,76,267,不合格
20113420,18,68,75,22,75,258,不合格
20113421,78,73,36,91,9,287,不合格
20113422,80,32,43,22,34,211,不合格
20113423,70,79,49,63,42,303,合格
20113424,30,20,96,46,74,266,不合格
20113425,29,7,87,15,4,142,不合格
20113426,65,78,31,40,81,295,不合格
20113427,32,46,28,58,74,238,不合格
20113428,12,29,12,24,3,80,不合格
20113429,60,11,83,75,0,229,不合格
20113430,27,19,23,30,47,146,不合格
20113431,84,28,64,30,47,253,不合格
20113432,62,16,75,44,67,264,不合格
20113433,12,30,32,26,85,185,不合格
20113434,76,58,91,19,93,337,合格
20113435,7,92,92,49,15,255,不合格
20113436,84,96,62,22,72,336,合格
20113437,96,13,82,21,19,231,不合格
20113438,98,81,82,25,31,317,合格
20113439,90,14,42,57,30,233,不合格
20113440,3,56,88,91,83,321,合格
20113441,40,31,62,68,31,232,不合格
20113442,84,45,0,57,63,249,不合格
20113443,30,65,11,71,23,200,不合格
20113444,85,63,11,69,79,307,合格
20113445,2,26,81,45,50,204,不合格
20113446,63,74,84,85,22,328,合格
20113447,10,66,86,74,67,303,合格
20113448,67,17,82,84,18,268,不合格
20113449,87,68,26,35,76,292,不合格
20113450,38,71,47,26,49,231,不合格
20113451,83,43,2,29,0,157,不合格
20113452,66,66,43,73,82,330,合格
20113453,96,48,20,44,66,274,不合格
20113454,93,64,13,43,42,255,不合格
20113455,7,16,90,78,45,236,不合格
20113456,32,65,59,69,22,247,不合格
20113457,6,13,99,5,69,192,不合格
20113458,74,49,89,21,3,236,不合格
20113459,30,3,61,43,96,233,不合格
20113460,28,29,52,0,52,161,不合格
20113461,50,52,28,74,64,268,不合格
20113462,81,95,19,87,24,306,合格
20113463,9,33,20,28,49,139,不合格
20113464,87,77,80,20,12,276,不合格
20113465,83,33,76,10,39,241,不合格
20113466,51,44,92,66,30,283,不合格
20113467,31,11,9,64,20,135,不合格
20113468,35,99,55,22,20,231,不合格
20113469,24,16,7,5,90,142,不合格
20113470,48,9,31,94,85,267,不合格
20113471,57,40,52,14,26,189,不合格
20113472,39,44,7,39,74,203,不合格
20113473,23,88,9,9,6,135,不合格
20113474,16,75,52,65,25,233,不合格
20113475,24,88,1,66,35,214,不合格
20113476,19,33,93,62,52,259,不合格
20113477,27,21,15,25,53,141,不合格
20113478,50,97,71,8,80,306,合格
20113479,62,11,52,50,77,252,不合格
20113480,25,56,17,43,95,236,不合格
20113481,37,16,68,23,87,231,不合格
20113482,88,68,91,32,71,350,合格
20113483,26,32,67,41,64,230,不合格
20113484,25,77,61,87,37,287,不合格
20113485,6,46,66,14,84,216,不合格
20113486,17,48,15,88,65,233,不合格
20113487,76,42,8,88,55,269,不合格
20113488,85,45,13,85,52,280,不合格
20113489,50,39,66,28,92,275,不合格
20113490,51,52,50,83,94,330,合格
20113491,3,13,15,7,31,69,不合格
20113492,81,24,66,55,26,252,不合格
20113493,33,97,61,85,32,308,合格
20113494,71,91,24,80,67,333,合格
20113495,72,51,37,67,88,315,合格
20113496,5,48,60,93,28,234,不合格
20113497,19,59,71,41,5,195,不合格
20113498,90,10,39,32,90,261,不合格
20113499,22,97,49,47,44,259,不合格
20113500,64,95,85,51,68,363,合格
20113501,9,31,46,85,34,205,不合格
20113502,55,15,90,73,44,277,不合格
20113503,75,95,82,74,23,349,合格
20113504,86,72,7,61,39,265,不合格
20113505,0,49,96,1,44,190,不合格
20113506,37,71,63,15,49,235,不合格
20113507,95,68,96,94,85,438,合格
20113508,89,31,44,42,83,289,不合格
20113509,56,67,42,56,66,287,不合格
20113510,53,27,77,74,72,303,合格
20113511,81,42,57,57,26,263,不合格
20113512,40,15,90,39,63,247,不合格
20113513,29,11,70,14,17,141,不合格
20113514,27,63,52,44,44,230,不合格
20113515,78,9,80,73,7,247,不合格
20113516,12,78,76,26,60,252,不合格
20113517,26,14,15,30,97,182,不合格
20113518,75,80,69,22,27,273,不合格
20113519,58,11,3,27,58,157,不合格
20113520,32,10,99,5,7,153,不合格
20113521,61,20,45,71,32,229,不合格
20113522,67,89,83,76,89,404,合格
20113523,87,28,57,25,91,288,不合格
20113524,61,1,86,13,81,242,不合格
20113525,42,11,86,26,51,216,不合格
20113526,63,50,61,27,99,300,合格
20113527,85,71,77,24,48,305,合格
20113528,83,49,77,1,4,214,不合格
20113529,17,96,22,62,74,271,不合格
20113530,42,16,29,63,6,156,不合格
20113531,16,87,96,64,35,298,不合格
20113532,70,88,48,15,2,223,不合格
20113533,67,22,68,69,96,322,合格
20113534,39,93,20,95,2,249,不合格
20113535,68,5,80,22,86,261,不合格
20113536,23,41,43,31,35,173,不合格
20113537,54,31,74,17,69,245,不合格
20113538,36,36,97,0,67,236,不合格
20113539,19,61,96,61,45,282,不合格
20113540,31,99,31,18,26,205,不合格
20113541,63,1,56,84,97,301,合格
20113542,75,11,82,42,23,233,不合格
20113543,93,34,90,24,81,322,合格
20113544,83,64,49,44,11,251,不合格
20113545,99,76,50,36,72,333,合格
20113546,53,59,38,51,68,269,不合格
20113547,29,55,25,75,80,264,不合格
20113548,27,87,67,37,62,280,不合格
20113549,41,32,47,32,80,232,不合格
20113550,14,6,44,48,86,198,不合格
20113551,72,26,0,67,39,204,不合格
20113552,41,49,95,19,89,293,不合格
20113553,48,0,22,81,73,224,不合格
20113554,26,30,86,2,63,207,不合格
20113555,79,19,43,49,60,250,不合格
20113556,30,30,37,77,47,221,不合格
20113557,94,9,68,17,10,198,不合格
20113558,83,85,33,85,48,334,合格
20113559,37,10,57,0,72,176,不合格
20113560,20,63,89,98,33,303,合格
20113561,6,10,2,54,11,83,不合格
20113562,29,46,62,3,46,186,不合格
20113563,82,70,80,76,85,393,合格
20113564,74,99,12,8,95,288,不合格
20113565,62,96,24,66,10,258,不合格
20113566,0,35,83,17,15,150,不合格
20113567,28,15,17,60,11,131,不合格
20113568,28,84,68,7,74,261,不合格
20113569,82,99,48,49,85,363,合格
20113570,57,92,71,30,62,312,合格
20113571,36,90,85,81,36,328,合格
20113572,66,6,34,45,19,170,不合格
20113573,12,57,82,32,49,232,不合格
20113574,97,88,23,61,11,280,不合格
20113575,34,63,83,22,89,291,不合格
20113576,9,35,2,38,79,163,不合格
20113577,14,62,17,53,55,201,不合格
20113578,81,64,72,23,65,305,合格
20113579,12,52,23,5,69,161,不合格
20113580,18,73,61,30,89,271,不合格
20113581,5,49,61,92,35,242,不合格
20113582,91,93,20,10,25,239,不合格
20113583,71,46,26,18,62,223,不合格
20113584,22,7,2,51,13,95,不合格
20113585,57,77,3,69,53,259,不合格
20113586,22,66,57,45,2,192,不合格
20113587,19,2,0,12,65,98,不合格
20113588,48,59,74,81,53,315,合格
20113589,29,36,54,2,94,215,不合格
20113590,32,28,63,88,75,286,不合格
20113591,89,2,95,97,69,352,合格
20113592,39,76,80,97,3,295,不合格
20113593,64,64,20,11,89,248,不合格
20113594,92,4,58,49,83,286,不合格
20113595,98,41,24,99,58,320,合格
20113596,27,86,73,26,44,256,不合格
20113597,0,6,17,32,4,59,不合格
20113598,43,2,24,24,39,132,不合格
20113599,60,98,10,68,18,254,不合格
20113600,56,66,35,11,38,206,不合格
20113601,75,24,12,74,70,255,不合格
20113602,57,80,9,14,37,197,不合格
20113603,58,40,99,14,75,286,不合格
20113604,59,99,84,71,17,330,合格
20113605,48,31,36,73,47,235,不合格
20113606,60,7,72,59,79,277,不合格
20113607,61,38,88,54,99,340,合格
20113608,77,94,38,4,90,303,合格
20113609,6,83,6,9,23,127,不合格
20113610,80,67,58,56,6,267,不合格
20113611,83,51,2,88,33,257,不合格
20113612,20,38,5,75,39,177,不合格
20113613,2,49,33,0,8,92,不合格
20113614,25,68,65,16,86,260,不合格
20113615,39,15,36,87,57,234,不合格
20113616,39,29,53,78,93,292,不合格
20113617,47,6,41,40,1,135,不合格
20113618,45,88,82,27,95,337,合格
20113619,8,68,27,13,42,158,不合格
20113620,46,42,79,4,71,242,不合格
20113621,68,95,17,85,52,317,合格
20113622,58,9,52,36,63,218,不合格
20113623,11,41,57,23,39,171,不合格
20113624,86,61,54,13,74,288,不合格
20113625,89,30,14,61,79,273,不合格
20113626,74,93,10,76,62,315,合格
20113627,60,83,21,92,87,343,合格
20113628,5,27,45,22,77,176,不合格
20113629,90,45,41,85,12,273,不合格
20113630,4,6,10,92,72,184,不合格
20113631,51,42,16,16,36,161,不合格
20113632,39,94,78,35,55,301,合格
20113633,68,46,65,50,8,237,不合格
20113634,14,44,49,27,65,199,不合格
20113635,35,11,13,31,10,100,不合格
20113636,3,75,91,24,17,210,不合格
20113637,33,3,44,28,74,182,不合格
20113638,43,73,2,12,45,175,不合格
20113639,66,53,50,39,80,288,不合格
20113640,1,94,63,27,29,214,不合格
20113641,49,87,28,1,66,231,不合格
20113642,76,55,1,73,56,261,不合格
20113643,80,41,64,32,21,238,不合格
20113644,66,66,66,0,59,257,不合格
20113645,26,28,33,14,61,162,不合格
20113646,47,73,58,77,16,271,不合格
20113647,10,30,4,8,91,143,不合格
20113648,50,66,17,34,40,207,不合格
20113649,92,39,32,12,4,179,不合格
20113650,0,97,2,50,18,167,不合格
20113651,34,92,15,30,14,185,不合格
20113652,48,72,47,1,63,231,不合格
20113653,5,86,89,7,35,222,不合格
20113654,65,77,13,56,51,262,不合格
20113655,41,61,33,67,0,202,不合格
20113656,71,74,79,3,73,300,合格
20113657,27,73,98,71,58,327,合格
20113658,0,95,55,76,27,253,不合格
20113659,61,18,97,24,42,242,不合格
20113660,72,44,77,40,72,305,合格
20113661,4,88,49,57,14,212,不合格
20113662,96,83,23,10,14,226,不合格
20113663,99,44,30,76,90,339,合格
20113664,55,78,48,81,38,300,合格
20113665,71,32,26,11,92,232,不合格
20113666,58,83,57,17,47,262,不合格
20113667,53,30,34,99,9,225,不合格
20113668,67,39,39,41,95,281,不合格
20113669,12,64,12,75,36,199,不合格
20113670,28,81,45,82,93,329,合格
20113671,33,49,48,43,33,206,不合格
20113672,99,12,73,63,68,315,合格
20113673,53,68,73,32,39,265,不合格
20113674,11,77,66,72,92,318,合格
20113675,47,48,32,58,75,260,不合格
20113676,28,91,90,68,13,290,不合格
20113677,70,50,86,48,66,320,合格
20113678,15,63,10,84,51,223,不合格
20113679,12,34,89,49,81,265,不合格
20113680,78,99,32,19,59,287,不合格
20113681,69,31,37,82,43,262,不合格
20113682,48,89,26,53,63,279,不合格
20113683,16,66,36,33,75,226,不合格
20113684,52,73,90,58,5,278,不合格
20113685,31,46,11,94,53,235,不合格
20113686,99,84,62,58,10,313,合格
20113687,78,95,89,36,84,382,合格
20113688,18,43,19,66,4,150,不合格
20113689,50,95,81,79,26,331,合格
20113690,55,89,53,55,95,347,合格
20113691,43,92,24,55,26,240,不合格
20113692,23,73,92,89,97,374,合格
20113693,66,30,28,25,31,180,不合格
20113694,60,76,42,71,40,289,不合格
20113695,63,95,15,50,68,291,不合格
20113696,50,39,44,67,86,286,不合格
20113697,73,94,4,0,88,259,不合格
20113698,33,93,69,61,45,301,合格
20113699,28,61,96,71,33,289,不合格
20113700,57,78,42,75,69,321,合格
20113701,43,86,15,42,90,276,不合格
20113702,4,41,63,0,39,147,不合格
20113703,0,83,73,82,27,265,不合格
20113704,94,59,68,16,99,336,合格
20113705,74,95,99,52,50,370,合格
20113706,72,19,93,50,29,263,不合格
20113707,32,77,57,6,61,233,不合格
20113708,93,12,33,37,89,264,不合格
20113709,9,91,34,94,22,250,不合格
20113710,35,78,48,69,85,315,合格
20113711,62,43,69,95,21,290,不合格
20113712,25,86,88,53,29,281,不合格
20113713,69,82,31,47,70,299,不合格
20113714,80,21,22,99,11,233,不合格
20113715,56,66,41,27,59,249,不合格
20113716,92,83,62,24,39,300,合格
20113717,18,24,69,98,65,274,不合格
20113718,68,45,28,19,92,252,不合格
20113719,68,32,38,39,48,225,不合格
20113720,25,74,47,62,98,306,合格
20113721,85,61,63,46,64,319,合格
20113722,48,66,61,65,27,267,不合格
20113723,2,99,6,91,39,237,不合格
20113724,35,76,94,56,89,350,合格
20113725,6,82,33,77,75,273,不合格
20113726,82,71,52,29,4,238,不合格
20113727,62,43,60,83,23,271,不合格
20113728,57,34,63,20,76,250,不合格
20113729,26,77,68,57,23,251,不合格
20113730,87,24,53,47,83,294,不合格
20113731,15,68,87,86,85,341,合格
20113732,76,95,58,77,52,358,合格
20113733,48,8,27,90,98,271,不合格
20113734,44,24,36,55,14,173,不合格
20113735,83,68,38,98,76,363,合格
20113736,41,25,6,99,46,217,不合格
20113737,45,82,64,4,60,255,不合格
20113738,65,60,89,0,34,248,不合格
20113739,83,14,42,56,77,272,不合格
20113740,2,55,57,57,75,246,不合格
20113741,10,15,92,16,18,151,不合格
20113742,29,47,66,38,63,243,不合格
20113743,20,51,42,91,7,211,不合格
20113744,0,20,28,0,84,132,不合格
20113745,18,55,35,99,92,299,不合格
20113746,85,4,68,79,73,309,合格
20113747,63,60,70,77,0,270,不合格
20113748,81,26,41,91,55,294,不合格
20113749,52,73,2,48,88,263,不合格
20113750,99,50,0,11,69,229,不合格
20113751,94,35,2,57,19,207,不合格
20113752,74,72,38,68,30,282,不合格
20113753,10,34,10,23,25,102,不合格
20113754,16,76,36,41,40,209,不合格
20113755,33,91,23,99,70,316,合格
20113756,14,79,95,27,70,285,不合格
20113757,28,30,14,48,6,126,不合格
20113758,91,20,86,57,28,282,不合格
20113759,73,95,36,14,29,247,不合格
20113760,81,88,79,36,58,342,合格
20113761,9,12,37,83,12,153,不合格
20113762,55,30,55,88,56,284,不合格
20113763,88,11,93,66,54,312,合格
20113764,62,17,21,83,47,230,不合格
20113765,13,63,88,8,73,245,不合格
20113766,93,3,47,5,51,199,不合格
20113767,22,28,52,50,69,221,不合格
20113768,56,49,45,81,2,233,不合格
20113769,27,56,47,95,42,267,不合格
20113770,31,89,53,55,37,265,不合格
20113771,79,6,65,15,98,263,不合格
20113772,35,45,54,99,91,324,合格
20113773,51,82,12,97,95,337,合格
20113774,14,26,35,95,89,259,不合格
20113775,57,3,38,74,4,176,不合格
20113776,62,71,78,2,28,241,不合格
20113777,82,58,78,44,14,276,不合格
20113778,69,61,53,2,10,195,不合格
20113779,8,1,46,64,59,178,不合格
20113780,20,77,5,74,86,262,不合格
20113781,90,36,15,93,45,279,不合格
20113782,96,93,48,24,98,359,合格
20113783,63,34,92,96,0,285,不合格
20113784,5,15,12,51,23,106,不合格
20113785,76,24,45,1,57,203,不合格
20113786,47,70,29,28,1,175,不合格
20113787,28,90,90,15,92,315,合格
20113788,37,41,42,22,84,226,不合格
20113789,72,47,69,61,51,300,合格
20113790,97,61,48,47,35,288,不合格
20113791,89,7,5,36,78,215,不合格
20113792,7,34,81,40,78,240,不合格
20113793,73,54,77,2,61,267,不合格
20113794,31,13,86,0,4,134,不合格
20113795,90,58,32,42,51,273,不合格
20113796,77,92,58,10,82,319,合格
20113797,96,79,19,7,23,224,不合格
20113798,54,72,89,56,9,280,不合格
20113799,7,49,65,96,44,261,不合格
20113800,2,8,35,56,10,111,不合格
20113801,57,14,4,29,97,201,不合格
20113802,37,95,90,98,12,332,合格
20113803,6,67,12,65,74,224,不合格
20113804,38,45,32,30,8,153,不合格
20113805,56,68,75,78,44,321,合格
20113806,33,98,11,19,5,166,不合格
20113807,11,13,54,32,88,198,不合格
20113808,87,36,62,66,65,316,合格
20113809,0,22,36,35,12,105,不合格
20113810,13,89,4,52,95,253,不合格
20113811,93,25,17,23,43,201,不合格
20113812,92,25,93,92,55,357,合格
20113813,68,23,32,91,17,231,不合格
20113814,4,53,32,49,37,175,不合格
20113815,22,74,97,46,75,314,合格
20113816,69,11,45,58,29,212,不合格
20113817,19,71,55,74,75,294,不合格
20113818,79,16,27,32,10,164,不合格
20113819,47,47,58,55,40,247,不合格
20113820,80,52,70,17,55,274,不合格
20113821,29,42,64,72,30,237,不合格
20113822,54,67,85,30,99,335,合格
20113823,43,20,28,97,73,261,不合格
20113824,84,5,70,21,82,262,不合格
20113825,55,84,83,71,9,302,合格
20113826,9,3,60,71,7,150,不合格
20113827,2,4,88,48,60,202,不合格
20113828,62,21,63,89,21,256,不合格
20113829,31,24,50,57,22,184,不合格
20113830,46,66,68,54,74,308,合格
20113831,64,52,71,42,79,308,合格
20113832,2,69,2,71,46,190,不合格
20113833,68,76,43,26,25,238,不合格
20113834,22,35,70,93,57,277,不合格
20113835,75,35,13,31,74,228,不合格
20113836,33,97,74,15,65,284,不合格
20113837,24,11,37,22,10,104,不合格
20113838,63,87,75,4,49,278,不合格
20113839,71,71,14,45,5,206,不合格
20113840,47,59,11,83,48,248,不合格
20113841,17,88,27,54,0,186,不合格
20113842,59,78,85,21,69,312,合格
20113843,4,89,77,85,68,323,合格
20113844,57,35,68,40,12,212,不合格
20113845,26,60,95,85,0,266,不合格
20113846,59,88,4,96,46,293,不合格
20113847,40,2,78,91,48,259,不合格
20113848,8,74,97,65,79,323,合格
20113849,28,11,31,25,30,125,不合格
20113850,3,27,57,29,10,126,不合格
20113851,91,54,2,5,84,236,不合格
20113852,63,93,89,5,33,283,不合格
20113853,82,72,2,54,42,252,不合格
20113854,88,90,94,40,19,331,合格
20113855,97,23,37,95,65,317,合格
20113856,75,99,39,12,11,236,不合格
20113857,32,86,94,95,90,397,合格
20113858,18,68,62,63,52,263,不合格
20113859,65,33,98,74,29,299,不合格
20113860,4,71,49,23,5,152,不合格
20113861,73,40,18,69,99,299,不合格
20113862,63,47,0,10,99,219,不合格
20113863,32,31,56,69,14,202,不合格
20113864,13,34,51,54,94,246,不合格
20113865,44,5,93,39,59,240,不合格
20113866,82,44,96,38,42,302,合格
20113867,72,0,20,59,27,178,不合格
20113868,9,55,11,27,12,114,不合格
20113869,18,56,9,51,52,186,不合格
20113870,62,92,47,54,4,259,不合格
20113871,37,57,64,71,62,291,不合格
20113872,43,31,4,1,45,124,不合格
20113873,28,42,80,50,32,232,不合格
20113874,70,25,33,18,98,244,不合格
20113875,12,95,60,50,15,232,不合格
20113876,56,64,41,49,8,218,不合格
20113877,80,44,18,3,88,233,不合格
20113878,33,76,20,97,74,300,合格
20113879,71,72,29,81,8,261,不合格
20113880,88,60,74,97,26,345,合格
20113881,11,33,49,26,41,160,不合格
20113882,95,87,15,18,53,268,不合格
20113883,79,83,37,84,22,305,合格
20113884,38,92,78,10,68,286,不合格
20113885,60,74,21,86,1,242,不合格
20113886,8,46,15,18,34,121,不合格
20113887,85,13,5,20,95,218,不合格
20113888,82,53,34,30,38,237,不合格
20113889,48,41,26,32,63,210,不合格
20113890,10,89,34,86,67,286,不合格
20113891,74,69,48,63,14,268,不合格
20113892,37,57,44,27,97,262,不合格
20113893,65,79,64,37,52,297,不合格
20113894,96,94,75,60,77,402,合格
20113895,19,70,62,81,67,299,不合格
20113896,54,88,38,84,2,266,不合格
20113897,99,1,75,92,88,355,合格
20113898,18,31,60,33,81,223,不合格
20113899,14,40,47,27,29,157,不合格
20113900,53,41,65,68,53,280,不合格
20113901,24,4,35,47,55,165,不合格
20113902,65,52,99,19,6,241,不合格
20113903,74,41,95,60,66,336,合格
20113904,45,39,52,72,13,221,不合格
20113905,3,72,68,15,11,169,不合格
20113906,15,39,19,75,38,186,不合格
20113907,38,27,54,86,33,238,不合格
20113908,61,76,61,78,64,340,合格
20113909,82,38,1,38,33,192,不合格
20113910,59,66,61,15,17,218,不合格
20113911,52,18,48,68,35,221,不合格
20113912,52,48,60,82,70,312,合格
20113913,96,0,16,28,63,203,不合格
20113914,55,79,11,39,34,218,不合格
20113915,87,98,90,87,29,391,合格
20113916,27,88,64,38,92,309,合格
20113917,80,63,45,1,64,253,不合格
20113918,54,40,56,61,15,226,不合格
20113919,79,53,0,76,20,228,不合格
20113920,29,29,12,89,66,225,不合格
20113921,40,47,12,27,48,174,不合格
20113922,28,13,91,6,60,198,不合格
20113923,69,32,32,6,16,155,不合格
20113924,67,78,14,79,45,283,不合格
20113925,47,12,25,92,69,245,不合格
20113926,42,55,71,43,1,212,不合格
20113927,78,73,72,1,30,254,不合格
20113928,74,40,73,14,4,205,不合格
20113929,95,55,94,15,87,346,合格
20113930,43,32,30,0,46,151,不合格
20113931,26,44,32,45,2,149,不合格
20113932,11,57,29,85,96,278,不合格
20113933,28,41,25,12,41,147,不合格
20113934,47,79,35,64,69,294,不合格
20113935,8,21,6,31,42,108,不合格
20113936,5,17,83,23,62,190,不合格
20113937,99,91,57,24,36,307,合格
20113938,96,54,8,44,66,268,不合格
20113939,30,96,41,33,36,236,不合格
20113940,35,24,11,0,5,75,不合格
20113941,10,52,73,89,18,242,不合格
20113942,50,75,86,21,66,298,不合格
20113943,12,7,2,65,2,88,不合格
20113944,42,54,13,27,5,141,不合格
20113945,4,45,42,14,30,135,不合格
20113946,5,48,43,74,53,223,不合格
20113947,81,37,40,0,37,195,不合格
20113948,66,21,17,69,7,180,不合格
20113949,81,11,88,0,38,218,不合格
20113950,3,94,66,76,98,337,合格
20113951,50,72,5,95,11,233,不合格
20113952,87,23,89,77,18,294,不合格
20113953,69,19,4,55,54,201,不合格
20113954,37,32,41,90,66,266,不合格
20113955,4,85,93,0,6,188,不合格
20113956,15,69,6,4,14,108,不合格
20113957,49,55,25,85,3,217,不合格
20113958,79,86,40,29,80,314,合格
20113959,87,48,46,35,7,223,不合格
20113960,15,70,12,94,80,271,不合格
20113961,93,59,68,73,18,311,合格
20113962,92,14,3,88,89,286,不合格
20113963,20,27,17,37,65,166,不合格
20113964,13,85,98,81,69,346,合格
20113965,78,64,94,15,39,290,不合格
20113966,18,34,14,88,37,191,不合格
20113967,83,74,20,21,32,230,不合格
20113968,82,37,71,57,65,312,合格
20113969,15,98,52,80,8,253,不合格
20113970,12,18,83,89,66,268,不合格
20113971,13,23,60,32,21,149,不合格
20113972,97,71,32,0,6,206,不合格
20113973,29,7,62,90,40,228,不合格
20113974,88,96,73,24,73,354,合格
20113975,19,87,8,17,19,150,不合格
20113976,49,21,74,9,26,179,不合格
20113977,96,68,66,37,26,293,不合格
20113978,50,32,8,68,13,171,不合格
20113979,92,91,39,27,81,330,合格
20113980,68,71,91,95,33,358,合格
20113981,43,71,9,17,70,210,不合格
20113982,20,50,74,81,81,306,合格
20113983,78,71,99,84,94,426,合格
20113984,74,81,15,78,22,270,不合格
20113985,74,91,98,1,29,293,不合格
20113986,16,11,65,3,30,125,不合格
20113987,58,36,41,28,34,197,不合格
20113988,5,63,41,16,50,175,不合格
20113989,6,55,86,29,57,233,不合格
20113990,22,14,60,35,34,165,不合格
20113991,51,24,26,94,58,253,不合格
20113992,96,84,54,54,34,322,合格
20113993,3,67,3,87,33,193,不合格
20113994,52,76,3,35,31,197,不合格
20113995,68,45,40,93,19,265,不合格
20113996,85,47,22,87,15,256,不合格
20113997,42,30,66,46,7,191,不合格
20113998,65,88,98,89,74,414,合格
20113999,74,66,42,79,45,306,合格
20114000,76,90,25,47,73,311,合格
20114001,11,1,10,27,67,116,不合格
20114002,37,46,36,29,20,168,不合格
20114003,57,53,91,24,58,283,不合格
20114004,21,58,52,14,65,210,不合格
20114005,34,54,95,91,55,329,合格
20114006,74,22,95,36,69,296,不合格
20114007,28,61,28,74,31,222,不合格
20114008,86,5,54,76,16,237,不合格
20114009,18,61,79,0,47,205,不合格
20114010,64,88,46,74,46,318,合格
20114011,97,54,71,81,12,315,合格
20114012,99,21,24,73,93,310,合格
20114013,82,93,57,0,22,254,不合格
20114014,28,72,24,73,81,278,不合格
20114015,17,85,87,59,72,320,合格
20114016,82,37,70,53,26,268,不合格
20114017,40,59,2,9,37,147,不合格
20114018,50,63,7,41,47,208,不合格
20114019,11,35,73,99,33,251,不合格
20114020,15,12,77,64,44,212,不合格
20114021,65,23,22,55,79,244,不合格
20114022,62,60,38,17,69,246,不合格
20114023,6,60,45,57,31,199,不合格
20114024,38,5,36,39,51,169,不合格
20114025,58,31,77,81,16,263,不合格
20114026,93,56,93,91,28,361,合格
20114027,92,9,16,26,24,167,不合格
20114028,8,66,45,56,80,255,不合格
20114029,43,39,67,14,29,192,不合格
20114030,90,77,52,74,5,298,不合格
20114031,75,72,68,14,38,267,不合格
20114032,98,36,22,96,49,301,合格
20114033,84,54,25,53,42,258,不合格
20114034,45,99,86,78,9,317,合格
20114035,62,35,32,88,8,225,不合格
20114036,25,31,3,8,67,134,不合格
20114037,91,14,77,63,83,328,合格
20114038,7,22,75,4,28,136,不合格
20114039,30,5,15,49,53,152,不合格
20114040,20,75,27,22,51,195,不合格
20114041,9,18,55,4,7,93,不合格
20114042,32,7,60,23,75,197,不合格
20114043,77,35,23,60,57,252,不合格
20114044,61,48,60,53,49,271,不合格
20114045,6,71,0,94,13,184,不合格
20114046,55,91,50,70,62,328,合格
20114047,28,52,48,54,63,245,不合格
20114048,33,12,98,46,47,236,不合格
20114049,32,96,49,43,45,265,不合格
20114050,74,95,9,2,60,240,不合格
20114051,29,62,62,31,94,278,不合格
20114052,20,3,2,91,33,149,不合格
20114053,42,99,6,47,22,216,不合格
20114054,69,13,36,67,10,195,不合格
20114055,98,71,64,98,58,389,合格
20114056,81,24,58,57,32,252,不合格
20114057,60,70,24,79,7,240,不合格
20114058,24,66,24,27,73,214,不合格
20114059,49,74,63,26,62,274,不合格
20114060,2,75,30,51,14,172,不合格
20114061,57,41,39,50,79,266,不合格
20114062,58,98,18,62,87,323,合格
20114063,91,10,12,79,38,230,不合格
20114064,91,75,62,99,93,420,合格
20114065,11,31,69,16,39,166,不合格
20114066,98,39,57,51,50,295,不合格
20114067,10,80,30,62,34,216,不合格
20114068,62,56,67,78,90,353,合格
20114069,13,87,54,5,26,185,不合格
20114070,90,45,54,23,89,301,合格
20114071,44,81,21,71,22,239,不合格
20114072,51,20,17,15,1,104,不合格
20114073,64,10,34,84,59,251,不合格
20114074,86,7,3,35,84,215,不合格
20114075,18,14,62,4,63,161,不合格
20114076,84,89,13,90,36,312,合格
20114077,49,37,28,40,16,170,不合格
20114078,10,72,85,23,12,202,不合格
20114079,86,8,41,89,89,313,合格
20114080,27,85,20,71,47,250,不合格
20114081,59,48,17,70,65,259,不合格
20114082,88,4,6,69,43,210,不合格
20114083,53,8,18,5,22,106,不合格
20114084,82,59,87,72,9,309,合格
20114085,3,2,7,34,44,90,不合格
20114086,80,40,0,12,44,176,不合格
20114087,77,68,57,99,37,338,合格
20114088,58,68,21,74,40,261,不合格
20114089,80,11,20,88,11,210,不合格
20114090,24,34,27,70,15,170,不合格
20114091,96,55,73,67,21,312,合格
20114092,37,17,2,55,49,160,不合格
20114093,33,63,17,51,21,185,不合格
20114094,28,47,72,48,75,270,不合格
20114095,49,86,49,7,8,199,不合格
20114096,97,99,28,5,60,289,不合格
20114097,38,55,30,56,36,215,不合格
20114098,62,13,94,49,17,235,不合格
20114099,58,30,23,38,48,197,不合格
20114100,77,71,73,29,45,295,不合格
20114101,10,35,94,79,37,255,不合格
20114102,73,93,63,15,96,340,合格
20114103,82,3,52,89,93,319,合格
20114104,14,63,99,26,77,279,不合格
20114105,8,56,69,85,46,264,不合格
20114106,21,44,53,0,71,189,不合格
20114107,63,66,6,54,10,199,不合格
20114108,88,68,68,81,11,316,合格
20114109,44,99,12,62,35,252,不合格
20114110,6,72,2,47,9,136,不合格
20114111,69,3,90,46,29,237,不合格
20114112,99,90,45,44,78,356,合格
20114113,74,42,45,59,61,281,不合格
20114114,54,57,74,0,57,242,不合格
20114115,68,16,95,3,50,232,不合格
20114116,11,5,14,81,48,159,不合格
20114117,40,40,95,93,93,361,合格
20114118,89,54,8,48,69,268,不合格
20114119,96,8,20,27,52,203,不合格
20114120,97,70,3,95,68,333,合格
20114121,13,61,59,84,3,220,不合格
20114122,60,29,29,4,17,139,不合格
20114123,93,83,98,8,11,293,不合格
20114124,39,38,35,94,52,258,不合格
20114125,7,4,27,16,80,134,不合格
20114126,40,22,94,20,77,253,不合格
20114127,15,46,97,19,10,187,不合格
20114128,39,16,42,73,94,264,不合格
20114129,10,55,80,52,16,213,不合格
20114130,39,37,7,5,94,182,不合格
20114131,65,28,0,65,6,164,不合格
20114132,90,35,9,33,16,183,不合格
20114133,16,24,25,64,81,210,不合格
20114134,51,60,69,84,11,275,不合格
20114135,53,33,47,56,59,248,不合格
20114136,12,39,48,14,57,170,不合格
20114137,30,55,42,34,96,257,不合格
20114138,51,69,88,73,52,333,合格
20114139,93,50,37,43,87,310,合格
20114140,18,63,67,22,33,203,不合格
20114141,50,91,16,54,95,306,合格
20114142,50,60,52,10,32,204,不合格
20114143,12,7,5,19,26,69,不合格
20114144,38,72,27,59,19,215,不合格
20114145,89,84,47,15,14,249,不合格
20114146,50,36,62,99,29,276,不合格
20114147,82,14,13,99,54,262,不合格
20114148,98,43,7,32,1,181,不合格
20114149,69,54,72,52,93,340,合格
20114150,55,66,14,59,55,249,不合格
20114151,58,17,86,7,78,246,不合格
20114152,18,87,99,24,1,229,不合格
20114153,67,48,82,61,69,327,合格
20114154,16,93,88,8,74,279,不合格
20114155,76,19,38,2,86,221,不合格
20114156,26,90,81,20,68,285,不合格
20114157,4,24,30,30,58,146,不合格
20114158,84,31,5,91,4,215,不合格
20114159,9,37,41,64,60,211,不合格
20114160,86,91,42,83,47,349,合格
20114161,0,92,6,45,97,240,不合格
20114162,54,53,55,3,60,225,不合格
20114163,80,28,49,43,53,253,不合格
20114164,80,37,10,82,59,268,不合格
20114165,5,39,99,6,30,179,不合格
20114166,18,81,78,11,4,192,不合格
20114167,33,99,55,68,28,283,不合格
20114168,95,17,4,48,69,233,不合格
20114169,65,24,50,67,54,260,不合格
20114170,28,75,66,54,52,275,不合格
20114171,96,94,31,16,63,300,合格
20114172,31,47,86,48,29,241,不合格
20114173,35,85,13,6,42,181,不合格
20114174,61,21,41,4,45,172,不合格
20114175,60,73,44,49,41,267,不合格
20114176,38,61,56,13,43,211,不合格
20114177,57,79,68,97,46,347,合格
20114178,12,70,25,93,43,243,不合格
20114179,74,33,26,26,73,232,不合格
20114180,73,30,60,97,93,353,合格
20114181,93,67,19,71,32,282,不合格
20114182,22,73,86,18,47,246,不合格
20114183,97,72,13,24,39,245,不合格
20114184,46,2,69,21,96,234,不合格
20114185,18,33,94,15,41,201,不合格
20114186,75,79,30,61,68,313,合格
20114187,49,30,54,55,84,272,不合格
20114188,5,47,87,86,15,240,不合格
20114189,45,71,10,18,76,220,不合格
20114190,15,14,43,2,47,121,不合格
20114191,71,46,55,44,57,273,不合格
20114192,74,37,82,6,62,261,不合格
20114193,63,83,55,0,1,202,不合格
20114194,66,32,79,51,89,317,合格
20114195,34,63,52,65,37,251,不合格
20114196,48,21,78,57,98,302,合格
20114197,73,91,3,99,51,317,合格
20114198,47,69,2,93,23,234,不合格
20114199,74,70,57,40,41,282,不合格
20114200,65,84,4,84,26,263,不合格
20114201,16,60,7,1,37,121,不合格
20114202,26,76,81,68,87,338,合格
20114203,13,60,70,52,90,285,不合格
20114204,82,37,39,29,82,269,不合格
20114205,86,41,93,80,85,385,合格
20114206,50,80,79,32,1,242,不合格
20114207,54,46,9,66,28,203,不合格
20114208,55,75,29,34,67,260,不合格
20114209,63,91,16,23,49,242,不合格
20114210,3,82,67,39,49,240,不合格
20114211,10,19,52,15,34,130,不合格
20114212,54,38,26,34,23,175,不合格
20114213,27,59,78,21,24,209,不合格
20114214,67,65,59,89,58,338,合格
20114215,25,41,67,92,91,316,合格
20114216,97,21,77,44,13,252,不合格
20114217,46,93,37,3,61,240,不合格
20114218,38,60,61,49,35,243,不合格
20114219,70,30,37,34,65,236,不合格
20114220,79,92,83,22,10,286,不合格
20114221,25,56,67,39,30,217,不合格
20114222,33,60,61,53,59,266,不合格
20114223,95,39,84,53,10,281,不合格
20114224,81,5,3,49,92,230,不合格
20114225,64,29,6,74,56,229,不合格
20114226,23,76,91,70,99,359,合格
20114227,70,85,32,90,57,334,合格
20114228,2,21,6,83,2,114,不合格
20114229,20,96,11,12,41,180,不合格
20114230,25,11,17,50,56,159,不合格
20114231,45,28,39,48,81,241,不合格
20114232,1,7,62,73,82,225,不合格
20114233,28,13,59,32,94,226,不合格
20114234,16,62,44,55,99,276,不合格
20114235,33,55,50,22,84,244,不合格
20114236,23,84,11,71,21,210,不合格
20114237,17,99,60,5,38,219,不合格
20114238,56,80,83,78,73,370,合格
20114239,31,92,98,12,18,251,不合格
20114240,52,9,69,24,66,220,不合格
20114241,0,76,67,1,11,155,不合格
20114242,18,86,27,53,62,246,不合格
20114243,35,9,79,53,44,220,不合格
20114244,98,52,67,7,67,291,不合格
20114245,23,25,60,81,5,194,不合格
20114246,1,31,56,84,64,236,不合格
20114247,12,17,14,6,83,132,不合格
20114248,26,58,68,59,16,227,不合格
20114249,46,16,49,37,61,209,不合格
20114250,84,83,53,4,39,263,不合格
20114251,18,51,28,15,40,152,不合格
20114252,83,8,57,82,82,312,合格
20114253,19,5,1,86,79,190,不合格
20114254,70,89,44,97,52,352,合格
20114255,39,60,48,82,80,309,合格
20114256,77,51,87,21,63,299,不合格
20114257,4,42,75,22,55,198,不合格
20114258,35,84,49,20,78,266,不合格
20114259,51,95,75,38,52,311,合格
20114260,53,14,82,9,59,217,不合格
20114261,58,32,98,82,41,311,合格
20114262,57,84,9,88,71,309,合格
20114263,60,87,47,88,29,311,合格
20114264,70,76,14,94,57,311,合格
20114265,28,9,23,35,39,134,不合格
20114266,67,61,16,75,69,288,不合格
20114267,10,87,67,98,0,262,不合格
20114268,8,42,74,95,0,219,不合格
20114269,43,41,66,34,44,228,不合格
20114270,61,3,19,54,73,210,不合格
20114271,80,52,98,79,74,383,合格
20114272,21,97,9,98,41,266,不合格
20114273,31,25,9,33,52,150,不合格
20114274,93,53,84,65,76,371,合格
20114275,77,43,27,32,48,227,不合格
20114276,48,6,60,38,75,227,不合格
20114277,1,59,18,74,72,224,不合格
20114278,8,11,39,17,97,172,不合格
20114279,22,81,73,25,39,240,不合格
20114280,33,69,28,77,27,234,不合格
20114281,36,40,97,18,37,228,不合格
20114282,21,82,18,18,22,161,不合格
20114283,76,46,35,88,86,331,合格
20114284,18,9,50,42,34,153,不合格
20114285,30,25,9,49,57,170,不合格
20114286,95,31,15,87,1,229,不合格
20114287,97,50,71,87,3,308,合格
20114288,18,17,50,58,93,236,不合格
20114289,5,39,0,65,84,193,不合格
20114290,34,14,63,46,84,241,不合格
20114291,49,49,84,10,29,221,不合格
20114292,35,29,61,55,21,201,不合格
20114293,8,39,68,20,62,197,不合格
20114294,62,2,44,87,68,263,不合格
20114295,5,68,43,63,33,212,不合格
20114296,59,93,71,84,82,389,合格
20114297,88,33,56,95,89,361,合格
20114298,56,38,42,50,27,213,不合格
20114299,5,54,41,54,87,241,不合格
20114300,39,46,9,48,40,182,不合格
20114301,0,4,96,38,90,228,不合格
20114302,26,47,33,61,91,258,不合格
20114303,28,61,35,67,84,275,不合格
20114304,34,32,9,44,75,194,不合格
20114305,31,59,43,34,0,167,不合格
20114306,79,63,67,63,83,355,合格
20114307,57,6,71,79,39,252,不合格
20114308,57,52,39,78,42,268,不合格
20114309,87,25,85,58,43,298,不合格
20114310,86,80,90,7,8,271,不合格
20114311,97,87,96,44,83,407,合格
20114312,66,99,16,50,26,257,不合格
20114313,9,26,59,94,3,191,不合格
20114314,33,96,7,40,80,256,不合格
20114315,61,86,34,14,53,248,不合格
20114316,52,45,80,36,34,247,不合格
20114317,76,76,83,83,8,326,合格
20114318,87,72,98,4,81,342,合格
20114319,24,43,37,93,97,294,不合格
20114320,73,61,15,43,64,256,不合格
20114321,20,37,71,83,53,264,不合格
20114322,24,15,56,51,67,213,不合格
20114323,40,0,27,56,42,165,不合格
20114324,28,71,0,19,12,130,不合格
20114325,61,60,44,1,64,230,不合格
20114326,79,74,64,13,48,278,不合格
20114327,24,36,35,74,7,176,不合格
20114328,98,9,17,1,68,193,不合格
20114329,12,85,62,81,12,252,不合格
20114330,43,53,42,93,33,264,不合格
20114331,47,60,97,42,4,250,不合格
20114332,82,34,54,26,84,280,不合格
20114333,77,79,64,93,5,318,合格
20114334,25,34,69,81,28,237,不合格
20114335,74,36,86,28,75,299,不合格
20114336,12,4,38,19,97,170,不合格
20114337,88,82,48,28,72,318,合格
20114338,18,18,1,29,92,158,不合格
20114339,99,84,5,87,79,354,合格
20114340,73,71,72,68,63,347,合格
20114341,38,43,19,41,96,237,不合格
20114342,67,14,4,37,6,128,不合格
20114343,9,7,50,84,91,241,不合格
20114344,20,23,1,94,27,165,不合格
20114345,20,5,83,7,49,164,不合格
20114346,75,83,84,81,2,325,合格
20114347,27,39,37,41,75,219,不合格
20114348,42,68,54,21,33,218,不合格
20114349,63,41,57,95,70,326,合格
20114350,18,80,46,46,23,213,不合格
20114351,78,69,50,32,59,288,不合格
20114352,6,76,72,94,73,321,合格
20114353,54,74,85,39,92,344,合格
20114354,12,63,18,72,1,166,不合格
20114355,80,85,56,49,95,365,合格
20114356,25,34,23,20,0,102,不合格
20114357,69,42,64,66,44,285,不合格
20114358,39,83,93,23,72,310,合格
20114359,58,1,74,19,12,164,不合格
20114360,33,99,58,37,19,246,不合格
20114361,55,61,80,12,1,209,不合格
20114362,49,24,6,21,53,153,不合格
20114363,94,16,34,67,84,295,不合格
20114364,60,21,26,93,21,221,不合格
20114365,1,94,81,29,75,280,不合格
20114366,82,5,41,76,87,291,不合格
20114367,73,28,47,78,68,294,不合格
20114368,75,14,56,70,94,309,合格
20114369,75,28,6,85,33,227,不合格
20114370,98,98,34,34,95,359,合格
20114371,10,28,52,65,55,210,不合格
20114372,24,85,66,4,12,191,不合格
20114373,65,54,30,41,52,242,不合格
20114374,61,23,26,9,49,168,不合格
20114375,24,9,26,33,40,132,不合格
20114376,81,75,55,28,7,246,不合格
20114377,6,43,35,49,21,154,不合格
20114378,3,68,11,39,42,163,不合格
20114379,45,92,59,79,42,317,合格
20114380,63,23,59,27,92,264,不合格
20114381,15,14,0,93,87,209,不合格
20114382,58,70,32,33,52,245,不合格
20114383,92,56,82,18,99,347,合格
20114384,38,69,34,76,65,282,不合格
20114385,34,4,16,88,13,155,不合格
20114386,24,40,59,54,59,236,不合格
20114387,53,44,0,76,94,267,不合格
20114388,43,42,7,37,3,132,不合格
20114389,59,42,92,80,97,370,合格
20114390,73,40,67,32,97,309,合格
20114391,11,33,24,86,95,249,不合格
20114392,51,49,27,6,95,228,不合格
20114393,50,55,74,2,96,277,不合格
20114394,97,7,96,34,86,320,合格
20114395,56,77,38,91,22,284,不合格
20114396,54,7,77,59,26,223,不合格
20114397,25,18,84,47,72,246,不合格
20114398,61,55,81,41,39,277,不合格
20114399,49,46,58,87,18,258,不合格
20114400,24,0,1,23,35,83,不合格
20114401,8,17,50,79,2,156,不合格
20114402,70,68,17,73,35,263,不合格
20114403,87,8,62,51,48,256,不合格
20114404,33,66,88,21,52,260,不合格
20114405,10,58,77,82,16,243,不合格
20114406,98,38,38,94,33,301,合格
20114407,50,13,95,69,22,249,不合格
20114408,68,10,33,89,69,269,不合格
20114409,64,94,79,10,33,280,不合格
20114410,3,40,55,25,10,133,不合格
20114411,93,67,24,50,57,291,不合格
20114412,85,40,37,57,33,252,不合格
20114413,15,35,98,36,39,223,不合格
20114414,78,49,63,13,88,291,不合格
20114415,30,42,21,12,71,176,不合格
20114416,81,22,2,27,97,229,不合格
20114417,46,24,44,46,28,188,不合格
20114418,83,69,91,35,87,365,合格
20114419,5,95,57,18,72,247,不合格
20114420,11,65,38,14,88,216,不合格
20114421,15,1,65,6,95,182,不合格
20114422,47,82,10,65,20,224,不合格
20114423,12,3,54,70,1,140,不合格
20114424,32,92,32,73,94,323,合格
20114425,29,98,32,87,47,293,不合格
20114426,0,2,99,23,95,219,不合格
20114427,27,38,34,7,13,119,不合格
20114428,53,74,25,60,89,301,合格
20114429,39,71,59,24,41,234,不合格
20114430,97,42,49,11,33,232,不合格
20114431,85,72,54,18,99,328,合格
20114432,6,9,34,58,67,174,不合格
20114433,30,6,22,50,19,127,不合格
20114434,43,51,9,96,85,284,不合格
20114435,82,64,82,47,31,306,合格
20114436,4,44,65,79,2,194,不合格
20114437,53,96,46,65,86,346,合格
20114438,21,20,42,26,88,197,不合格
20114439,89,70,7,57,76,299,不合格
20114440,56,50,79,22,3,210,不合格
20114441,75,60,39,35,0,209,不合格
20114442,97,41,32,95,0,265,不合格
20114443,86,18,10,72,88,274,不合格
20114444,53,66,75,14,43,251,不合格
20114445,32,14,48,52,10,156,不合格
20114446,8,67,65,89,28,257,不合格
20114447,57,78,98,20,12,265,不合格
20114448,11,82,85,28,38,244,不合格
20114449,99,17,13,6,83,218,不合格
20114450,77,67,3,54,26,227,不合格
20114451,59,66,61,18,83,287,不合格
20114452,44,8,54,41,6,153,不合格
20114453,30,49,5,30,12,126,不合格
20114454,97,84,47,69,40,337,合格
20114455,39,9,43,11,93,195,不合格
20114456,72,38,67,41,62,280,不合格
20114457,93,13,98,86,88,378,合格
20114458,33,61,77,59,44,274,不合格
20114459,11,38,36,91,40,216,不合格
20114460,58,43,12,61,53,227,不合格
20114461,0,60,48,34,63,205,不合格
20114462,21,44,57,92,30,244,不合格
20114463,97,54,97,56,40,344,合格
20114464,30,79,92,2,62,265,不合格
20114465,37,93,14,82,63,289,不合格
20114466,74,13,22,83,74,266,不合格
20114467,90,92,84,9,49,324,合格
20114468,22,38,59,49,60,228,不合格
20114469,75,8,46,97,83,309,合格
20114470,99,54,4,64,45,266,不合格
20114471,86,93,62,43,21,305,合格
20114472,38,0,33,69,11,151,不合格
20114473,25,44,65,74,68,276,不合格
20114474,40,23,0,83,52,198,不合格
20114475,60,84,73,37,29,283,不合格
20114476,88,76,17,93,5,279,不合格
20114477,67,2,52,46,23,190,不合格
20114478,18,18,97,45,49,227,不合格
20114479,0,49,67,94,17,227,不合格
20114480,50,97,4,68,18,237,不合格
20114481,1,89,41,45,72,248,不合格
20114482,18,9,79,41,26,173,不合格
20114483,74,4,12,76,85,251,不合格
20114484,60,0,65,19,55,199,不合格
20114485,80,92,28,29,95,324,合格
20114486,59,36,54,33,39,221,不合格
20114487,79,85,66,3,26,259,不合格
20114488,42,30,8,87,24,191,不合格
20114489,51,77,73,40,91,332,合格
20114490,82,81,69,28,46,306,合格
20114491,8,13,91,90,26,228,不合格
20114492,45,75,13,6,23,162,不合格
20114493,73,44,96,21,81,315,合格
20114494,71,48,73,78,36,306,合格
20114495,12,29,11,86,89,227,不合格
20114496,79,11,28,50,93,261,不合格
20114497,72,58,33,61,11,235,不合格
20114498,34,94,73,28,87,316,合格
20114499,86,86,61,76,24,333,合格
20114500,94,10,98,23,77,302,合格
20114501,89,64,95,70,27,345,合格
20114502,3,68,21,21,33,146,不合格
20114503,25,27,40,44,83,219,不合格
20114504,2,49,9,21,58,139,不合格
20114505,1,35,16,0,99,151,不合格
20114506,29,84,29,27,17,186,不合格
20114507,14,22,20,77,1,134,不合格
20114508,7,52,31,6,86,182,不合格
20114509,20,47,32,9,70,178,不合格
20114510,89,3,15,7,79,193,不合格
20114511,10,36,65,68,89,268,不合格
20114512,44,98,50,31,2,225,不合格
20114513,1,35,94,29,54,213,不合格
20114514,1,1,44,67,85,198,不合格
20114515,31,42,27,52,58,210,不合格
20114516,47,8,41,13,7,116,不合格
20114517,27,40,94,53,41,255,不合格
20114518,17,17,47,23,12,116,不合格
20114519,70,63,78,41,39,291,不合格
20114520,21,81,41,24,21,188,不合格
20114521,24,97,55,31,44,251,不合格
20114522,39,54,69,51,93,306,合格
20114523,42,76,63,18,73,272,不合格
20114524,77,68,16,48,3,212,不合格
20114525,66,98,83,24,7,278,不合格
20114526,16,7,22,52,21,118,不合格
20114527,2,83,75,36,98,294,不合格
20114528,56,28,44,45,11,184,不合格
20114529,56,99,94,5,59,313,合格
20114530,84,78,27,12,56,257,不合格
20114531,74,85,29,98,54,340,合格
20114532,21,68,58,63,43,253,不合格
20114533,4,51,2,26,85,168,不合格
20114534,11,30,37,10,72,160,不合格
20114535,61,24,61,90,52,288,不合格
20114536,18,34,70,64,31,217,不合格
20114537,3,40,53,12,73,181,不合格
20114538,50,21,23,14,64,172,不合格
20114539,92,75,43,57,38,305,合格
20114540,89,37,5,22,30,183,不合格
20114541,17,28,94,29,22,190,不合格
20114542,95,9,18,49,23,194,不合格
20114543,22,6,16,28,41,113,不合格
20114544,83,85,6,64,78,316,合格
20114545,9,39,42,10,8,108,不合格
20114546,75,40,11,78,50,254,不合格
20114547,1,35,84,76,47,243,不合格
20114548,93,25,98,13,54,283,不合格
20114549,50,63,10,50,80,253,不合格
20114550,10,98,7,68,42,225,不合格
20114551,60,94,50,40,39,283,不合格
20114552,48,57,45,3,9,162,不合格
20114553,23,37,23,90,40,213,不合格
20114554,78,23,10,11,13,135,不合格
20114555,31,95,92,6,54,278,不合格
20114556,34,57,61,2,38,192,不合格
20114557,49,78,23,68,29,247,不合格
20114558,95,71,90,46,80,382,合格
20114559,40,59,0,16,37,152,不合格
20114560,16,20,55,89,72,252,不合格
20114561,55,92,97,78,44,366,合格
20114562,40,88,30,59,63,280,不合格
20114563,49,35,9,78,22,193,不合格
20114564,11,0,36,83,77,207,不合格
20114565,41,11,2,77,49,180,不合格
20114566,24,33,59,92,95,303,合格
20114567,92,5,86,89,33,305,合格
20114568,61,62,18,47,33,221,不合格
20114569,34,13,89,89,38,263,不合格
20114570,24,82,46,16,89,257,不合格
20114571,43,82,77,38,13,253,不合格
20114572,92,49,4,82,46,273,不合格
20114573,51,83,85,0,89,308,合格
20114574,67,7,44,30,86,234,不合格
20114575,94,10,27,2,75,208,不合格
20114576,11,55,99,44,69,278,不合格
20114577,46,74,99,64,10,293,不合格
20114578,18,75,30,5,34,162,不合格
20114579,72,66,63,90,84,375,合格
20114580,97,53,26,35,8,219,不合格
20114581,99,90,51,51,31,322,合格
20114582,0,61,71,93,86,311,合格
20114583,85,92,6,9,23,215,不合格
20114584,62,10,95,9,48,224,不合格
20114585,91,39,90,87,3,310,合格
20114586,56,48,17,93,87,301,合格
20114587,44,79,39,62,92,316,合格
20114588,35,29,14,45,62,185,不合格
20114589,38,6,30,95,83,252,不合格
20114590,37,7,52,33,13,142,不合格
20114591,96,8,61,32,25,222,不合格
20114592,86,99,29,38,53,305,合格
20114593,15,63,69,75,21,243,不合格
20114594,59,14,56,42,89,260,不合格
20114595,29,13,12,96,45,195,不合格
20114596,80,52,66,43,86,327,合格
20114597,32,89,41,86,58,306,合格
20114598,55,28,71,49,55,258,不合格
20114599,88,13,31,21,50,203,不合格
20114600,18,20,27,88,10,163,不合格
20114601,17,32,43,11,90,193,不合格
20114602,62,39,59,5,41,206,不合格
20114603,74,20,54,39,89,276,不合格
20114604,73,49,2,8,26,158,不合格
20114605,39,73,37,17,31,197,不合格
20114606,33,27,16,54,78,208,不合格
20114607,89,56,97,53,35,330,合格
20114608,70,19,51,18,29,187,不合格
20114609,31,41,63,4,11,150,不合格
20114610,8,84,16,1,93,202,不合格
20114611,16,48,93,8,63,228,不合格
20114612,62,25,58,52,58,255,不合格
20114613,51,17,16,44,61,189,不合格
20114614,18,96,65,8,34,221,不合格
20114615,52,44,9,83,34,222,不合格
20114616,63,79,96,79,1,318,合格
20114617,67,18,25,40,95,245,不合格
20114618,85,45,89,82,90,391,合格
20114619,98,4,54,1,40,197,不合格
20114620,61,79,33,37,53,263,不合格
20114621,13,51,71,78,61,274,不合格
20114622,56,23,63,66,71,279,不合格
20114623,7,27,66,9,75,184,不合格
20114624,97,86,26,68,52,329,合格
20114625,49,6,59,60,95,269,不合格
20114626,8,76,10,20,19,133,不合格
20114627,31,95,18,3,72,219,不合格
20114628,32,44,98,56,93,323,合格
20114629,38,32,38,43,53,204,不合格
20114630,77,52,13,18,52,212,不合格
20114631,58,76,21,54,30,239,不合格
20114632,58,89,5,61,42,255,不合格
20114633,59,53,9,25,39,185,不合格
20114634,60,80,55,7,7,209,不合格
20114635,17,24,35,92,91,259,不合格
20114636,17,68,10,21,48,164,不合格
20114637,40,4,72,85,96,297,不合格
20114638,52,91,57,19,80,299,不合格
20114639,60,5,14,79,33,191,不合格
20114640,66,13,42,36,40,197,不合格
20114641,59,6,68,96,28,257,不合格
20114642,1,58,77,70,85,291,不合格
20114643,72,38,64,19,27,220,不合格
20114644,96,43,52,72,87,350,合格
20114645,19,69,92,99,53,332,合格
20114646,7,22,60,52,85,226,不合格
20114647,30,63,54,2,67,216,不合格
20114648,42,74,15,75,93,299,不合格
20114649,44,28,48,58,46,224,不合格
20114650,22,42,37,80,16,197,不合格
20114651,38,1,82,55,72,248,不合格
20114652,91,70,92,79,43,375,合格
20114653,53,97,46,36,1,233,不合格
20114654,23,71,62,45,70,271,不合格
20114655,66,69,62,97,97,391,合格
20114656,85,35,10,10,45,185,不合格
20114657,21,33,74,34,80,242,不合格
20114658,44,36,82,59,38,259,不合格
20114659,26,45,81,50,48,250,不合格
20114660,7,84,36,14,24,165,不合格
20114661,22,15,14,99,50,200,不合格
20114662,12,53,62,14,14,155,不合格
20114663,33,22,59,54,33,201,不合格
20114664,6,99,62,26,86,279,不合格
20114665,79,16,28,72,64,259,不合格
20114666,73,79,49,36,27,264,不合格
20114667,10,56,42,8,45,161,不合格
20114668,44,97,81,5,15,242,不合格
20114669,40,25,14,41,17,137,不合格
20114670,8,94,72,38,43,255,不合格
20114671,99,71,63,77,42,352,合格
20114672,42,75,69,45,59,290,不合格
20114673,80,10,63,7,59,219,不合格
20114674,77,46,75,64,89,351,合格
20114675,37,62,30,77,5,211,不合格
20114676,24,72,10,1,36,143,不合格
20114677,0,57,42,60,15,174,不合格
20114678,74,60,74,80,54,342,合格
20114679,76,60,49,76,70,331,合格
20114680,94,22,61,62,68,307,合格
20114681,5,30,57,88,3,183,不合格
20114682,96,30,84,93,37,340,合格
20114683,18,29,84,92,4,227,不合格
20114684,78,49,66,76,36,305,合格
20114685,10,28,52,20,64,174,不合格
20114686,74,93,75,64,78,384,合格
20114687,5,0,32,38,94,169,不合格
20114688,50,81,31,34,67,263,不合格
20114689,80,35,5,95,63,278,不合格
20114690,53,24,88,84,63,312,合格
20114691,42,81,63,24,36,246,不合格
20114692,68,92,86,0,53,299,不合格
20114693,42,99,66,61,35,303,合格
20114694,34,65,1,38,66,204,不合格
20114695,57,89,26,99,95,366,合格
20114696,70,25,89,82,38,304,合格
20114697,58,48,69,91,49,315,合格
20114698,83,77,94,96,56,406,合格
20114699,12,50,36,52,27,177,不合格
20114700,81,47,24,92,41,285,不合格
20114701,72,15,52,65,58,262,不合格
20114702,83,51,56,40,52,282,不合格
20114703,15,41,53,2,80,191,不合格
20114704,87,15,84,35,33,254,不合格
20114705,33,89,84,59,4,269,不合格
20114706,60,17,95,60,62,294,不合格
20114707,65,0,43,61,44,213,不合格
20114708,14,47,58,83,35,237,不合格
20114709,14,23,37,15,27,116,不合格
20114710,44,88,18,43,65,258,不合格
20114711,31,1,65,20,99,216,不合格
20114712,57,60,27,17,92,253,不合格
20114713,83,15,36,88,65,287,不合格
20114714,30,91,83,67,49,320,合格
20114715,7,87,15,45,2,156,不合格
20114716,93,66,42,70,10,281,不合格
20114717,78,26,32,43,48,227,不合格
20114718,34,2,52,26,94,208,不合格
20114719,65,59,69,36,63,292,不合格
20114720,14,39,86,11,60,210,不合格
20114721,32,31,0,84,57,204,不合格
20114722,48,91,15,98,47,299,不合格
20114723,4,12,42,10,25,93,不合格
20114724,43,83,10,55,46,237,不合格
20114725,92,22,10,14,18,156,不合格
20114726,40,63,23,41,94,261,不合格
20114727,90,82,51,2,1,226,不合格
20114728,17,58,6,50,23,154,不合格
20114729,54,85,55,56,97,347,合格
20114730,63,57,24,17,13,174,不合格
20114731,39,74,20,92,58,283,不合格
20114732,77,2,57,96,56,288,不合格
20114733,69,57,36,89,85,336,合格
20114734,75,3,25,51,59,213,不合格
20114735,28,81,42,52,97,300,合格
20114736,5,81,7,33,35,161,不合格
20114737,49,60,0,57,22,188,不合格
20114738,11,98,60,62,6,237,不合格
20114739,95,16,13,18,5,147,不合格
20114740,2,17,0,35,69,123,不合格
20114741,12,41,73,97,72,295,不合格
20114742,12,88,53,41,28,222,不合格
20114743,65,91,83,66,60,365,合格
20114744,2,24,67,28,69,190,不合格
20114745,9,41,33,66,81,230,不合格
20114746,30,76,33,2,7,148,不合格
20114747,85,22,63,46,53,269,不合格
20114748,33,82,79,38,27,259,不合格
20114749,95,60,82,10,44,291,不合格
20114750,32,32,34,67,16,181,不合格
20114751,12,49,18,10,87,176,不合格
20114752,87,98,65,20,16,286,不合格
20114753,97,8,91,76,93,365,合格
20114754,34,72,43,51,16,216,不合格
20114755,60,93,33,43,23,252,不合格
20114756,29,81,41,80,23,254,不合格
20114757,39,11,78,74,39,241,不合格
20114758,20,16,22,78,30,166,不合格
20114759,58,71,8,89,78,304,合格
20114760,77,29,97,30,91,324,合格
20114761,66,11,53,13,24,167,不合格
20114762,72,32,24,31,87,246,不合格
20114763,73,42,19,17,90,241,不合格
20114764,75,42,3,91,92,303,合格
20114765,76,0,7,34,84,201,不合格
20114766,89,15,45,95,76,320,合格
20114767,35,1,26,35,45,142,不合格
20114768,73,40,88,6,34,241,不合格
20114769,87,23,32,72,82,296,不合格
20114770,35,94,32,77,49,287,不合格
20114771,56,36,70,0,94,256,不合格
20114772,56,15,27,54,82,234,不合格
20114773,67,91,96,39,18,311,合格
20114774,62,95,60,51,89,357,合格
20114775,89,85,13,85,81,353,合格
20114776,0,66,1,7,31,105,不合格
20114777,20,8,37,84,34,183,不合格
20114778,62,3,51,44,79,239,不合格
20114779,64,23,82,12,95,276,不合格
20114780,27,68,53,39,71,258,不合格
20114781,50,47,68,8,72,245,不合格
20114782,82,57,62,20,34,255,不合格
20114783,91,35,29,12,98,265,不合格
20114784,58,83,3,96,72,312,合格
20114785,6,99,29,66,15,215,不合格
20114786,61,41,77,86,17,282,不合格
20114787,86,70,18,41,1,216,不合格
20114788,33,95,47,33,35,243,不合格
20114789,34,0,85,82,67,268,不合格
20114790,66,99,75,46,71,357,合格
20114791,57,76,7,86,16,242,不合格
20114792,78,53,67,82,51,331,合格
20114793,10,79,69,96,22,276,不合格
20114794,48,55,41,17,74,235,不合格
20114795,58,71,35,31,13,208,不合格
20114796,38,59,98,36,87,318,合格
20114797,73,85,12,12,34,216,不合格
20114798,30,77,40,45,29,221,不合格
20114799,50,21,80,39,64,254,不合格
20114800,51,19,33,8,29,140,不合格
20114801,98,68,36,26,87,315,合格
20114802,82,67,72,25,97,343,合格
20114803,53,28,41,33,71,226,不合格
20114804,21,29,79,63,21,213,不合格
20114805,33,67,92,24,91,307,合格
20114806,64,30,91,12,41,238,不合格
20114807,72,91,45,7,65,280,不合格
20114808,1,20,53,81,92,247,不合格
20114809,46,32,28,1,56,163,不合格
20114810,21,12,88,59,28,208,不合格
20114811,71,19,97,3,73,263,不合格
20114812,78,60,65,67,82,352,合格
20114813,49,54,99,94,84,380,合格
20114814,14,44,88,28,44,218,不合格
20114815,92,24,6,96,85,303,合格
20114816,75,64,77,28,1,245,不合格
20114817,39,99,36,59,10,243,不合格
20114818,66,53,47,56,71,293,不合格
20114819,79,66,25,46,90,306,合格
20114820,54,44,82,65,30,275,不合格
20114821,36,20,50,61,53,220,不合格
20114822,18,46,23,70,29,186,不合格
20114823,33,40,58,44,56,231,不合格
20114824,76,1,30,47,50,204,不合格
20114825,43,35,2,41,32,153,不合格
20114826,93,98,93,30,68,382,合格
20114827,77,60,58,26,5,226,不合格
20114828,25,92,52,72,99,340,合格
20114829,57,84,63,57,24,285,不合格
20114830,74,89,76,96,79,414,合格
20114831,0,58,88,26,63,235,不合格
20114832,88,8,27,88,98,309,合格
20114833,38,34,47,72,91,282,不合格
20114834,99,46,99,99,67,410,合格
20114835,83,69,64,0,38,254,不合格
20114836,37,18,27,34,74,190,不合格
20114837,51,0,86,29,44,210,不合格
20114838,17,80,84,27,34,242,不合格
20114839,46,30,25,22,72,195,不合格
20114840,52,95,33,66,10,256,不合格
20114841,3,88,62,30,20,203,不合格
20114842,21,24,50,86,56,237,不合格
20114843,76,30,29,99,98,332,合格
20114844,69,27,74,34,83,287,不合格
20114845,21,78,24,14,79,216,不合格
20114846,5,93,77,42,81,298,不合格
20114847,10,22,72,85,22,211,不合格
20114848,51,36,36,52,9,184,不合格
20114849,8,41,37,57,10,153,不合格
20114850,78,67,67,88,8,308,合格
20114851,58,91,73,14,27,263,不合格
20114852,28,23,55,20,30,156,不合格
20114853,7,9,75,43,15,149,不合格
20114854,1,42,2,81,87,213,不合格
20114855,76,51,60,28,0,215,不合格
20114856,87,11,20,50,58,226,不合格
20114857,11,15,54,5,39,124,不合格
20114858,23,57,49,43,92,264,不合格
20114859,33,92,39,49,4,217,不合格
20114860,75,27,58,48,11,219,不合格
20114861,31,16,19,72,85,223,不合格
20114862,16,63,33,96,46,254,不合格
20114863,70,4,59,69,13,215,不合格
20114864,8,24,87,12,1,132,不合格
20114865,54,19,31,80,98,282,不合格
20114866,85,65,18,87,71,326,合格
20114867,45,78,89,76,16,304,合格
20114868,51,70,77,43,22,263,不合格
20114869,25,54,22,99,7,207,不合格
20114870,21,83,37,39,69,249,不合格
20114871,93,88,40,67,58,346,合格
20114872,5,34,62,92,4,197,不合格
20114873,92,74,98,82,81,427,合格
20114874,23,29,78,2,78,210,不合格
20114875,28,94,8,27,29,186,不合格
20114876,1,87,77,87,15,267,不合格
20114877,47,29,80,68,50,274,不合格
20114878,13,91,47,81,90,322,合格
20114879,87,90,76,25,4,282,不合格
20114880,31,32,57,6,60,186,不合格
20114881,13,76,56,12,34,191,不合格
20114882,91,56,53,19,96,315,合格
20114883,19,37,60,81,75,272,不合格
20114884,82,43,40,38,61,264,不合格
20114885,10,25,97,44,64,240,不合格
20114886,31,2,75,21,76,205,不合格
20114887,12,62,73,27,58,232,不合格
20114888,77,97,79,51,56,360,合格
20114889,52,15,20,25,98,210,不合格
20114890,94,92,50,61,60,357,合格
20114891,72,49,28,13,33,195,不合格
20114892,85,32,19,28,55,219,不合格
20114893,99,97,28,56,50,330,合格
20114894,94,43,60,67,45,309,合格
20114895,53,73,76,40,12,254,不合格
20114896,82,6,90,37,50,265,不合格
20114897,92,55,50,6,50,253,不合格
20114898,9,96,97,82,25,309,合格
20114899,98,65,27,34,38,262,不合格
20114900,57,81,24,24,37,223,不合格
20114901,5,10,35,71,66,187,不合格
20114902,84,95,54,53,59,345,合格
20114903,29,85,2,41,66,223,不合格
20114904,3,51,47,81,83,265,不合格
20114905,26,98,69,41,42,276,不合格
20114906,34,26,19,96,78,253,不合格
20114907,86,16,39,71,47,259,不合格
20114908,53,2,88,48,43,234,不合格
20114909,42,98,73,38,12,263,不合格
20114910,30,56,34,87,29,236,不合格
20114911,39,2,94,20,52,207,不合格
20114912,39,6,43,67,20,175,不合格
20114913,53,58,59,23,94,287,不合格
20114914,87,36,15,21,1,160,不合格
20114915,12,30,8,37,80,167,不合格
20114916,54,15,30,60,15,174,不合格
20114917,89,60,7,73,24,253,不合格
20114918,58,46,9,52,85,250,不合格
20114919,8,95,41,30,22,196,不合格
20114920,15,7,44,95,36,197,不合格
20114921,87,20,16,77,82,282,不合格
20114922,66,41,63,87,7,264,不合格
20114923,12,4,91,29,60,196,不合格
20114924,97,60,26,46,30,259,不合格
20114925,78,37,53,58,85,311,合格
20114926,5,12,44,57,9,127,不合格
20114927,91,38,78,10,4,221,不合格
20114928,58,28,10,63,11,170,不合格
20114929,40,74,44,74,26,258,不合格
20114930,93,61,32,60,37,283,不合格
20114931,24,81,96,37,16,254,不合格
20114932,57,64,29,28,32,210,不合格
20114933,18,6,94,73,26,217,不合格
20114934,38,69,60,2,11,180,不合格
20114935,35,82,7,35,88,247,不合格
20114936,84,81,92,0,35,292,不合格
20114937,32,82,90,64,25,293,不合格
20114938,59,73,17,43,92,284,不合格
20114939,71,80,58,91,78,378,合格
20114940,95,93,34,75,33,330,合格
20114941,59,66,45,17,15,202,不合格
20114942,90,79,8,56,3,236,不合格
20114943,52,20,0,85,83,240,不合格
20114944,58,89,24,87,2,260,不合格
20114945,19,35,68,79,67,268,不合格
20114946,20,7,52,84,88,251,不合格
20114947,92,20,20,49,89,270,不合格
20114948,76,17,24,74,49,240,不合格
20114949,56,0,13,62,70,201,不合格
20114950,53,50,55,33,90,281,不合格
20114951,65,0,48,23,74,210,不合格
20114952,23,77,65,16,74,255,不合格
20114953,8,8,20,28,55,119,不合格
20114954,93,30,30,51,39,243,不合格
20114955,76,7,1,35,11,130,不合格
20114956,50,29,10,52,85,226,不合格
20114957,82,10,39,90,60,281,不合格
20114958,40,42,11,55,39,187,不合格
20114959,16,73,9,54,69,221,不合格
20114960,87,34,93,26,21,261,不合格
20114961,93,54,84,6,54,291,不合格
20114962,27,92,50,10,20,199,不合格
20114963,7,86,8,98,67,266,不合格
20114964,7,83,41,70,3,204,不合格
20114965,70,96,89,12,48,315,合格
20114966,81,7,66,86,16,256,不合格
20114967,61,26,37,41,0,165,不合格
20114968,74,79,60,57,37,307,合格
20114969,59,22,45,39,36,201,不合格
20114970,50,19,46,94,6,215,不合格
20114971,10,67,31,20,68,196,不合格
20114972,31,62,28,90,60,271,不合格
20114973,39,3,9,15,12,78,不合格
20114974,0,15,40,89,82,226,不合格
20114975,92,10,97,42,94,335,合格
20114976,62,7,40,50,26,185,不合格
20114977,59,17,90,88,12,266,不合格
20114978,46,58,71,93,46,314,合格
20114979,12,29,84,98,2,225,不合格
20114980,40,48,92,81,0,261,不合格
20114981,65,79,57,29,37,267,不合格
20114982,28,7,19,68,50,172,不合格
20114983,27,48,26,87,76,264,不合格
20114984,2,85,91,8,25,211,不合格
20114985,61,48,92,6,33,240,不合格
20114986,46,40,66,39,36,227,不合格
20114987,23,30,34,35,90,212,不合格
20114988,23,75,10,35,56,199,不合格
20114989,8,5,48,53,85,199,不合格
20114990,25,47,66,47,0,185,不合格
20114991,56,74,64,93,40,327,合格
20114992,13,1,10,63,49,136,不合格
20114993,7,38,78,42,56,221,不合格
20114994,90,97,98,35,32,352,合格
20114995,47,17,19,18,84,185,不合格
20114996,72,68,52,76,21,289,不合格
20114997,45,27,30,17,40,159,不合格
20114998,97,57,2,56,32,244,不合格
20114999,13,15,15,54,15,112,不合格
20115000,87,23,32,29,85,256,不合格
20115001,51,53,47,70,29,250,不合格
20115002,5,69,23,5,9,111,不合格
20115003,15,67,96,56,15,249,不合格
20115004,50,11,33,77,98,269,不合格
20115005,88,34,0,32,32,186,不合格
20115006,33,28,30,44,17,152,不合格
20115007,12,25,50,28,29,144,不合格
20115008,86,54,65,70,20,295,不合格
20115009,8,62,4,91,46,211,不合格
20115010,73,52,90,76,92,383,合格
20115011,99,68,42,28,45,282,不合格
20115012,51,45,89,91,36,312,合格
20115013,2,13,10,29,32,86,不合格
20115014,96,23,90,36,15,260,不合格
20115015,19,54,38,10,20,141,不合格
20115016,75,19,46,36,76,252,不合格
20115017,31,47,41,4,33,156,不合格
20115018,69,33,82,87,52,323,合格
20115019,23,97,63,81,73,337,合格
20115020,95,49,78,83,81,386,合格
20115021,63,61,1,97,59,281,不合格
20115022,46,17,40,27,4,134,不合格
20115023,83,28,41,19,13,184,不合格
20115024,54,97,8,53,93,305,合格
20115025,92,28,98,90,21,329,合格
20115026,75,87,95,7,66,330,合格
20115027,67,62,83,12,60,284,不合格
20115028,99,60,58,98,83,398,合格
20115029,95,13,70,86,72,336,合格
20115030,3,39,50,33,70,195,不合格
20115031,95,53,5,32,86,271,不合格
20115032,35,92,46,19,22,214,不合格
20115033,20,13,14,52,84,183,不合格
20115034,50,15,91,87,0,243,不合格
20115035,86,67,38,42,16,249,不合格
20115036,81,96,76,72,55,380,合格
20115037,85,79,77,6,65,312,合格
20115038,1,93,87,24,34,239,不合格
20115039,73,70,37,77,50,307,合格
20115040,49,69,1,93,19,231,不合格
20115041,82,18,74,46,34,254,不合格
20115042,73,23,9,27,58,190,不合格
20115043,18,14,67,7,19,125,不合格
20115044,14,30,55,20,92,211,不合格
20115045,46,77,12,68,80,283,不合格
20115046,40,61,2,7,41,151,不合格
20115047,71,5,19,45,2,142,不合格
20115048,13,55,22,69,38,197,不合格
20115049,0,9,61,33,55,158,不合格
20115050,82,6,62,87,20,257,不合格
20115051,11,43,14,31,93,192,不合格
20115052,75,36,24,22,98,255,不合格
20115053,13,8,86,11,53,171,不合格
20115054,95,7,7,35,17,161,不合格
20115055,96,98,10,88,97,389,合格
20115056,70,63,19,69,29,250,不合格
20115057,67,46,74,85,74,346,合格
20115058,45,80,57,93,28,303,合格
20115059,39,51,9,28,45,172,不合格
20115060,68,56,90,57,84,355,合格
20115061,64,44,21,0,62,191,不合格
20115062,82,51,11,7,89,240,不合格
20115063,66,22,37,19,5,149,不合格
20115064,38,35,50,64,8,195,不合格
20115065,95,67,25,91,24,302,合格
20115066,52,17,77,44,79,269,不合格
20115067,70,21,8,17,18,134,不合格
20115068,35,61,18,49,68,231,不合格
20115069,64,37,16,88,78,283,不合格
20115070,84,32,40,40,9,205,不合格
20115071,97,64,39,86,15,301,合格
20115072,72,86,22,29,55,264,不合格
20115073,86,17,14,70,15,202,不合格
20115074,52,29,60,97,16,254,不合格
20115075,49,22,81,0,62,214,不合格
20115076,47,26,49,97,16,235,不合格
20115077,51,21,32,23,47,174,不合格
20115078,13,69,19,36,10,147,不合格
20115079,66,67,2,69,89,293,不合格
20115080,45,34,19,68,9,175,不合格
20115081,69,30,64,25,19,207,不合格
20115082,53,76,92,62,64,347,合格
20115083,42,32,16,0,6,96,不合格
20115084,73,9,59,67,96,304,合格
20115085,37,24,86,39,51,237,不合格
20115086,58,46,96,55,54,309,合格
20115087,75,78,7,41,89,290,不合格
20115088,8,74,77,11,25,195,不合格
20115089,45,78,87,7,1,218,不合格
20115090,72,69,94,51,50,336,合格
20115091,26,36,61,32,48,203,不合格
20115092,97,63,90,94,33,377,合格
20115093,53,95,68,45,2,263,不合格
20115094,58,3,64,73,94,292,不合格
20115095,70,82,34,10,93,289,不合格
20115096,3,57,8,9,77,154,不合格
20115097,59,83,8,55,34,239,不合格
20115098,27,66,19,72,18,202,不合格
20115099,54,50,48,46,48,246,不合格
20115100,72,39,98,98,68,375,合格
20115101,99,73,38,56,29,295,不合格
20115102,68,12,87,22,89,278,不合格
20115103,5,3,81,76,79,244,不合格
20115104,85,18,54,61,37,255,不合格
20115105,87,28,15,21,24,175,不合格
20115106,45,52,28,93,77,295,不合格
20115107,99,79,0,39,92,309,合格
20115108,99,60,54,44,23,280,不合格
20115109,45,42,48,44,21,200,不合格
20115110,56,60,48,70,30,264,不合格
20115111,17,30,57,25,39,168,不合格
20115112,8,87,64,85,49,293,不合格
20115113,44,57,45,14,10,170,不合格
20115114,97,1,46,2,64,210,不合格
20115115,62,56,47,79,95,339,合格
20115116,36,62,16,63,50,227,不合格
20115117,69,31,50,77,14,241,不合格
20115118,79,31,48,67,98,323,合格
20115119,0,64,86,35,90,275,不合格
20115120,96,62,97,38,92,385,合格
20115121,6,88,33,14,36,177,不合格
20115122,28,15,7,23,84,157,不合格
20115123,20,72,63,81,49,285,不合格
20115124,57,67,25,89,97,335,合格
20115125,15,91,67,70,41,284,不合格
20115126,57,47,96,88,28,316,合格
20115127,96,83,19,34,59,291,不合格
20115128,13,58,66,20,91,248,不合格
20115129,45,87,61,41,35,269,不合格
20115130,31,33,40,84,64,252,不合格
20115131,31,93,24,91,97,336,合格
20115132,8,13,48,9,24,102,不合格
20115133,11,32,22,87,42,194,不合格
20115134,19,71,40,75,53,258,不合格
20115135,91,7,35,27,50,210,不合格
20115136,92,69,50,50,84,345,合格
20115137,64,88,92,92,13,349,合格
20115138,31,33,63,38,5,170,不合格
20115139,64,84,44,30,89,311,合格
20115140,62,82,58,43,22,267,不合格
20115141,23,5,74,16,23,141,不合格
20115142,55,58,22,93,33,261,不合格
20115143,89,46,44,55,21,255,不合格
20115144,48,9,50,93,97,297,不合格
20115145,61,4,74,30,91,260,不合格
20115146,81,62,16,98,50,307,合格
20115147,19,99,7,28,18,171,不合格
20115148,83,61,68,48,1,261,不合格
20115149,10,79,88,13,24,214,不合格
20115150,17,80,5,94,65,261,不合格
20115151,91,95,33,68,60,347,合格
20115152,54,38,99,19,29,239,不合格
20115153,17,68,37,53,69,244,不合格
20115154,77,28,56,82,87,330,合格
20115155,25,55,95,61,76,312,合格
20115156,35,82,39,51,77,284,不合格
20115157,64,44,48,47,35,238,不合格
20115158,31,70,72,80,46,299,不合格
20115159,23,64,19,11,85,202,不合格
20115160,63,12,45,96,76,292,不合格
20115161,13,17,12,61,47,150,不合格
20115162,35,41,91,52,49,268,不合格
20115163,82,7,70,6,28,193,不合格
20115164,81,54,6,7,50,198,不合格
20115165,95,25,90,33,11,254,不合格
20115166,99,90,69,24,91,373,合格
20115167,49,28,74,9,17,177,不合格
20115168,14,4,49,5,59,131,不合格
20115169,85,88,61,49,77,360,合格
20115170,64,70,93,9,6,242,不合格
20115171,71,63,77,79,22,312,合格
20115172,20,87,35,82,39,263,不合格
20115173,57,86,27,80,82,332,合格
20115174,61,12,44,52,34,203,不合格
20115175,76,42,9,59,68,254,不合格
20115176,62,65,3,66,89,285,不合格
20115177,58,25,27,82,89,281,不合格
20115178,15,33,65,42,56,211,不合格
20115179,29,46,19,53,97,244,不合格
20115180,9,71,44,89,96,309,合格
20115181,94,62,52,35,7,250,不合格
20115182,85,99,3,90,24,301,合格
20115183,16,42,79,36,68,241,不合格
20115184,78,78,0,97,67,320,合格
20115185,75,26,17,20,98,236,不合格
20115186,76,37,79,26,62,280,不合格
20115187,73,15,35,18,10,151,不合格
20115188,66,74,0,77,89,306,合格
20115189,81,93,43,56,16,289,不合格
20115190,15,2,54,38,61,170,不合格
20115191,79,2,55,32,53,221,不合格
20115192,29,64,96,6,28,223,不合格
20115193,10,4,52,92,97,255,不合格
20115194,32,38,71,6,86,233,不合格
20115195,25,91,3,22,26,167,不合格
20115196,82,40,18,72,71,283,不合格
20115197,6,93,87,21,92,299,不合格
20115198,30,85,66,31,29,241,不合格
20115199,96,72,90,15,89,362,合格
20115200,26,6,87,55,36,210,不合格
20115201,31,26,51,52,95,255,不合格
20115202,85,9,5,96,76,271,不合格
20115203,52,49,50,94,50,295,不合格
20115204,85,88,21,19,47,260,不合格
20115205,83,77,87,58,2,307,合格
20115206,33,26,49,58,5,171,不合格
20115207,33,40,3,29,22,127,不合格
20115208,9,5,86,66,20,186,不合格
20115209,87,48,27,59,29,250,不合格
20115210,58,61,94,3,70,286,不合格
20115211,33,48,60,99,75,315,合格
20115212,0,92,55,12,55,214,不合格
20115213,89,90,58,89,40,366,合格
20115214,93,52,97,75,48,365,合格
20115215,12,8,94,4,80,198,不合格
20115216,62,87,83,82,78,392,合格
20115217,72,66,95,74,37,344,合格
20115218,37,99,35,67,6,244,不合格
20115219,38,74,39,81,27,259,不合格
20115220,8,99,44,73,11,235,不合格
20115221,57,37,71,81,19,265,不合格
20115222,95,39,21,12,20,187,不合格
20115223,93,12,34,61,16,216,不合格
20115224,1,99,23,97,66,286,不合格
20115225,38,21,23,12,90,184,不合格
20115226,97,93,52,84,26,352,合格
20115227,2,18,24,93,0,137,不合格
20115228,15,85,87,96,20,303,合格
20115229,37,53,64,4,93,251,不合格
20115230,48,55,55,23,61,242,不合格
20115231,94,21,30,16,22,183,不合格
20115232,28,95,62,56,9,250,不合格
20115233,56,12,53,63,73,257,不合格
20115234,76,46,36,30,57,245,不合格
20115235,21,39,74,72,12,218,不合格
20115236,86,24,8,0,34,152,不合格
20115237,10,25,1,23,43,102,不合格
20115238,97,17,84,39,36,273,不合格
20115239,51,26,61,26,93,257,不合格
20115240,10,0,72,88,74,244,不合格
20115241,81,41,75,63,82,342,合格
20115242,16,95,79,39,98,327,合格
20115243,37,58,59,8,78,240,不合格
20115244,61,34,2,59,34,190,不合格
20115245,33,89,84,33,69,308,合格
20115246,61,20,0,92,75,248,不合格
20115247,98,22,19,53,5,197,不合格
20115248,67,0,57,42,40,206,不合格
20115249,66,34,78,37,12,227,不合格
20115250,71,92,83,8,18,272,不合格
20115251,59,70,90,44,3,266,不合格
20115252,66,75,83,12,97,333,合格
20115253,46,38,48,28,26,186,不合格
20115254,24,73,8,26,30,161,不合格
20115255,4,86,44,3,12,149,不合格
20115256,94,41,30,19,73,257,不合格
20115257,28,68,18,23,3,140,不合格
20115258,38,33,41,11,22,145,不合格
20115259,28,27,70,36,84,245,不合格
20115260,1,45,50,47,48,191,不合格
20115261,19,71,18,19,63,190,不合格
20115262,26,42,64,13,80,225,不合格
20115263,53,94,24,56,94,321,合格
20115264,92,51,81,61,98,383,合格
20115265,99,97,91,17,67,371,合格
20115266,92,87,45,15,39,278,不合格
20115267,40,32,86,84,81,323,合格
20115268,15,49,80,94,34,272,不合格
20115269,98,15,15,93,70,291,不合格
20115270,32,36,27,81,59,235,不合格
20115271,46,88,67,48,46,295,不合格
20115272,47,44,58,98,19,266,不合格
20115273,19,92,30,88,99,328,合格
20115274,13,64,30,78,65,250,不合格
20115275,79,21,48,20,0,168,不合格
20115276,56,0,44,19,95,214,不合格
20115277,55,6,42,25,21,149,不合格
20115278,49,34,12,83,98,276,不合格
20115279,47,64,94,99,47,351,合格
20115280,58,48,95,94,46,341,合格
20115281,50,70,99,69,65,353,合格
20115282,1,17,71,53,71,213,不合格
20115283,41,72,65,70,82,330,合格
20115284,7,51,47,0,56,161,不合格
20115285,3,72,74,86,8,243,不合格
20115286,49,80,14,23,61,227,不合格
20115287,34,25,8,87,92,246,不合格
20115288,95,84,36,82,35,332,合格
20115289,1,35,60,98,84,278,不合格
20115290,78,55,24,25,90,272,不合格
20115291,25,53,22,23,19,142,不合格
20115292,38,55,58,15,56,222,不合格
20115293,92,36,15,2,57,202,不合格
20115294,11,63,72,87,49,282,不合格
20115295,41,47,92,31,24,235,不合格
20115296,51,58,97,89,81,376,合格
20115297,76,9,85,56,21,247,不合格
20115298,91,48,39,26,95,299,不合格
20115299,84,99,42,53,56,334,合格
20115300,32,4,45,64,97,242,不合格
20115301,26,62,29,15,85,217,不合格
20115302,0,33,99,25,87,244,不合格
20115303,73,32,65,43,13,226,不合格
20115304,48,67,11,9,94,229,不合格
20115305,12,25,82,94,63,276,不合格
20115306,36,67,2,96,66,267,不合格
20115307,26,50,50,55,30,211,不合格
20115308,23,66,41,22,12,164,不合格
20115309,53,94,36,65,1,249,不合格
20115310,62,52,80,27,23,244,不合格
20115311,46,84,4,45,56,235,不合格
20115312,58,19,63,50,70,260,不合格
20115313,33,81,69,1,4,188,不合格
20115314,16,39,30,76,75,236,不合格
20115315,60,43,40,66,64,273,不合格
20115316,49,22,36,61,52,220,不合格
20115317,50,35,37,71,21,214,不合格
20115318,97,60,60,32,60,309,合格
20115319,45,5,47,66,53,216,不合格
20115320,84,96,59,65,91,395,合格
20115321,27,76,60,35,32,230,不合格
20115322,31,74,89,9,45,248,不合格
20115323,54,71,20,13,1,159,不合格
20115324,93,60,91,97,20,361,合格
20115325,95,26,50,43,17,231,不合格
20115326,97,67,60,82,46,352,合格
20115327,76,47,63,26,24,236,不合格
20115328,7,59,64,47,66,243,不合格
20115329,96,13,53,19,87,268,不合格
20115330,57,11,55,40,23,186,不合格
20115331,9,8,13,50,59,139,不合格
20115332,32,11,2,44,58,147,不合格
20115333,64,18,10,9,53,154,不合格
20115334,42,88,28,47,60,265,不合格
20115335,66,8,13,18,91,196,不合格
20115336,93,99,99,9,90,390,合格
20115337,54,96,95,37,15,297,不合格
20115338,16,87,53,3,7,166,不合格
20115339,24,77,36,76,95,308,合格
20115340,83,84,11,13,27,218,不合格
20115341,45,38,99,33,79,294,不合格
20115342,13,26,83,12,40,174,不合格
20115343,53,16,62,26,10,167,不合格
20115344,24,83,85,81,27,300,合格
20115345,36,8,25,10,84,163,不合格
20115346,92,60,62,21,75,310,合格
20115347,60,8,46,72,50,236,不合格
20115348,9,86,16,58,86,255,不合格
20115349,73,14,68,0,78,233,不合格
20115350,67,32,18,68,12,197,不合格
20115351,63,43,77,80,31,294,不合格
20115352,66,20,58,44,84,272,不合格
20115353,6,9,20,58,41,134,不合格
20115354,88,94,8,71,67,328,合格
20115355,84,91,68,16,89,348,合格
20115356,9,83,65,48,30,235,不合格
20115357,72,42,65,45,49,273,不合格
20115358,66,69,77,56,80,348,合格
20115359,17,67,94,63,82,323,合格
20115360,45,61,36,32,32,206,不合格
20115361,79,99,13,38,55,284,不合格
20115362,74,32,74,43,10,233,不合格
20115363,8,83,61,24,56,232,不合格
20115364,79,93,48,83,12,315,合格
20115365,86,51,84,5,6,232,不合格
20115366,43,5,2,85,41,176,不合格
20115367,45,80,2,16,60,203,不合格
20115368,60,17,33,56,71,237,不合格
20115369,28,40,86,57,57,268,不合格
20115370,84,41,10,13,36,184,不合格
20115371,77,13,94,6,19,209,不合格
20115372,15,23,9,20,45,112,不合格
20115373,2,17,79,7,46,151,不合格
20115374,71,51,8,8,10,148,不合格
20115375,0,93,99,78,59,329,合格
20115376,6,17,18,17,31,89,不合格
20115377,35,35,41,47,17,175,不合格
20115378,46,13,94,0,61,214,不合格
20115379,84,98,32,79,10,303,合格
20115380,71,32,44,38,40,225,不合格
20115381,45,60,89,62,67,323,合格
20115382,83,79,20,32,5,219,不合格
20115383,53,21,82,20,58,234,不合格
20115384,90,37,34,51,64,276,不合格
20115385,10,67,76,7,20,180,不合格
20115386,72,0,19,52,27,170,不合格
20115387,42,54,98,60,26,280,不合格
20115388,97,96,41,74,72,380,合格
20115389,38,85,92,53,70,338,合格
20115390,66,87,77,11,90,331,合格
20115391,15,17,87,39,19,177,不合格
20115392,74,51,29,67,46,267,不合格
20115393,9,79,84,68,68,308,合格
20115394,22,83,13,77,96,291,不合格
20115395,52,38,57,83,29,259,不合格
20115396,3,81,61,47,69,261,不合格
20115397,59,32,11,63,37,202,不合格
20115398,92,85,48,75,93,393,合格
20115399,10,97,53,61,21,242,不合格
20115400,43,87,10,80,3,223,不合格
20115401,34,43,20,2,68,167,不合格
20115402,42,0,56,1,42,141,不合格
20115403,98,76,40,22,87,323,合格
20115404,44,29,13,85,61,232,不合格
20115405,90,17,10,93,14,224,不合格
20115406,11,19,87,74,56,247,不合格
20115407,37,24,94,19,75,249,不合格
20115408,81,3,87,22,75,268,不合格
20115409,64,94,32,93,29,312,合格
20115410,6,13,16,54,85,174,不合格
20115411,22,4,90,2,92,210,不合格
20115412,7,81,51,94,21,254,不合格
20115413,20,58,86,13,50,227,不合格
20115414,14,29,10,42,48,143,不合格
20115415,12,33,44,11,93,193,不合格
20115416,64,41,79,52,10,246,不合格
20115417,38,38,6,98,5,185,不合格
20115418,41,85,85,38,80,329,合格
20115419,74,72,11,37,65,259,不合格
20115420,26,91,46,51,36,250,不合格
20115421,29,59,11,13,98,210,不合格
20115422,87,89,24,46,52,298,不合格
20115423,53,15,17,27,40,152,不合格
20115424,54,40,26,54,31,205,不合格
20115425,44,87,3,78,54,266,不合格
20115426,79,35,3,72,46,235,不合格
20115427,53,79,83,78,25,318,合格
20115428,60,12,97,88,15,272,不合格
20115429,93,20,68,56,67,304,合格
20115430,30,5,56,46,52,189,不合格
20115431,73,8,41,99,7,228,不合格
20115432,92,53,44,35,93,317,合格
20115433,48,34,57,41,61,241,不合格
20115434,58,75,54,13,80,280,不合格
20115435,59,13,24,3,81,180,不合格
20115436,5,79,1,52,67,204,不合格
20115437,96,40,56,7,51,250,不合格
20115438,26,98,10,41,18,193,不合格
20115439,16,27,91,57,59,250,不合格
20115440,46,98,17,61,24,246,不合格
20115441,9,29,94,0,80,212,不合格
20115442,14,82,80,83,88,347,合格
20115443,35,79,30,56,16,216,不合格
20115444,4,17,57,23,65,166,不合格
20115445,95,72,33,26,47,273,不合格
20115446,46,33,86,52,23,240,不合格
20115447,45,83,95,88,12,323,合格
20115448,20,82,99,96,67,364,合格
20115449,39,70,71,74,7,261,不合格
20115450,65,38,90,53,4,250,不合格
20115451,85,14,7,41,64,211,不合格
20115452,61,57,37,14,54,223,不合格
20115453,87,66,91,83,56,383,合格
20115454,49,32,1,38,3,123,不合格
20115455,45,67,49,37,21,219,不合格
20115456,56,27,74,0,38,195,不合格
20115457,49,30,47,60,40,226,不合格
20115458,84,87,48,8,15,242,不合格
20115459,55,65,92,41,33,286,不合格
20115460,14,1,38,11,77,141,不合格
20115461,27,68,92,77,79,343,合格
20115462,42,14,51,14,27,148,不合格
20115463,19,1,84,60,76,240,不合格
20115464,60,50,60,23,38,231,不合格
20115465,88,5,73,3,41,210,不合格
20115466,47,31,48,91,7,224,不合格
20115467,26,77,19,35,76,233,不合格
20115468,43,40,49,66,39,237,不合格
20115469,51,96,42,12,96,297,不合格
20115470,66,18,73,58,29,244,不合格
20115471,18,84,87,29,88,306,合格
20115472,67,2,83,13,29,194,不合格
20115473,5,82,15,33,9,144,不合格
20115474,53,41,49,15,93,251,不合格
20115475,50,89,98,95,88,420,合格
20115476,75,45,38,9,96,263,不合格
20115477,82,83,55,93,43,356,合格
20115478,99,37,25,9,50,220,不合格
20115479,1,13,6,24,72,116,不合格
20115480,76,93,41,80,32,322,合格
20115481,20,97,82,60,30,289,不合格
20115482,4,73,47,29,39,192,不合格
20115483,65,10,68,8,73,224,不合格
20115484,60,50,4,86,11,211,不合格
20115485,78,83,16,9,27,213,不合格
20115486,63,41,5,39,40,188,不合格
20115487,54,91,49,6,31,231,不合格
20115488,56,26,28,97,26,233,不合格
20115489,23,38,16,17,74,168,不合格
20115490,13,38,83,41,46,221,不合格
20115491,86,91,10,99,7,293,不合格
20115492,46,54,15,27,22,164,不合格
20115493,7,14,61,28,71,181,不合格
20115494,91,14,72,16,29,222,不合格
20115495,4,17,19,20,82,142,不合格
20115496,25,25,86,20,86,242,不合格
20115497,89,70,82,93,31,365,合格
20115498,80,0,90,63,65,298,不合格
20115499,59,57,94,27,5,242,不合格
20115500,42,3,45,65,77,232,不合格
