ID,国語,数学,英語,理科,社会,合計,判定
20170001,44,27,6,87,90,254,不合格
20170002,16,84,96,27,17,240,不合格
20170003,90,96,86,58,79,409,合格
20170004,24,40,46,5,79,194,不合格
20170005,70,54,50,42,79,295,不合格
20170006,58,14,80,8,95,255,不合格
20170007,27,87,11,75,51,251,不合格
20170008,95,11,31,22,39,198,不合格
20170009,4,94,80,69,86,333,合格
20170010,57,26,77,24,90,274,不合格
20170011,35,62,48,21,83,249,不合格
20170012,65,5,21,27,74,192,不合格
20170013,38,1,10,73,33,155,不合格
20170014,91,97,0,70,32,290,不合格
20170015,48,61,27,48,71,255,不合格
20170016,57,22,80,93,61,313,合格
20170017,66,17,28,36,84,231,不合格
20170018,26,12,56,33,14,141,不合格
20170019,71,61,62,61,26,281,不合格
20170020,22,73,81,73,29,278,不合格
20170021,15,13,76,58,55,217,不合格
20170022,33,68,33,6,92,232,不合格
20170023,58,53,69,28,6,214,不合格
20170024,27,82,16,95,8,228,不合格
20170025,51,54,25,34,37,201,不合格
20170026,58,90,35,52,60,295,不合格
20170027,90,89,29,28,64,300,合格
20170028,79,95,89,20,58,341,合格
20170029,41,23,58,30,42,194,不合格
20170030,68,65,91,35,58,317,合格
20170031,16,23,2,77,69,187,不合格
20170032,8,77,52,81,5,223,不合格
20170033,0,19,88,66,58,231,不合格
20170034,87,66,64,82,31,330,合格
20170035,20,7,48,62,94,231,不合格
20170036,82,58,39,83,33,295,不合格
20170037,20,83,12,7,93,215,不合格
20170038,78,26,28,95,90,317,合格
20170039,95,83,35,69,97,379,合格
20170040,90,81,52,87,43,353,合格
20170041,18,40,95,97,26,276,不合格
20170042,9,64,90,59,15,237,不合格
20170043,27,22,28,23,57,157,不合格
20170044,45,14,94,18,94,265,不合格
20170045,19,61,53,92,53,278,不合格
20170046,28,76,10,85,54,253,不合格
20170047,55,53,52,3,71,234,不合格
20170048,12,44,24,43,1,124,不合格
20170049,82,29,5,38,51,205,不合格
20170050,98,68,31,38,20,255,不合格
20170051,14,71,54,66,75,280,不合格
20170052,18,78,21,85,40,242,不合格
20170053,2,91,76,61,89,319,合格
20170054,61,13,25,76,97,272,不合格
20170055,83,82,39,16,7,227,不合格
20170056,57,30,88,68,85,328,合格
20170057,72,57,56,73,67,325,合格
20170058,12,56,1,62,82,213,不合格
20170059,35,65,55,46,39,240,不合格
20170060,20,9,96,70,66,261,不合格
20170061,3,31,78,37,26,175,不合格
20170062,89,40,61,37,24,251,不合格
20170063,35,28,19,2,63,147,不合格
20170064,81,0,8,11,98,198,不合格
20170065,58,90,21,88,99,356,合格
20170066,35,81,23,78,73,290,不合格
20170067,92,30,32,5,81,240,不合格
20170068,22,69,2,54,58,205,不合格
20170069,82,26,75,16,54,253,不合格
20170070,35,21,83,79,7,225,不合格
20170071,6,19,98,99,66,288,不合格
20170072,26,11,22,88,53,200,不合格
20170073,93,67,39,60,17,276,不合格
20170074,59,89,75,60,2,285,不合格
20170075,86,21,76,93,75,351,合格
20170076,91,76,60,68,80,375,合格
20170077,71,31,55,8,87,252,不合格
20170078,3,47,56,62,12,180,不合格
20170079,14,46,35,63,13,171,不合格
20170080,24,2,2,92,41,161,不合格
20170081,30,79,16,55,30,210,不合格
20170082,43,29,17,15,31,135,不合格
20170083,11,44,67,97,94,313,合格
20170084,87,23,94,93,14,311,合格
20170085,16,32,34,55,71,208,不合格
20170086,3,8,23,89,73,196,不合格
20170087,3,32,72,66,22,195,不合格
20170088,31,23,79,91,62,286,不合格
20170089,86,24,47,25,89,271,不合格
20170090,97,51,32,48,24,252,不合格
20170091,0,41,99,32,5,177,不合格
20170092,11,62,96,2,33,204,不合格
20170093,77,44,14,50,30,215,不合格
20170094,52,92,68,22,68,302,合格
20170095,91,9,84,65,5,254,不合格
20170096,34,66,68,83,17,268,不合格
20170097,92,37,28,12,99,268,不合格
20170098,47,84,98,48,72,349,合格
20170099,90,69,99,62,20,340,合格
20170100,46,89,87,78,62,362,合格
20170101,98,61,77,56,54,346,合格
20170102,3,1,39,5,43,91,不合格
20170103,59,7,11,89,38,204,不合格
20170104,20,79,94,23,93,309,合格
20170105,28,60,13,61,41,203,不合格
20170106,68,11,97,69,40,285,不合格
20170107,50,78,19,52,92,291,不合格
20170108,3,82,83,6,47,221,不合格
20170109,69,64,76,58,26,293,不合格
20170110,55,40,50,70,61,276,不合格
20170111,4,62,37,52,77,232,不合格
20170112,50,24,60,77,84,295,不合格
20170113,9,37,35,25,80,186,不合格
20170114,15,35,23,1,50,124,不合格
20170115,94,36,43,98,72,343,合格
20170116,81,80,58,48,92,359,合格
20170117,19,20,87,37,58,221,不合格
20170118,59,58,8,10,7,142,不合格
20170119,48,66,60,43,10,227,不合格
20170120,8,91,61,93,0,253,不合格
20170121,5,94,74,74,68,315,合格
20170122,96,44,97,3,74,314,合格
20170123,23,99,57,21,55,255,不合格
20170124,37,97,54,93,43,324,合格
20170125,88,24,38,26,71,247,不合格
20170126,58,35,27,94,23,237,不合格
20170127,45,48,26,25,20,164,不合格
20170128,24,34,59,6,92,215,不合格
20170129,17,53,87,44,67,268,不合格
20170130,65,8,89,91,23,276,不合格
20170131,90,60,87,58,20,315,合格
20170132,88,59,95,12,66,320,合格
20170133,55,31,66,93,90,335,合格
20170134,16,19,21,37,27,120,不合格
20170135,74,67,45,75,39,300,合格
20170136,83,36,69,75,80,343,合格
20170137,88,73,47,26,93,327,合格
20170138,10,23,50,1,95,179,不合格
20170139,61,54,71,35,83,304,合格
20170140,31,85,31,23,29,199,不合格
20170141,94,47,99,38,53,331,合格
20170142,1,22,89,91,80,283,不合格
20170143,24,87,84,4,26,225,不合格
20170144,34,83,33,43,15,208,不合格
20170145,4,12,85,99,87,287,不合格
20170146,9,75,4,87,28,203,不合格
20170147,19,16,85,47,41,208,不合格
20170148,61,3,71,19,49,203,不合格
20170149,45,48,46,6,74,219,不合格
20170150,56,62,43,69,25,255,不合格
20170151,72,71,16,21,27,207,不合格
20170152,85,48,31,71,93,328,合格
20170153,45,73,17,26,27,188,不合格
20170154,68,56,73,83,79,359,合格
20170155,0,10,26,35,55,126,不合格
20170156,44,13,40,6,78,181,不合格
20170157,85,72,57,37,62,313,合格
20170158,73,88,68,95,42,366,合格
20170159,84,33,37,66,70,290,不合格
20170160,14,87,7,72,47,227,不合格
20170161,61,68,11,10,9,159,不合格
20170162,34,23,73,25,70,225,不合格
20170163,28,9,64,41,17,159,不合格
20170164,12,38,76,43,41,210,不合格
20170165,67,89,95,80,63,394,合格
20170166,56,98,32,96,28,310,合格
20170167,83,12,35,79,8,217,不合格
20170168,20,56,16,27,47,166,不合格
20170169,98,50,44,5,75,272,不合格
20170170,51,34,45,64,29,223,不合格
20170171,75,29,43,53,24,224,不合格
20170172,45,31,47,16,52,191,不合格
20170173,97,37,18,94,80,326,合格
20170174,99,64,47,63,79,352,合格
20170175,52,26,11,25,46,160,不合格
20170176,99,41,12,50,40,242,不合格
20170177,54,78,55,38,50,275,不合格
20170178,21,74,72,80,38,285,不合格
20170179,42,48,70,36,81,277,不合格
20170180,82,69,90,99,35,375,合格
20170181,90,83,63,62,78,376,合格
20170182,14,61,5,27,88,195,不合格
20170183,38,24,9,23,53,147,不合格
20170184,42,73,81,7,51,254,不合格
20170185,79,26,22,68,94,289,不合格
20170186,61,65,44,59,90,319,合格
20170187,36,92,37,93,15,273,不合格
20170188,93,89,80,51,8,321,合格
20170189,38,38,96,91,2,265,不合格
20170190,3,76,62,55,52,248,不合格
20170191,50,64,77,68,73,332,合格
20170192,64,68,94,29,51,306,合格
20170193,23,59,95,19,77,273,不合格
20170194,84,29,94,58,70,335,合格
20170195,5,72,81,20,8,186,不合格
20170196,27,62,66,86,62,303,合格
20170197,37,63,58,85,79,322,合格
20170198,45,11,44,88,86,274,不合格
20170199,86,4,89,94,87,360,合格
20170200,51,76,68,62,43,300,合格
20170201,10,50,38,11,82,191,不合格
20170202,94,40,60,22,51,267,不合格
20170203,84,40,17,19,96,256,不合格
20170204,17,76,23,52,54,222,不合格
20170205,40,99,21,42,30,232,不合格
20170206,90,19,64,62,43,278,不合格
20170207,52,65,68,73,41,299,不合格
20170208,88,21,44,95,45,293,不合格
20170209,99,79,85,29,72,364,合格
20170210,88,53,39,89,81,350,合格
20170211,17,66,65,34,93,275,不合格
20170212,32,11,52,60,79,234,不合格
20170213,11,49,0,72,25,157,不合格
20170214,3,36,53,36,44,172,不合格
20170215,28,0,29,50,54,161,不合格
20170216,49,0,33,13,74,169,不合格
20170217,87,73,46,55,72,333,合格
20170218,80,46,45,1,65,237,不合格
20170219,48,35,81,86,7,257,不合格
20170220,18,30,9,14,62,133,不合格
20170221,59,88,49,24,53,273,不合格
20170222,82,8,40,50,34,214,不合格
20170223,83,47,40,64,44,278,不合格
20170224,21,84,17,78,91,291,不合格
20170225,53,75,12,33,18,191,不合格
20170226,3,56,68,89,96,312,合格
20170227,37,77,28,19,35,196,不合格
20170228,78,85,39,65,89,356,合格
20170229,69,78,28,27,67,269,不合格
20170230,33,48,34,39,27,181,不合格
20170231,49,39,58,26,83,255,不合格
20170232,38,70,85,47,26,266,不合格
20170233,76,86,66,88,10,326,合格
20170234,72,91,41,90,1,295,不合格
20170235,12,41,49,85,62,249,不合格
20170236,95,45,29,18,68,255,不合格
20170237,33,45,88,74,95,335,合格
20170238,27,58,0,56,87,228,不合格
20170239,24,72,30,3,14,143,不合格
20170240,85,5,25,41,25,181,不合格
20170241,16,63,38,18,13,148,不合格
20170242,89,66,50,4,53,262,不合格
20170243,83,66,82,45,73,349,合格
20170244,20,66,75,41,97,299,不合格
20170245,9,91,86,69,86,341,合格
20170246,89,62,95,63,73,382,合格
20170247,51,36,19,29,13,148,不合格
20170248,47,81,83,90,17,318,合格
20170249,5,65,91,0,58,219,不合格
20170250,7,6,25,47,62,147,不合格
20170251,97,83,12,28,81,301,合格
20170252,21,3,88,51,7,170,不合格
20170253,66,6,87,54,82,295,不合格
20170254,86,68,17,27,23,221,不合格
20170255,36,48,97,26,12,219,不合格
20170256,7,17,40,64,77,205,不合格
20170257,18,66,40,15,52,191,不合格
20170258,35,29,42,51,12,169,不合格
20170259,28,32,67,19,6,152,不合格
20170260,22,26,22,15,3,88,不合格
20170261,1,76,28,63,58,226,不合格
20170262,54,50,44,89,81,318,合格
20170263,49,78,86,32,49,294,不合格
20170264,79,17,78,73,41,288,不合格
20170265,5,51,3,81,88,228,不合格
20170266,98,22,12,33,23,188,不合格
20170267,58,98,69,69,38,332,合格
20170268,94,26,36,88,98,342,合格
20170269,76,10,32,89,89,296,不合格
20170270,94,79,4,60,62,299,不合格
20170271,32,63,19,73,4,191,不合格
20170272,8,82,71,24,71,256,不合格
20170273,47,5,20,56,81,209,不合格
20170274,88,99,15,48,2,252,不合格
20170275,56,47,84,86,37,310,合格
20170276,53,73,67,29,84,306,合格
20170277,98,74,20,15,46,253,不合格
20170278,49,12,51,89,10,211,不合格
20170279,24,61,70,43,57,255,不合格
20170280,84,87,63,4,80,318,合格
20170281,2,92,73,81,25,273,不合格
20170282,49,26,45,53,87,260,不合格
20170283,29,27,78,71,7,212,不合格
20170284,74,31,53,63,33,254,不合格
20170285,21,79,55,32,7,194,不合格
20170286,56,56,42,55,92,301,合格
20170287,5,31,97,65,1,199,不合格
20170288,1,46,16,60,3,126,不合格
20170289,24,32,78,97,74,305,合格
20170290,42,92,6,66,97,303,合格
20170291,55,68,87,5,69,284,不合格
20170292,28,36,22,37,84,207,不合格
20170293,89,95,76,19,72,351,合格
20170294,58,92,97,14,41,302,合格
20170295,73,16,34,40,14,177,不合格
20170296,62,65,52,99,59,337,合格
20170297,15,13,5,1,46,80,不合格
20170298,53,80,32,88,35,288,不合格
20170299,67,56,2,74,28,227,不合格
20170300,57,81,99,66,40,343,合格
20170301,24,78,57,92,76,327,合格
20170302,19,43,35,19,48,164,不合格
20170303,45,10,81,83,0,219,不合格
20170304,87,22,28,49,52,238,不合格
20170305,61,91,9,18,2,181,不合格
20170306,21,96,46,9,57,229,不合格
20170307,94,35,31,32,40,232,不合格
20170308,30,50,73,63,97,313,合格
20170309,67,55,38,15,30,205,不合格
20170310,44,30,87,3,70,234,不合格
20170311,37,22,14,29,79,181,不合格
20170312,21,79,0,57,90,247,不合格
20170313,86,41,75,57,28,287,不合格
20170314,95,20,45,70,74,304,合格
20170315,29,2,23,70,80,204,不合格
20170316,17,12,2,80,0,111,不合格
20170317,45,1,8,32,12,98,不合格
20170318,87,32,0,44,5,168,不合格
20170319,11,95,33,33,51,223,不合格
20170320,26,87,56,33,99,301,合格
20170321,81,41,28,16,5,171,不合格
20170322,33,19,28,71,54,205,不合格
20170323,35,96,30,81,85,327,合格
20170324,71,25,97,9,94,296,不合格
20170325,19,68,30,57,54,228,不合格
20170326,67,89,19,88,20,283,不合格
20170327,79,24,69,67,24,263,不合格
20170328,56,47,76,73,52,304,合格
20170329,40,32,13,59,85,229,不合格
20170330,80,96,76,37,30,319,合格
20170331,52,54,59,1,48,214,不合格
20170332,39,62,25,37,76,239,不合格
20170333,13,33,24,33,77,180,不合格
20170334,3,47,57,95,99,301,合格
20170335,34,63,62,39,58,256,不合格
20170336,71,13,49,8,70,211,不合格
20170337,92,19,29,31,93,264,不合格
20170338,11,68,13,18,80,190,不合格
20170339,76,18,32,27,94,247,不合格
20170340,60,33,34,13,51,191,不合格
20170341,35,0,88,0,75,198,不合格
20170342,84,24,80,47,40,275,不合格
20170343,29,94,66,71,32,292,不合格
20170344,2,25,22,64,51,164,不合格
20170345,28,5,82,12,9,136,不合格
20170346,74,49,23,74,53,273,不合格
20170347,7,11,20,36,69,143,不合格
20170348,31,50,98,96,75,350,合格
20170349,22,34,28,92,28,204,不合格
20170350,34,46,63,46,72,261,不合格
20170351,23,0,55,62,24,164,不合格
20170352,70,87,26,69,11,263,不合格
20170353,34,27,2,18,56,137,不合格
20170354,87,2,27,41,22,179,不合格
20170355,90,72,97,27,2,288,不合格
20170356,91,7,88,63,38,287,不合格
20170357,77,92,35,82,38,324,合格
20170358,18,20,96,72,72,278,不合格
20170359,45,14,1,72,53,185,不合格
20170360,51,78,44,83,92,348,合格
20170361,43,92,40,5,37,217,不合格
20170362,7,78,40,58,17,200,不合格
20170363,47,74,83,59,65,328,合格
20170364,56,85,13,77,75,306,合格
20170365,75,79,83,48,75,360,合格
20170366,98,10,50,30,90,278,不合格
20170367,17,91,10,32,34,184,不合格
20170368,91,79,52,98,94,414,合格
20170369,10,34,79,85,84,292,不合格
20170370,67,34,79,6,74,260,不合格
20170371,56,45,27,44,52,224,不合格
20170372,55,42,18,90,88,293,不合格
20170373,6,71,88,62,31,258,不合格
20170374,62,58,11,27,24,182,不合格
20170375,60,44,17,51,56,228,不合格
20170376,7,57,36,76,17,193,不合格
20170377,83,67,96,72,82,400,合格
20170378,26,75,56,83,8,248,不合格
20170379,83,51,36,86,87,343,合格
20170380,92,16,39,53,3,203,不合格
20170381,69,37,57,25,80,268,不合格
20170382,46,98,70,90,31,335,合格
20170383,14,74,98,57,6,249,不合格
20170384,51,11,79,64,20,225,不合格
20170385,79,33,15,27,60,214,不合格
20170386,20,14,11,18,53,116,不合格
20170387,62,92,45,72,51,322,合格
20170388,53,14,15,21,37,140,不合格
20170389,82,14,96,4,58,254,不合格
20170390,65,19,25,34,53,196,不合格
20170391,1,57,99,37,7,201,不合格
20170392,5,24,23,32,78,162,不合格
20170393,88,87,37,89,66,367,合格
20170394,5,54,30,59,6,154,不合格
20170395,90,37,20,32,93,272,不合格
20170396,17,20,87,77,59,260,不合格
20170397,84,13,79,23,61,260,不合格
20170398,0,67,41,2,19,129,不合格
20170399,32,26,89,96,71,314,合格
20170400,50,13,50,63,56,232,不合格
20170401,17,80,80,45,63,285,不合格
20170402,64,87,71,64,71,357,合格
20170403,17,83,51,72,1,224,不合格
20170404,38,15,2,47,34,136,不合格
20170405,37,25,71,8,22,163,不合格
20170406,37,81,64,2,41,225,不合格
20170407,96,27,93,84,61,361,合格
20170408,9,83,77,91,88,348,合格
20170409,32,62,81,69,14,258,不合格
20170410,7,93,16,64,90,270,不合格
20170411,65,79,44,40,81,309,合格
20170412,73,19,75,53,92,312,合格
20170413,99,74,24,4,73,274,不合格
20170414,34,70,27,39,91,261,不合格
20170415,19,49,8,25,56,157,不合格
20170416,72,21,79,43,89,304,合格
20170417,34,36,38,85,89,282,不合格
20170418,52,82,55,38,74,301,合格
20170419,67,90,60,25,19,261,不合格
20170420,34,44,2,62,35,177,不合格
20170421,44,94,36,85,89,348,合格
20170422,83,46,48,7,63,247,不合格
20170423,5,56,85,69,46,261,不合格
20170424,62,34,97,57,3,253,不合格
20170425,16,43,1,51,87,198,不合格
20170426,1,40,2,68,47,158,不合格
20170427,17,1,87,91,49,245,不合格
20170428,2,50,47,37,6,142,不合格
20170429,70,16,55,40,21,202,不合格
20170430,83,8,54,6,52,203,不合格
20170431,86,25,95,48,64,318,合格
20170432,15,89,42,36,24,206,不合格
20170433,44,27,50,69,5,195,不合格
20170434,6,12,11,47,46,122,不合格
20170435,40,12,53,2,84,191,不合格
20170436,91,8,46,92,47,284,不合格
20170437,33,84,11,58,32,218,不合格
20170438,42,2,56,18,71,189,不合格
20170439,88,22,79,96,62,347,合格
20170440,50,70,18,91,99,328,合格
20170441,67,80,66,46,95,354,合格
20170442,59,10,10,1,92,172,不合格
20170443,36,47,36,47,84,250,不合格
20170444,1,80,16,67,16,180,不合格
20170445,63,91,11,68,55,288,不合格
20170446,54,48,19,82,49,252,不合格
20170447,51,24,29,59,60,223,不合格
20170448,18,61,27,36,53,195,不合格
20170449,17,19,79,18,97,230,不合格
20170450,21,21,62,17,98,219,不合格
20170451,11,3,43,52,88,197,不合格
20170452,59,6,26,9,41,141,不合格
20170453,27,78,41,88,76,310,合格
20170454,15,63,16,16,60,170,不合格
20170455,77,6,1,96,67,247,不合格
20170456,17,48,43,65,63,236,不合格
20170457,11,56,89,11,79,246,不合格
20170458,23,77,57,15,37,209,不合格
20170459,19,49,37,61,8,174,不合格
20170460,10,46,91,98,12,257,不合格
20170461,89,39,47,3,62,240,不合格
20170462,16,28,40,1,98,183,不合格
20170463,3,7,45,6,54,115,不合格
20170464,79,81,1,3,81,245,不合格
20170465,54,31,75,50,44,254,不合格
20170466,92,82,48,40,78,340,合格
20170467,54,31,91,22,38,236,不合格
20170468,7,98,30,98,42,275,不合格
20170469,71,52,75,24,92,314,合格
20170470,7,66,18,74,57,222,不合格
20170471,56,21,50,26,85,238,不合格
20170472,98,35,5,58,73,269,不合格
20170473,73,42,33,53,34,235,不合格
20170474,31,21,41,6,48,147,不合格
20170475,16,82,16,41,84,239,不合格
20170476,18,17,13,93,15,156,不合格
20170477,13,80,32,44,85,254,不合格
20170478,16,32,59,24,24,155,不合格
20170479,9,53,82,17,68,229,不合格
20170480,77,5,7,4,94,187,不合格
20170481,22,73,46,53,49,243,不合格
20170482,99,23,55,90,95,362,合格
20170483,10,0,16,43,70,139,不合格
20170484,5,3,79,18,95,200,不合格
20170485,67,60,90,52,7,276,不合格
20170486,79,88,37,23,83,310,合格
20170487,81,20,0,49,53,203,不合格
20170488,52,64,17,36,82,251,不合格
20170489,32,42,56,82,32,244,不合格
20170490,10,90,29,72,82,283,不合格
20170491,20,31,84,96,96,327,合格
20170492,98,67,72,72,3,312,合格
20170493,20,95,56,69,89,329,合格
20170494,37,57,37,77,35,243,不合格
20170495,19,94,16,1,59,189,不合格
20170496,78,73,67,13,56,287,不合格
20170497,32,47,98,44,63,284,不合格
20170498,61,1,49,54,66,231,不合格
20170499,50,15,21,84,84,254,不合格
20170500,71,85,62,88,46,352,合格
20170501,56,63,18,6,87,230,不合格
20170502,41,36,71,59,81,288,不合格
20170503,12,11,99,87,54,263,不合格
20170504,31,32,94,27,18,202,不合格
20170505,69,74,60,11,98,312,合格
20170506,80,15,13,58,26,192,不合格
20170507,12,70,43,28,40,193,不合格
20170508,31,96,92,7,24,250,不合格
20170509,92,23,15,11,80,221,不合格
20170510,57,82,37,83,91,350,合格
20170511,73,84,23,25,74,279,不合格
20170512,14,37,94,19,78,242,不合格
20170513,80,20,53,78,94,325,合格
20170514,83,70,51,65,33,302,合格
20170515,40,81,42,60,43,266,不合格
20170516,45,88,26,14,24,197,不合格
20170517,4,91,90,26,51,262,不合格
20170518,40,49,47,95,91,322,合格
20170519,98,7,84,60,52,301,合格
20170520,50,25,88,58,28,249,不合格
20170521,14,25,19,52,72,182,不合格
20170522,36,61,48,77,13,235,不合格
20170523,11,95,50,47,75,278,不合格
20170524,36,98,41,26,32,233,不合格
20170525,78,17,27,76,3,201,不合格
20170526,62,68,11,11,79,231,不合格
20170527,92,95,65,30,4,286,不合格
20170528,60,11,51,94,6,222,不合格
20170529,85,14,82,89,18,288,不合格
20170530,41,50,85,71,92,339,合格
20170531,98,42,28,86,98,352,合格
20170532,0,17,51,83,84,235,不合格
20170533,93,93,47,15,89,337,合格
20170534,44,83,41,18,63,249,不合格
20170535,95,91,79,33,15,313,合格
20170536,65,20,46,54,53,238,不合格
20170537,36,14,10,21,61,142,不合格
20170538,59,70,70,79,44,322,合格
20170539,94,65,35,75,78,347,合格
20170540,60,4,90,93,24,271,不合格
20170541,98,74,43,90,46,351,合格
20170542,45,59,18,25,45,192,不合格
20170543,42,22,74,46,20,204,不合格
20170544,87,45,22,71,55,280,不合格
20170545,52,51,83,22,70,278,不合格
20170546,82,43,1,61,53,240,不合格
20170547,48,67,15,46,24,200,不合格
20170548,91,0,35,9,92,227,不合格
20170549,49,31,16,82,92,270,不合格
20170550,64,73,52,14,0,203,不合格
20170551,21,81,0,75,78,255,不合格
20170552,10,8,34,6,83,141,不合格
20170553,61,31,95,55,60,302,合格
20170554,77,2,32,61,90,262,不合格
20170555,46,40,96,35,69,286,不合格
20170556,53,62,81,30,98,324,合格
20170557,53,12,14,98,26,203,不合格
20170558,86,63,77,92,71,389,合格
20170559,71,87,99,15,10,282,不合格
20170560,24,2,51,51,81,209,不合格
20170561,53,32,63,20,35,203,不合格
20170562,47,26,79,69,37,258,不合格
20170563,21,45,84,51,16,217,不合格
20170564,0,40,94,79,86,299,不合格
20170565,37,30,74,2,67,210,不合格
20170566,38,2,91,14,0,145,不合格
20170567,39,1,65,24,35,164,不合格
20170568,3,18,52,84,95,252,不合格
20170569,57,74,25,25,70,251,不合格
20170570,97,6,86,73,22,284,不合格
20170571,66,48,15,88,21,238,不合格
20170572,52,32,33,22,65,204,不合格
20170573,77,12,10,73,92,264,不合格
20170574,24,78,10,99,39,250,不合格
20170575,80,32,27,39,92,270,不合格
20170576,99,45,94,4,49,291,不合格
20170577,41,18,50,95,68,272,不合格
20170578,74,23,70,29,53,249,不合格
20170579,68,5,94,1,89,257,不合格
20170580,32,67,20,53,79,251,不合格
20170581,71,37,17,29,77,231,不合格
20170582,62,85,22,61,18,248,不合格
20170583,9,19,74,81,33,216,不合格
20170584,11,8,78,67,52,216,不合格
20170585,48,98,9,14,70,239,不合格
20170586,49,76,48,59,89,321,合格
20170587,61,17,23,34,8,143,不合格
20170588,8,68,58,63,10,207,不合格
20170589,72,14,12,2,81,181,不合格
20170590,74,96,80,96,84,430,合格
20170591,37,89,95,57,83,361,合格
20170592,61,24,27,61,23,196,不合格
20170593,34,30,59,73,63,259,不合格
20170594,64,36,67,77,36,280,不合格
20170595,9,53,33,10,63,168,不合格
20170596,76,73,28,90,59,326,合格
20170597,15,71,3,6,76,171,不合格
20170598,82,13,43,99,92,329,合格
20170599,45,85,23,19,10,182,不合格
20170600,85,1,0,51,95,232,不合格
20170601,79,24,80,71,81,335,合格
20170602,89,90,78,93,10,360,合格
20170603,87,65,12,98,91,353,合格
20170604,3,81,94,67,18,263,不合格
20170605,44,81,82,75,48,330,合格
20170606,70,7,11,82,88,258,不合格
20170607,48,22,59,89,17,235,不合格
20170608,61,26,66,73,43,269,不合格
20170609,63,36,60,83,65,307,合格
20170610,99,70,42,43,7,261,不合格
20170611,10,57,95,35,94,291,不合格
20170612,24,45,46,90,73,278,不合格
20170613,34,80,19,49,38,220,不合格
20170614,90,17,79,1,43,230,不合格
20170615,9,62,95,27,32,225,不合格
20170616,5,89,90,81,64,329,合格
20170617,39,0,5,0,31,75,不合格
20170618,76,51,24,64,58,273,不合格
20170619,23,18,87,50,5,183,不合格
20170620,28,97,29,74,26,254,不合格
20170621,20,54,62,27,57,220,不合格
20170622,16,89,87,16,47,255,不合格
20170623,64,39,2,48,69,222,不合格
20170624,51,20,7,51,89,218,不合格
20170625,90,14,56,59,97,316,合格
20170626,77,14,81,9,19,200,不合格
20170627,64,56,55,24,80,279,不合格
20170628,33,22,75,92,10,232,不合格
20170629,81,46,55,44,88,314,合格
20170630,94,75,74,90,69,402,合格
20170631,71,35,8,43,79,236,不合格
20170632,97,5,23,52,69,246,不合格
20170633,51,69,37,53,36,246,不合格
20170634,73,62,69,98,61,363,合格
20170635,11,52,85,7,7,162,不合格
20170636,44,8,10,66,70,198,不合格
20170637,70,70,13,87,74,314,合格
20170638,67,41,87,91,4,290,不合格
20170639,21,64,49,46,92,272,不合格
20170640,21,84,99,96,33,333,合格
20170641,13,87,75,21,81,277,不合格
20170642,44,88,59,95,1,287,不合格
20170643,36,32,73,29,95,265,不合格
20170644,44,11,48,31,18,152,不合格
20170645,67,60,23,39,1,190,不合格
20170646,53,0,0,98,73,224,不合格
20170647,52,65,77,72,41,307,合格
20170648,24,46,93,86,85,334,合格
20170649,81,14,47,6,67,215,不合格
20170650,11,73,51,43,52,230,不合格
20170651,45,6,82,71,90,294,不合格
20170652,31,90,54,15,86,276,不合格
20170653,86,27,69,22,37,241,不合格
20170654,28,31,46,94,62,261,不合格
20170655,26,97,56,85,93,357,合格
20170656,37,56,92,61,96,342,合格
20170657,29,62,53,10,78,232,不合格
20170658,69,84,68,8,5,234,不合格
20170659,10,54,82,54,37,237,不合格
20170660,39,96,10,59,97,301,合格
20170661,85,38,44,35,83,285,不合格
20170662,51,69,14,47,2,183,不合格
20170663,64,53,46,51,54,268,不合格
20170664,74,6,95,3,96,274,不合格
20170665,44,77,42,47,39,249,不合格
20170666,91,52,52,46,28,269,不合格
20170667,77,3,78,23,36,217,不合格
20170668,87,46,91,69,91,384,合格
20170669,57,8,20,56,43,184,不合格
20170670,93,21,30,38,18,200,不合格
20170671,68,53,79,61,78,339,合格
20170672,32,37,67,84,6,226,不合格
20170673,21,86,95,73,46,321,合格
20170674,63,93,17,83,60,316,合格
20170675,69,93,40,14,74,290,不合格
20170676,96,8,43,2,33,182,不合格
20170677,63,55,45,75,90,328,合格
20170678,28,71,79,92,46,316,合格
20170679,43,60,10,3,49,165,不合格
20170680,44,49,29,12,45,179,不合格
20170681,83,99,4,96,24,306,合格
20170682,85,37,64,29,76,291,不合格
20170683,1,94,80,60,61,296,不合格
20170684,16,15,24,90,67,212,不合格
20170685,38,70,15,97,58,278,不合格
20170686,41,45,86,23,5,200,不合格
20170687,85,91,98,12,3,289,不合格
20170688,83,25,62,18,80,268,不合格
20170689,22,24,37,27,96,206,不合格
20170690,10,35,50,61,10,166,不合格
20170691,4,58,77,21,3,163,不合格
20170692,27,90,71,75,70,333,合格
20170693,95,44,52,40,14,245,不合格
20170694,27,42,44,86,10,209,不合格
20170695,43,64,38,34,73,252,不合格
20170696,91,98,95,37,47,368,合格
20170697,93,51,37,1,69,251,不合格
20170698,80,14,64,39,10,207,不合格
20170699,20,51,72,38,44,225,不合格
20170700,38,70,91,94,0,293,不合格
20170701,71,69,15,22,0,177,不合格
20170702,64,55,43,13,70,245,不合格
20170703,92,23,87,88,74,364,合格
20170704,90,38,27,75,77,307,合格
20170705,43,54,13,24,49,183,不合格
20170706,48,41,33,0,47,169,不合格
20170707,81,38,77,89,25,310,合格
20170708,42,23,12,0,32,109,不合格
20170709,30,2,34,70,72,208,不合格
20170710,13,94,19,23,71,220,不合格
20170711,77,52,26,12,61,228,不合格
20170712,12,4,39,95,48,198,不合格
20170713,39,60,30,81,85,295,不合格
20170714,46,76,82,73,88,365,合格
20170715,99,78,0,10,93,280,不合格
20170716,11,52,38,23,36,160,不合格
20170717,14,35,33,78,74,234,不合格
20170718,14,33,87,28,10,172,不合格
20170719,32,67,13,43,64,219,不合格
20170720,43,33,60,34,32,202,不合格
20170721,46,76,54,95,65,336,合格
20170722,80,76,54,16,53,279,不合格
20170723,5,60,39,89,70,263,不合格
20170724,4,60,17,36,53,170,不合格
20170725,60,40,74,35,12,221,不合格
20170726,89,70,18,63,87,327,合格
20170727,14,32,23,89,77,235,不合格
20170728,35,67,40,50,81,273,不合格
20170729,76,68,45,35,71,295,不合格
20170730,73,66,18,5,84,246,不合格
20170731,84,80,83,75,43,365,合格
20170732,31,84,7,76,88,286,不合格
20170733,34,20,59,15,61,189,不合格
20170734,45,64,59,4,18,190,不合格
20170735,74,17,55,42,81,269,不合格
20170736,60,49,58,88,81,336,合格
20170737,28,40,83,65,77,293,不合格
20170738,91,86,67,86,7,337,合格
20170739,64,85,65,56,54,324,合格
20170740,6,2,44,45,76,173,不合格
20170741,55,44,70,65,74,308,合格
20170742,45,57,85,89,43,319,合格
20170743,15,43,46,3,61,168,不合格
20170744,91,28,88,58,75,340,合格
20170745,56,46,37,15,69,223,不合格
20170746,53,45,11,19,83,211,不合格
20170747,42,15,0,73,65,195,不合格
20170748,65,99,7,57,36,264,不合格
20170749,5,8,27,81,87,208,不合格
20170750,69,15,37,58,81,260,不合格
20170751,12,40,75,84,51,262,不合格
20170752,79,12,18,59,82,250,不合格
20170753,69,45,36,86,45,281,不合格
20170754,71,8,84,27,62,252,不合格
20170755,84,68,44,58,96,350,合格
20170756,90,47,66,10,1,214,不合格
20170757,4,8,87,26,10,135,不合格
20170758,56,20,58,50,18,202,不合格
20170759,1,55,0,81,13,150,不合格
20170760,63,18,62,85,43,271,不合格
20170761,86,58,62,82,97,385,合格
20170762,63,24,27,58,91,263,不合格
20170763,19,87,20,36,65,227,不合格
20170764,81,21,80,25,1,208,不合格
20170765,69,51,66,0,60,246,不合格
20170766,55,31,48,2,3,139,不合格
20170767,88,26,66,91,28,299,不合格
20170768,31,31,9,24,43,138,不合格
20170769,45,91,91,92,32,351,合格
20170770,92,65,67,73,1,298,不合格
20170771,75,14,74,12,42,217,不合格
20170772,67,35,13,58,51,224,不合格
20170773,98,93,9,88,93,381,合格
20170774,79,93,83,24,98,377,合格
20170775,49,31,26,32,10,148,不合格
20170776,10,74,50,0,87,221,不合格
20170777,52,42,51,1,72,218,不合格
20170778,35,43,30,21,56,185,不合格
20170779,84,98,96,48,53,379,合格
20170780,44,69,80,91,13,297,不合格
20170781,97,58,5,56,66,282,不合格
20170782,20,17,6,99,83,225,不合格
20170783,99,59,61,92,98,409,合格
20170784,16,54,21,99,42,232,不合格
20170785,21,13,54,85,97,270,不合格
20170786,16,42,88,35,33,214,不合格
20170787,73,57,79,79,44,332,合格
20170788,81,3,57,51,46,238,不合格
20170789,18,41,86,44,19,208,不合格
20170790,66,61,88,94,19,328,合格
20170791,97,3,45,97,31,273,不合格
20170792,36,93,84,5,97,315,合格
20170793,48,51,74,98,44,315,合格
20170794,14,15,50,75,9,163,不合格
20170795,53,17,1,7,95,173,不合格
20170796,47,87,24,56,49,263,不合格
20170797,87,65,55,48,34,289,不合格
20170798,40,48,1,89,16,194,不合格
20170799,48,43,62,57,34,244,不合格
20170800,2,20,32,83,85,222,不合格
20170801,78,38,70,20,5,211,不合格
20170802,56,37,58,29,25,205,不合格
20170803,57,25,81,10,9,182,不合格
20170804,73,28,76,24,74,275,不合格
20170805,0,49,62,70,90,271,不合格
20170806,8,31,81,8,23,151,不合格
20170807,97,3,17,79,71,267,不合格
20170808,85,41,38,66,68,298,不合格
20170809,57,76,42,69,34,278,不合格
20170810,21,7,88,61,81,258,不合格
20170811,10,82,64,41,98,295,不合格
20170812,70,75,12,66,83,306,合格
20170813,46,38,26,20,3,133,不合格
20170814,24,2,15,5,34,80,不合格
20170815,45,54,30,1,37,167,不合格
20170816,35,22,85,7,12,161,不合格
20170817,90,52,70,90,46,348,合格
20170818,92,44,0,97,56,289,不合格
20170819,38,61,71,98,93,361,合格
20170820,89,33,39,73,30,264,不合格
20170821,47,3,38,45,60,193,不合格
20170822,57,48,77,36,21,239,不合格
20170823,48,36,72,21,2,179,不合格
20170824,90,16,78,99,26,309,合格
20170825,89,30,80,80,84,363,合格
20170826,82,22,52,4,69,229,不合格
20170827,31,53,19,55,82,240,不合格
20170828,38,32,75,82,14,241,不合格
20170829,29,54,61,25,9,178,不合格
20170830,16,50,12,51,49,178,不合格
20170831,98,8,31,83,21,241,不合格
20170832,51,63,4,58,77,253,不合格
20170833,52,87,68,73,41,321,合格
20170834,16,25,1,19,78,139,不合格
20170835,0,48,18,96,16,178,不合格
20170836,38,64,84,22,56,264,不合格
20170837,83,53,45,60,62,303,合格
20170838,32,54,90,7,90,273,不合格
20170839,6,96,39,33,2,176,不合格
20170840,14,46,61,3,15,139,不合格
20170841,54,76,43,28,14,215,不合格
20170842,45,24,98,49,62,278,不合格
20170843,38,40,1,40,10,129,不合格
20170844,9,11,57,17,60,154,不合格
20170845,11,28,92,9,60,200,不合格
20170846,46,14,31,49,80,220,不合格
20170847,8,49,56,8,72,193,不合格
20170848,78,41,86,82,4,291,不合格
20170849,79,28,49,96,19,271,不合格
20170850,66,38,31,31,77,243,不合格
20170851,66,61,26,17,52,222,不合格
20170852,81,39,86,12,27,245,不合格
20170853,77,7,90,48,45,267,不合格
20170854,87,57,35,95,10,284,不合格
20170855,69,16,87,69,87,328,合格
20170856,40,80,58,65,77,320,合格
20170857,56,39,78,44,23,240,不合格
20170858,51,94,41,95,51,332,合格
20170859,49,86,45,0,56,236,不合格
20170860,52,40,73,31,3,199,不合格
20170861,82,19,84,87,50,322,合格
20170862,55,50,41,33,13,192,不合格
20170863,30,45,91,22,51,239,不合格
20170864,61,28,56,46,56,247,不合格
20170865,87,56,50,60,82,335,合格
20170866,73,5,82,18,46,224,不合格
20170867,83,98,6,40,85,312,合格
20170868,61,6,4,87,55,213,不合格
20170869,73,50,58,51,32,264,不合格
20170870,28,84,7,41,90,250,不合格
20170871,67,85,53,62,81,348,合格
20170872,77,7,30,74,83,271,不合格
20170873,83,87,63,77,66,376,合格
20170874,16,85,38,66,7,212,不合格
20170875,75,32,37,70,85,299,不合格
20170876,92,78,10,44,94,318,合格
20170877,35,69,44,85,58,291,不合格
20170878,66,11,50,2,66,195,不合格
20170879,14,88,29,10,9,150,不合格
20170880,50,56,2,80,55,243,不合格
20170881,21,77,29,80,73,280,不合格
20170882,65,16,58,27,43,209,不合格
20170883,69,57,83,69,81,359,合格
20170884,10,30,56,42,11,149,不合格
20170885,51,24,40,58,40,213,不合格
20170886,81,50,35,80,62,308,合格
20170887,91,28,97,10,93,319,合格
20170888,83,76,11,23,24,217,不合格
20170889,42,1,96,42,46,227,不合格
20170890,18,74,47,37,97,273,不合格
20170891,3,0,24,30,40,97,不合格
20170892,36,11,6,65,71,189,不合格
20170893,37,53,81,99,94,364,合格
20170894,27,21,47,97,46,238,不合格
20170895,77,76,48,7,8,216,不合格
20170896,71,44,79,94,38,326,合格
20170897,83,17,46,82,61,289,不合格
20170898,60,91,23,56,68,298,不合格
20170899,17,81,72,62,69,301,合格
20170900,94,6,27,56,94,277,不合格
20170901,43,1,45,32,60,181,不合格
20170902,66,59,4,4,62,195,不合格
20170903,40,80,70,57,79,326,合格
20170904,95,75,99,38,70,377,合格
20170905,24,34,83,1,8,150,不合格
20170906,55,86,42,4,22,209,不合格
20170907,65,61,71,59,13,269,不合格
20170908,83,65,62,8,35,253,不合格
20170909,27,38,39,19,16,139,不合格
20170910,60,38,37,66,17,218,不合格
20170911,23,18,19,95,18,173,不合格
20170912,97,73,91,52,96,409,合格
20170913,5,4,24,66,67,166,不合格
20170914,8,56,20,98,59,241,不合格
20170915,25,88,78,29,68,288,不合格
20170916,4,94,74,37,71,280,不合格
20170917,76,25,34,12,63,210,不合格
20170918,25,58,36,67,17,203,不合格
20170919,12,60,3,98,29,202,不合格
20170920,48,16,87,53,88,292,不合格
20170921,16,23,25,3,50,117,不合格
20170922,61,77,32,71,82,323,合格
20170923,27,53,5,28,5,118,不合格
20170924,97,27,44,47,49,264,不合格
20170925,20,67,72,88,46,293,不合格
20170926,6,94,11,54,43,208,不合格
20170927,30,86,18,97,96,327,合格
20170928,58,61,34,82,24,259,不合格
20170929,79,99,48,76,96,398,合格
20170930,86,5,12,0,0,103,不合格
20170931,93,16,2,58,13,182,不合格
20170932,14,35,37,28,98,212,不合格
20170933,27,57,55,11,8,158,不合格
20170934,69,37,43,1,73,223,不合格
20170935,71,37,42,73,11,234,不合格
20170936,73,43,94,28,82,320,合格
20170937,70,72,2,30,14,188,不合格
20170938,38,96,5,13,54,206,不合格
20170939,29,1,12,90,19,151,不合格
20170940,31,28,4,96,44,203,不合格
20170941,30,42,1,8,33,114,不合格
20170942,33,57,45,30,31,196,不合格
20170943,83,66,77,20,44,290,不合格
20170944,28,77,88,5,23,221,不合格
20170945,27,15,64,81,96,283,不合格
20170946,45,36,10,63,55,209,不合格
20170947,84,62,84,47,68,345,合格
20170948,7,95,64,87,53,306,合格
20170949,7,61,82,86,16,252,不合格
20170950,99,47,70,61,22,299,不合格
20170951,28,63,3,40,10,144,不合格
20170952,83,83,44,81,7,298,不合格
20170953,10,54,39,45,11,159,不合格
20170954,77,8,73,47,89,294,不合格
20170955,57,33,64,28,29,211,不合格
20170956,32,68,70,6,59,235,不合格
20170957,99,47,90,2,65,303,合格
20170958,93,83,63,33,69,341,合格
20170959,16,46,33,4,31,130,不合格
20170960,75,27,63,43,51,259,不合格
20170961,93,45,24,49,91,302,合格
20170962,92,82,11,52,56,293,不合格
20170963,97,13,26,31,56,223,不合格
20170964,58,92,9,59,36,254,不合格
20170965,12,82,25,59,73,251,不合格
20170966,15,92,27,77,85,296,不合格
20170967,77,55,17,95,12,256,不合格
20170968,20,80,56,36,73,265,不合格
20170969,44,9,75,6,82,216,不合格
20170970,53,99,37,39,8,236,不合格
20170971,50,93,61,36,74,314,合格
20170972,67,78,67,8,62,282,不合格
20170973,88,62,45,16,46,257,不合格
20170974,67,95,66,70,33,331,合格
20170975,30,76,47,95,38,286,不合格
20170976,27,10,2,36,76,151,不合格
20170977,92,11,44,27,4,178,不合格
20170978,74,18,15,26,59,192,不合格
20170979,33,39,30,53,20,175,不合格
20170980,5,41,73,76,18,213,不合格
20170981,22,34,85,6,0,147,不合格
20170982,48,6,1,67,88,210,不合格
20170983,26,30,69,65,91,281,不合格
20170984,18,16,96,78,16,224,不合格
20170985,82,16,40,23,35,196,不合格
20170986,11,83,58,56,70,278,不合格
20170987,85,40,5,9,25,164,不合格
20170988,73,81,79,17,27,277,不合格
20170989,93,96,13,35,80,317,合格
20170990,73,98,83,97,63,414,合格
20170991,23,50,57,78,60,268,不合格
20170992,61,54,52,63,88,318,合格
20170993,91,12,72,84,5,264,不合格
20170994,83,8,45,43,2,181,不合格
20170995,53,81,67,10,87,298,不合格
20170996,31,36,39,26,65,197,不合格
20170997,88,85,44,60,17,294,不合格
20170998,38,78,31,3,52,202,不合格
20170999,96,12,9,33,38,188,不合格
20171000,98,67,1,7,47,220,不合格
20171001,48,22,70,77,10,227,不合格
20171002,37,55,75,82,24,273,不合格
20171003,86,65,7,81,17,256,不合格
20171004,29,6,38,32,55,160,不合格
20171005,80,23,17,92,55,267,不合格
20171006,21,97,16,97,18,249,不合格
20171007,6,53,10,44,22,135,不合格
20171008,0,54,88,2,93,237,不合格
20171009,6,33,0,84,54,177,不合格
20171010,8,33,97,15,69,222,不合格
20171011,77,4,66,83,75,305,合格
20171012,98,8,76,30,47,259,不合格
20171013,94,68,81,87,89,419,合格
20171014,75,97,23,26,58,279,不合格
20171015,92,88,74,22,83,359,合格
20171016,32,34,60,14,34,174,不合格
20171017,29,9,75,88,51,252,不合格
20171018,51,18,85,97,19,270,不合格
20171019,66,30,12,1,21,130,不合格
20171020,19,36,86,34,96,271,不合格
20171021,74,60,82,61,83,360,合格
20171022,50,84,43,71,34,282,不合格
20171023,73,33,67,70,23,266,不合格
20171024,61,80,88,90,86,405,合格
20171025,73,31,97,30,88,319,合格
20171026,40,44,17,38,67,206,不合格
20171027,70,50,57,26,49,252,不合格
20171028,50,61,53,10,46,220,不合格
20171029,78,98,29,36,63,304,合格
20171030,12,81,5,8,15,121,不合格
20171031,38,97,9,14,78,236,不合格
20171032,85,72,34,12,50,253,不合格
20171033,20,51,42,98,8,219,不合格
20171034,71,77,12,73,31,264,不合格
20171035,21,41,54,16,16,148,不合格
20171036,1,90,45,6,29,171,不合格
20171037,61,60,39,8,26,194,不合格
20171038,50,65,88,39,29,271,不合格
20171039,1,57,30,33,91,212,不合格
20171040,79,97,34,42,40,292,不合格
20171041,51,17,61,18,38,185,不合格
20171042,65,89,15,29,22,220,不合格
20171043,54,0,41,80,70,245,不合格
20171044,59,41,93,81,64,338,合格
20171045,41,76,15,30,99,261,不合格
20171046,89,18,15,17,75,214,不合格
20171047,77,5,11,77,45,215,不合格
20171048,58,28,46,3,80,215,不合格
20171049,79,56,31,12,88,266,不合格
20171050,6,69,7,77,60,219,不合格
20171051,73,19,6,94,46,238,不合格
20171052,30,42,47,80,70,269,不合格
20171053,83,12,32,80,47,254,不合格
20171054,64,57,4,4,1,130,不合格
20171055,81,64,69,82,58,354,合格
20171056,97,14,3,13,60,187,不合格
20171057,14,54,17,59,95,239,不合格
20171058,95,30,44,20,51,240,不合格
20171059,8,56,91,31,51,237,不合格
20171060,17,28,21,85,71,222,不合格
20171061,75,71,94,21,80,341,合格
20171062,47,26,26,61,16,176,不合格
20171063,36,47,0,56,55,194,不合格
20171064,85,36,86,99,31,337,合格
20171065,91,74,53,50,66,334,合格
20171066,55,24,54,70,78,281,不合格
20171067,42,90,39,85,44,300,合格
20171068,3,88,92,46,37,266,不合格
20171069,23,96,48,41,52,260,不合格
20171070,99,48,86,14,8,255,不合格
20171071,40,39,77,84,90,330,合格
20171072,65,2,28,11,1,107,不合格
20171073,74,93,91,20,4,282,不合格
20171074,90,32,21,50,51,244,不合格
20171075,38,48,43,76,27,232,不合格
20171076,83,94,53,65,76,371,合格
20171077,37,92,54,20,58,261,不合格
20171078,13,60,89,17,11,190,不合格
20171079,22,79,84,7,18,210,不合格
20171080,92,40,87,89,22,330,合格
20171081,21,91,15,54,94,275,不合格
20171082,43,74,95,58,51,321,合格
20171083,31,82,42,56,46,257,不合格
20171084,94,54,30,4,70,252,不合格
20171085,80,25,12,94,97,308,合格
20171086,14,12,61,65,97,249,不合格
20171087,26,22,54,25,7,134,不合格
20171088,51,27,95,43,24,240,不合格
20171089,87,25,62,56,49,279,不合格
20171090,49,20,32,33,63,197,不合格
20171091,54,28,11,58,30,181,不合格
20171092,62,48,94,91,95,390,合格
20171093,64,3,37,73,53,230,不合格
20171094,93,14,98,55,33,293,不合格
20171095,93,26,90,87,41,337,合格
20171096,11,14,9,86,25,145,不合格
20171097,5,64,91,94,87,341,合格
20171098,5,5,87,90,77,264,不合格
20171099,0,21,75,89,32,217,不合格
20171100,56,59,24,18,78,235,不合格
20171101,4,31,90,71,94,290,不合格
20171102,8,96,57,46,68,275,不合格
20171103,58,5,61,83,68,275,不合格
20171104,70,63,10,45,43,231,不合格
20171105,82,11,41,49,2,185,不合格
20171106,49,15,44,0,57,165,不合格
20171107,95,66,62,86,85,394,合格
20171108,29,55,66,29,86,265,不合格
20171109,57,48,92,41,54,292,不合格
20171110,8,35,24,28,89,184,不合格
20171111,59,37,88,98,78,360,合格
20171112,95,27,53,78,93,346,合格
20171113,34,32,47,11,59,183,不合格
20171114,13,81,6,1,39,140,不合格
20171115,4,26,60,93,76,259,不合格
20171116,90,48,39,78,11,266,不合格
20171117,25,92,14,37,87,255,不合格
20171118,77,53,48,58,72,308,合格
20171119,5,98,85,36,10,234,不合格
20171120,65,17,9,62,0,153,不合格
20171121,41,88,13,40,73,255,不合格
20171122,57,13,59,1,33,163,不合格
20171123,85,25,31,42,9,192,不合格
20171124,81,59,85,73,52,350,合格
20171125,90,45,69,59,48,311,合格
20171126,82,29,91,85,63,350,合格
20171127,7,15,34,76,86,218,不合格
20171128,53,17,0,72,85,227,不合格
20171129,37,89,13,50,27,216,不合格
20171130,30,12,58,50,5,155,不合格
20171131,43,66,29,24,86,248,不合格
20171132,90,55,57,46,90,338,合格
20171133,96,78,6,43,77,300,合格
20171134,22,88,43,7,86,246,不合格
20171135,60,69,63,43,63,298,不合格
20171136,25,44,93,82,38,282,不合格
20171137,69,28,67,11,42,217,不合格
20171138,41,96,49,84,57,327,合格
20171139,21,12,77,9,66,185,不合格
20171140,61,96,66,75,45,343,合格
20171141,80,57,65,94,70,366,合格
20171142,16,39,51,97,79,282,不合格
20171143,72,50,40,65,38,265,不合格
20171144,11,74,47,5,30,167,不合格
20171145,70,61,91,64,19,305,合格
20171146,78,2,90,13,55,238,不合格
20171147,22,44,31,35,64,196,不合格
20171148,19,69,42,70,4,204,不合格
20171149,68,10,39,22,80,219,不合格
20171150,59,84,21,3,91,258,不合格
20171151,40,43,14,73,52,222,不合格
20171152,20,20,18,23,83,164,不合格
20171153,7,29,46,15,0,97,不合格
20171154,67,85,50,5,38,245,不合格
20171155,10,82,17,26,17,152,不合格
20171156,37,94,95,19,32,277,不合格
20171157,32,44,83,61,66,286,不合格
20171158,8,74,51,64,51,248,不合格
20171159,52,88,47,94,22,303,合格
20171160,53,13,25,96,22,209,不合格
20171161,90,90,26,82,23,311,合格
20171162,98,91,56,16,14,275,不合格
20171163,40,97,5,89,76,307,合格
20171164,31,37,50,6,96,220,不合格
20171165,6,76,81,0,70,233,不合格
20171166,67,91,84,17,99,358,合格
20171167,3,12,94,21,3,133,不合格
20171168,59,84,23,45,54,265,不合格
20171169,16,27,73,56,3,175,不合格
20171170,9,5,0,23,25,62,不合格
20171171,11,87,69,95,90,352,合格
20171172,42,8,75,98,85,308,合格
20171173,38,28,65,56,97,284,不合格
20171174,68,22,0,47,93,230,不合格
20171175,84,70,35,97,8,294,不合格
20171176,97,77,37,95,63,369,合格
20171177,33,42,59,1,24,159,不合格
20171178,92,54,0,52,9,207,不合格
20171179,55,86,14,23,80,258,不合格
20171180,54,7,60,51,17,189,不合格
20171181,22,25,57,36,70,210,不合格
20171182,18,47,53,14,92,224,不合格
20171183,4,86,5,69,14,178,不合格
20171184,83,81,53,10,81,308,合格
20171185,90,78,35,78,62,343,合格
20171186,65,48,3,66,52,234,不合格
20171187,88,19,12,7,80,206,不合格
20171188,7,96,70,59,59,291,不合格
20171189,35,59,45,82,67,288,不合格
20171190,7,39,9,84,31,170,不合格
20171191,64,43,83,56,94,340,合格
20171192,73,4,84,45,44,250,不合格
20171193,28,24,2,11,78,143,不合格
20171194,61,34,69,82,84,330,合格
20171195,11,28,74,42,5,160,不合格
20171196,96,91,13,14,28,242,不合格
20171197,46,47,50,50,64,257,不合格
20171198,28,37,33,67,41,206,不合格
20171199,74,55,58,95,66,348,合格
20171200,40,12,77,2,99,230,不合格
20171201,59,7,42,67,17,192,不合格
20171202,36,37,32,47,8,160,不合格
20171203,18,64,60,15,55,212,不合格
20171204,77,96,23,81,92,369,合格
20171205,10,43,78,13,24,168,不合格
20171206,62,19,27,39,76,223,不合格
20171207,93,84,39,85,58,359,合格
20171208,15,66,14,80,71,246,不合格
20171209,31,3,58,75,42,209,不合格
20171210,75,21,11,93,25,225,不合格
20171211,98,95,63,13,48,317,合格
20171212,37,37,43,93,26,236,不合格
20171213,49,59,16,70,63,257,不合格
20171214,49,70,21,7,33,180,不合格
20171215,18,7,55,79,0,159,不合格
20171216,80,65,81,74,51,351,合格
20171217,71,6,46,35,33,191,不合格
20171218,34,81,88,39,1,243,不合格
20171219,67,36,73,45,50,271,不合格
20171220,71,12,35,17,34,169,不合格
20171221,90,18,12,28,34,182,不合格
20171222,51,15,68,7,40,181,不合格
20171223,45,89,26,74,63,297,不合格
20171224,46,14,56,67,84,267,不合格
20171225,75,71,6,80,27,259,不合格
20171226,51,36,34,52,2,175,不合格
20171227,97,57,73,14,43,284,不合格
20171228,92,89,21,93,54,349,合格
20171229,80,18,40,25,13,176,不合格
20171230,46,15,89,48,51,249,不合格
20171231,68,30,9,59,25,191,不合格
20171232,36,35,81,52,2,206,不合格
20171233,44,18,11,79,71,223,不合格
20171234,62,81,10,30,28,211,不合格
20171235,19,48,76,85,85,313,合格
20171236,69,46,51,18,94,278,不合格
20171237,76,9,87,81,13,266,不合格
20171238,71,14,29,13,94,221,不合格
20171239,38,37,36,84,61,256,不合格
20171240,72,31,40,99,1,243,不合格
20171241,67,65,45,84,43,304,合格
20171242,18,90,30,83,49,270,不合格
20171243,86,21,71,8,22,208,不合格
20171244,15,87,18,86,13,219,不合格
20171245,89,14,55,32,1,191,不合格
20171246,66,75,68,34,29,272,不合格
20171247,59,28,34,12,32,165,不合格
20171248,66,75,97,2,75,315,合格
20171249,46,6,49,89,79,269,不合格
20171250,70,45,5,96,31,247,不合格
20171251,93,40,67,74,76,350,合格
20171252,92,94,46,60,85,377,合格
20171253,51,78,76,24,78,307,合格
20171254,22,86,59,92,20,279,不合格
20171255,46,68,90,5,25,234,不合格
20171256,72,65,95,14,92,338,合格
20171257,96,26,51,25,62,260,不合格
20171258,82,50,88,3,80,303,合格
20171259,40,78,51,67,70,306,合格
20171260,46,87,57,26,24,240,不合格
20171261,96,30,18,92,28,264,不合格
20171262,10,86,83,26,22,227,不合格
20171263,13,36,78,90,61,278,不合格
20171264,44,58,24,14,83,223,不合格
20171265,17,59,17,88,73,254,不合格
20171266,77,79,24,69,95,344,合格
20171267,23,99,39,6,1,168,不合格
20171268,70,76,97,91,17,351,合格
20171269,93,43,51,82,92,361,合格
20171270,29,35,88,52,52,256,不合格
20171271,6,24,72,65,72,239,不合格
20171272,0,77,21,77,87,262,不合格
20171273,21,73,55,43,0,192,不合格
20171274,95,34,80,16,54,279,不合格
20171275,67,1,19,37,15,139,不合格
20171276,69,87,35,77,45,313,合格
20171277,89,50,24,23,25,211,不合格
20171278,81,66,13,88,71,319,合格
20171279,16,42,95,44,19,216,不合格
20171280,44,47,95,30,93,309,合格
20171281,80,22,80,24,87,293,不合格
20171282,3,92,21,1,21,138,不合格
20171283,54,60,6,76,53,249,不合格
20171284,74,81,7,96,66,324,合格
20171285,17,85,35,80,27,244,不合格
20171286,22,53,94,4,12,185,不合格
20171287,19,2,50,33,6,110,不合格
20171288,45,45,27,17,48,182,不合格
20171289,56,26,27,12,26,147,不合格
20171290,0,97,15,40,63,215,不合格
20171291,9,11,88,62,56,226,不合格
20171292,31,13,85,32,90,251,不合格
20171293,13,51,45,82,90,281,不合格
20171294,30,47,31,99,12,219,不合格
20171295,94,93,15,32,13,247,不合格
20171296,4,44,71,0,23,142,不合格
20171297,48,36,74,44,29,231,不合格
20171298,48,78,54,38,91,309,合格
20171299,9,35,63,84,13,204,不合格
20171300,44,12,47,5,4,112,不合格
20171301,1,38,72,18,25,154,不合格
20171302,1,99,82,6,58,246,不合格
20171303,31,16,33,81,82,243,不合格
20171304,22,83,88,22,94,309,合格
20171305,95,3,93,23,29,243,不合格
20171306,0,52,96,92,71,311,合格
20171307,49,96,68,7,37,257,不合格
20171308,61,2,38,31,7,139,不合格
20171309,32,7,5,44,46,134,不合格
20171310,80,43,24,81,55,283,不合格
20171311,55,93,41,93,72,354,合格
20171312,67,27,86,62,74,316,合格
20171313,56,44,47,12,1,160,不合格
20171314,4,41,41,43,69,198,不合格
20171315,57,35,37,90,54,273,不合格
20171316,20,35,37,20,33,145,不合格
20171317,15,90,88,13,45,251,不合格
20171318,82,62,4,41,65,254,不合格
20171319,7,73,94,86,74,334,合格
20171320,51,93,89,97,89,419,合格
20171321,57,23,30,87,62,259,不合格
20171322,74,73,77,21,11,256,不合格
20171323,38,34,12,2,59,145,不合格
20171324,30,21,84,11,58,204,不合格
20171325,66,68,57,80,40,311,合格
20171326,51,72,72,93,71,359,合格
20171327,81,97,47,32,41,298,不合格
20171328,88,69,48,70,10,285,不合格
20171329,59,24,24,42,54,203,不合格
20171330,99,99,97,32,54,381,合格
20171331,2,47,42,97,42,230,不合格
20171332,93,74,17,39,17,240,不合格
20171333,65,58,26,82,31,262,不合格
20171334,10,50,35,32,2,129,不合格
20171335,91,1,99,98,39,328,合格
20171336,12,19,15,48,67,161,不合格
20171337,98,14,46,36,28,222,不合格
20171338,58,23,10,95,66,252,不合格
20171339,32,60,52,1,41,186,不合格
20171340,43,10,55,93,65,266,不合格
20171341,76,42,92,38,96,344,合格
20171342,79,91,65,34,4,273,不合格
20171343,95,1,60,17,32,205,不合格
20171344,91,34,42,28,21,216,不合格
20171345,94,67,85,36,69,351,合格
20171346,54,51,54,60,28,247,不合格
20171347,18,12,16,5,54,105,不合格
20171348,68,59,53,65,40,285,不合格
20171349,7,66,95,33,87,288,不合格
20171350,37,41,85,31,87,281,不合格
20171351,73,67,19,16,3,178,不合格
20171352,64,12,9,88,10,183,不合格
20171353,59,12,70,12,32,185,不合格
20171354,84,57,80,96,52,369,合格
20171355,72,39,63,18,14,206,不合格
20171356,48,55,14,22,14,153,不合格
20171357,31,66,72,40,16,225,不合格
20171358,44,8,51,35,98,236,不合格
20171359,30,54,24,59,30,197,不合格
20171360,39,41,63,29,63,235,不合格
20171361,95,81,36,40,89,341,合格
20171362,12,36,49,48,21,166,不合格
20171363,28,2,42,57,0,129,不合格
20171364,75,45,34,17,20,191,不合格
20171365,67,55,96,5,99,322,合格
20171366,9,85,38,79,91,302,合格
20171367,11,21,19,9,35,95,不合格
20171368,79,36,24,52,10,201,不合格
20171369,66,22,54,3,35,180,不合格
20171370,61,66,54,82,95,358,合格
20171371,2,29,84,18,21,154,不合格
20171372,64,44,79,46,53,286,不合格
20171373,96,88,22,69,1,276,不合格
20171374,98,40,73,56,36,303,合格
20171375,14,12,45,41,54,166,不合格
20171376,90,54,53,86,55,338,合格
20171377,46,69,1,66,42,224,不合格
20171378,23,55,17,7,68,170,不合格
20171379,76,58,38,41,85,298,不合格
20171380,93,9,32,58,47,239,不合格
20171381,90,1,9,46,4,150,不合格
20171382,37,40,72,3,12,164,不合格
20171383,63,47,48,64,6,228,不合格
20171384,34,45,6,74,1,160,不合格
20171385,0,60,68,98,45,271,不合格
20171386,93,35,4,59,95,286,不合格
20171387,16,73,9,43,3,144,不合格
20171388,13,53,91,32,66,255,不合格
20171389,47,42,15,85,67,256,不合格
20171390,33,8,9,68,92,210,不合格
20171391,60,9,77,49,83,278,不合格
20171392,79,46,74,8,10,217,不合格
20171393,90,22,72,79,89,352,合格
20171394,18,69,36,26,47,196,不合格
20171395,69,62,1,67,33,232,不合格
20171396,47,57,75,0,15,194,不合格
20171397,50,55,3,59,46,213,不合格
20171398,93,50,69,45,21,278,不合格
20171399,75,43,69,45,62,294,不合格
20171400,84,56,4,54,83,281,不合格
20171401,36,62,16,40,27,181,不合格
20171402,68,76,38,93,29,304,合格
20171403,18,72,93,89,38,310,合格
20171404,36,34,96,78,50,294,不合格
20171405,17,63,51,44,9,184,不合格
20171406,67,84,93,82,86,412,合格
20171407,55,11,68,12,21,167,不合格
20171408,24,88,86,64,62,324,合格
20171409,82,22,50,34,81,269,不合格
20171410,16,83,2,57,31,189,不合格
20171411,40,92,10,16,94,252,不合格
20171412,7,65,97,68,72,309,合格
20171413,31,46,99,23,51,250,不合格
20171414,62,73,39,89,46,309,合格
20171415,79,53,13,65,8,218,不合格
20171416,76,67,65,71,45,324,合格
20171417,25,31,2,82,50,190,不合格
20171418,85,29,10,29,92,245,不合格
20171419,88,47,84,51,42,312,合格
20171420,6,58,73,17,41,195,不合格
20171421,83,46,60,93,24,306,合格
20171422,51,70,38,71,39,269,不合格
20171423,20,90,87,62,54,313,合格
20171424,55,50,60,49,62,276,不合格
20171425,80,98,6,87,50,321,合格
20171426,70,75,87,72,15,319,合格
20171427,27,23,29,60,98,237,不合格
20171428,14,6,14,80,6,120,不合格
20171429,4,49,95,41,57,246,不合格
20171430,40,3,3,6,48,100,不合格
20171431,1,21,99,90,80,291,不合格
20171432,27,11,13,36,35,122,不合格
20171433,12,3,98,97,25,235,不合格
20171434,22,9,91,27,88,237,不合格
20171435,97,0,12,7,88,204,不合格
20171436,34,80,60,21,38,233,不合格
20171437,56,99,57,87,38,337,合格
20171438,85,19,79,57,10,250,不合格
20171439,94,64,93,1,39,291,不合格
20171440,84,80,17,72,36,289,不合格
20171441,13,39,69,1,39,161,不合格
20171442,8,72,51,40,21,192,不合格
20171443,24,53,14,89,20,200,不合格
20171444,95,29,34,93,47,298,不合格
20171445,82,22,38,41,4,187,不合格
20171446,58,88,67,69,11,293,不合格
20171447,51,21,55,46,25,198,不合格
20171448,70,36,60,71,64,301,合格
20171449,10,5,89,94,21,219,不合格
20171450,41,19,31,26,73,190,不合格
20171451,0,37,88,52,69,246,不合格
20171452,79,49,65,8,14,215,不合格
20171453,10,50,75,98,50,283,不合格
20171454,72,69,26,93,84,344,合格
20171455,12,25,26,6,91,160,不合格
20171456,68,21,33,54,75,251,不合格
20171457,82,63,99,28,3,275,不合格
20171458,97,5,55,65,29,251,不合格
20171459,16,87,91,26,0,220,不合格
20171460,65,98,78,22,39,302,合格
20171461,9,86,86,16,44,241,不合格
20171462,17,13,32,35,51,148,不合格
20171463,93,12,49,58,56,268,不合格
20171464,20,59,9,14,52,154,不合格
20171465,80,58,96,22,25,281,不合格
20171466,46,24,55,34,67,226,不合格
20171467,58,59,62,74,49,302,合格
20171468,38,34,38,11,77,198,不合格
20171469,72,27,81,50,80,310,合格
20171470,93,6,88,71,48,306,合格
20171471,85,81,87,32,95,380,合格
20171472,34,83,42,19,18,196,不合格
20171473,97,60,9,1,45,212,不合格
20171474,97,66,91,96,68,418,合格
20171475,98,56,64,2,84,304,合格
20171476,51,68,63,74,73,329,合格
20171477,16,94,56,85,97,348,合格
20171478,71,16,39,86,95,307,合格
20171479,95,66,78,13,78,330,合格
20171480,61,5,82,23,28,199,不合格
20171481,30,49,66,75,1,221,不合格
20171482,72,87,1,54,7,221,不合格
20171483,74,44,25,83,21,247,不合格
20171484,92,15,79,27,98,311,合格
20171485,5,45,47,21,21,139,不合格
20171486,91,30,38,98,1,258,不合格
20171487,13,59,80,56,3,211,不合格
20171488,66,44,33,74,23,240,不合格
20171489,62,22,44,82,81,291,不合格
20171490,36,83,52,80,51,302,合格
20171491,13,9,76,90,74,262,不合格
20171492,53,54,48,12,25,192,不合格
20171493,62,42,54,23,9,190,不合格
20171494,69,55,18,80,35,257,不合格
20171495,83,19,19,46,36,203,不合格
20171496,45,89,64,66,22,286,不合格
20171497,91,44,4,11,29,179,不合格
20171498,41,76,89,61,53,320,合格
20171499,52,77,25,44,24,222,不合格
20171500,84,85,21,28,86,304,合格
20171501,3,3,80,48,37,171,不合格
20171502,37,50,76,2,53,218,不合格
20171503,43,81,71,22,6,223,不合格
20171504,39,18,50,96,31,234,不合格
20171505,45,57,98,69,53,322,合格
20171506,71,79,68,24,30,272,不合格
20171507,94,67,1,98,35,295,不合格
20171508,69,55,63,0,59,246,不合格
20171509,23,8,18,67,98,214,不合格
20171510,14,73,85,34,17,223,不合格
20171511,0,13,0,62,61,136,不合格
20171512,7,53,54,26,55,195,不合格
20171513,73,71,83,62,8,297,不合格
20171514,66,44,96,3,95,304,合格
20171515,21,54,77,16,54,222,不合格
20171516,31,75,55,53,90,304,合格
20171517,36,27,99,54,44,260,不合格
20171518,41,94,97,95,26,353,合格
20171519,47,61,9,1,61,179,不合格
20171520,35,91,48,88,94,356,合格
20171521,78,4,47,16,82,227,不合格
20171522,29,42,15,78,98,262,不合格
20171523,11,32,14,54,81,192,不合格
20171524,33,70,28,59,94,284,不合格
20171525,56,9,75,85,85,310,合格
20171526,28,69,96,15,31,239,不合格
20171527,17,31,63,56,31,198,不合格
20171528,99,5,13,36,74,227,不合格
20171529,82,33,21,27,23,186,不合格
20171530,43,32,13,89,75,252,不合格
20171531,1,17,76,43,82,219,不合格
20171532,67,39,21,48,82,257,不合格
20171533,52,93,30,28,89,292,不合格
20171534,0,63,54,10,11,138,不合格
20171535,31,47,22,0,98,198,不合格
20171536,8,20,41,87,18,174,不合格
20171537,80,78,50,27,54,289,不合格
20171538,22,74,16,93,89,294,不合格
20171539,55,7,89,29,23,203,不合格
20171540,59,69,56,55,60,299,不合格
20171541,78,30,67,24,3,202,不合格
20171542,0,92,51,59,3,205,不合格
20171543,91,39,23,70,7,230,不合格
20171544,55,64,18,43,11,191,不合格
20171545,22,38,27,58,47,192,不合格
20171546,55,66,0,51,63,235,不合格
20171547,37,55,44,56,40,232,不合格
20171548,78,89,88,52,67,374,合格
20171549,65,11,19,14,74,183,不合格
20171550,9,79,76,18,54,236,不合格
20171551,75,42,23,65,58,263,不合格
20171552,26,89,27,59,45,246,不合格
20171553,3,3,21,69,92,188,不合格
20171554,58,19,69,56,44,246,不合格
20171555,30,23,24,48,36,161,不合格
20171556,94,28,47,9,0,178,不合格
20171557,53,12,82,54,99,300,合格
20171558,85,6,30,38,4,163,不合格
20171559,78,82,13,60,96,329,合格
20171560,17,1,16,4,38,76,不合格
20171561,1,82,56,48,41,228,不合格
20171562,77,34,0,67,41,219,不合格
20171563,76,72,10,57,27,242,不合格
20171564,46,62,87,71,87,353,合格
20171565,49,8,6,43,64,170,不合格
20171566,80,47,96,94,69,386,合格
20171567,24,79,85,12,5,205,不合格
20171568,82,16,96,19,87,300,合格
20171569,14,15,65,27,2,123,不合格
20171570,25,26,3,42,40,136,不合格
20171571,80,34,16,44,73,247,不合格
20171572,5,33,44,75,72,229,不合格
20171573,93,36,5,57,44,235,不合格
20171574,82,47,64,86,37,316,合格
20171575,70,54,63,73,95,355,合格
20171576,68,96,49,43,64,320,合格
20171577,91,48,7,28,88,262,不合格
20171578,73,59,26,15,16,189,不合格
20171579,3,28,45,25,1,102,不合格
20171580,77,77,19,17,68,258,不合格
20171581,38,60,43,14,0,155,不合格
20171582,56,47,39,51,65,258,不合格
20171583,39,59,55,93,34,280,不合格
20171584,7,1,54,30,1,93,不合格
20171585,24,94,41,56,64,279,不合格
20171586,76,80,40,92,90,378,合格
20171587,16,29,64,25,30,164,不合格
20171588,39,50,67,0,95,251,不合格
20171589,58,33,9,87,94,281,不合格
20171590,62,25,3,69,82,241,不合格
20171591,23,52,66,8,44,193,不合格
20171592,23,96,48,10,42,219,不合格
20171593,91,76,99,85,71,422,合格
20171594,61,45,33,32,49,220,不合格
20171595,20,99,84,2,23,228,不合格
20171596,75,17,78,18,29,217,不合格
20171597,44,92,92,2,22,252,不合格
20171598,84,45,65,69,69,332,合格
20171599,6,52,2,49,72,181,不合格
20171600,94,23,28,32,26,203,不合格
20171601,66,26,13,1,1,107,不合格
20171602,68,48,59,3,94,272,不合格
20171603,77,89,18,89,81,354,合格
20171604,23,91,86,46,23,269,不合格
20171605,57,71,35,34,33,230,不合格
20171606,98,13,89,57,75,332,合格
20171607,66,68,34,22,98,288,不合格
20171608,95,98,62,11,38,304,合格
20171609,82,10,40,53,25,210,不合格
20171610,95,42,20,59,94,310,合格
20171611,56,84,29,46,59,274,不合格
20171612,75,19,18,51,76,239,不合格
20171613,54,36,51,46,13,200,不合格
20171614,1,8,10,73,74,166,不合格
20171615,34,34,27,3,58,156,不合格
20171616,84,73,48,97,71,373,合格
20171617,35,98,77,56,1,267,不合格
20171618,30,93,60,96,92,371,合格
20171619,20,67,82,5,14,188,不合格
20171620,14,87,94,77,68,340,合格
20171621,96,93,28,21,34,272,不合格
20171622,60,38,41,1,17,157,不合格
20171623,22,66,28,66,18,200,不合格
20171624,6,22,98,30,50,206,不合格
20171625,52,34,70,46,7,209,不合格
20171626,8,13,79,66,3,169,不合格
20171627,11,61,24,14,11,121,不合格
20171628,86,48,31,71,96,332,合格
20171629,50,3,4,47,86,190,不合格
20171630,17,11,94,86,67,275,不合格
20171631,20,3,61,21,43,148,不合格
20171632,88,87,5,77,5,262,不合格
20171633,75,82,40,12,64,273,不合格
20171634,43,84,58,49,24,258,不合格
20171635,76,7,55,46,55,239,不合格
20171636,53,69,9,17,39,187,不合格
20171637,63,38,15,30,20,166,不合格
20171638,62,51,24,20,0,157,不合格
20171639,12,79,64,61,92,308,合格
20171640,31,1,68,25,24,149,不合格
20171641,38,41,87,25,61,252,不合格
20171642,11,11,47,19,36,124,不合格
20171643,18,24,40,87,93,262,不合格
20171644,66,48,75,7,48,244,不合格
20171645,55,47,71,73,63,309,合格
20171646,87,93,95,52,18,345,合格
20171647,71,87,70,5,27,260,不合格
20171648,80,21,95,86,37,319,合格
20171649,7,9,21,99,35,171,不合格
20171650,18,43,67,54,11,193,不合格
20171651,93,49,92,94,44,372,合格
20171652,3,92,78,81,15,269,不合格
20171653,34,17,68,40,57,216,不合格
20171654,68,61,56,24,84,293,不合格
20171655,7,11,55,20,32,125,不合格
20171656,52,20,81,44,18,215,不合格
20171657,88,59,78,31,18,274,不合格
20171658,49,75,69,61,86,340,合格
20171659,19,58,14,92,24,207,不合格
20171660,73,67,31,55,12,238,不合格
20171661,31,38,84,52,80,285,不合格
20171662,7,97,26,43,97,270,不合格
20171663,24,30,76,64,65,259,不合格
20171664,93,10,52,83,61,299,不合格
20171665,60,6,81,19,70,236,不合格
20171666,80,34,76,46,33,269,不合格
20171667,40,71,16,33,88,248,不合格
20171668,44,2,90,98,44,278,不合格
20171669,36,68,27,82,73,286,不合格
20171670,14,23,77,70,10,194,不合格
20171671,20,41,91,75,60,287,不合格
20171672,92,25,8,49,37,211,不合格
20171673,72,32,48,60,42,254,不合格
20171674,5,73,24,0,54,156,不合格
20171675,70,33,8,84,45,240,不合格
20171676,42,69,69,82,81,343,合格
20171677,87,75,84,37,18,301,合格
20171678,88,19,43,17,91,258,不合格
20171679,29,50,12,94,13,198,不合格
20171680,50,75,16,57,22,220,不合格
20171681,23,14,26,27,47,137,不合格
20171682,15,85,1,82,12,195,不合格
20171683,85,80,14,86,65,330,合格
20171684,0,11,82,67,51,211,不合格
20171685,10,70,44,19,83,226,不合格
20171686,11,10,96,83,8,208,不合格
20171687,80,9,88,59,95,331,合格
20171688,98,1,78,71,82,330,合格
20171689,58,68,29,79,96,330,合格
20171690,57,98,8,66,22,251,不合格
20171691,65,86,56,6,76,289,不合格
20171692,77,38,70,75,43,303,合格
20171693,68,48,57,72,56,301,合格
20171694,14,88,13,43,43,201,不合格
20171695,17,58,67,28,87,257,不合格
20171696,42,41,21,98,87,289,不合格
20171697,6,21,87,83,3,200,不合格
20171698,11,89,7,18,0,125,不合格
20171699,11,12,40,89,61,213,不合格
20171700,96,78,21,38,84,317,合格
20171701,36,92,19,91,11,249,不合格
20171702,39,8,65,52,46,210,不合格
20171703,13,92,56,90,77,328,合格
20171704,52,67,23,46,42,230,不合格
20171705,27,79,84,91,4,285,不合格
20171706,25,58,94,37,74,288,不合格
20171707,38,40,2,74,45,199,不合格
20171708,0,34,39,13,25,111,不合格
20171709,38,38,41,26,36,179,不合格
20171710,62,10,99,13,58,242,不合格
20171711,79,99,24,96,65,363,合格
20171712,29,29,21,92,68,239,不合格
20171713,35,99,60,78,63,335,合格
20171714,59,41,34,4,97,235,不合格
20171715,81,37,42,56,27,243,不合格
20171716,92,43,17,68,13,233,不合格
20171717,94,22,99,29,91,335,合格
20171718,26,46,14,65,91,242,不合格
20171719,92,97,77,11,43,320,合格
20171720,35,57,91,86,61,330,合格
20171721,96,37,98,81,99,411,合格
20171722,47,60,33,62,67,269,不合格
20171723,52,16,99,73,60,300,合格
20171724,57,55,79,31,25,247,不合格
20171725,30,38,40,55,66,229,不合格
20171726,30,11,47,51,17,156,不合格
20171727,76,91,58,65,51,341,合格
20171728,35,44,4,27,15,125,不合格
20171729,19,67,74,32,26,218,不合格
20171730,80,95,18,49,25,267,不合格
20171731,95,28,39,13,72,247,不合格
20171732,75,74,81,36,30,296,不合格
20171733,24,18,51,98,58,249,不合格
20171734,50,73,87,7,84,301,合格
20171735,33,21,36,88,20,198,不合格
20171736,99,39,81,86,59,364,合格
20171737,81,71,36,36,74,298,不合格
20171738,9,53,87,76,14,239,不合格
20171739,23,80,9,90,90,292,不合格
20171740,25,32,62,56,32,207,不合格
20171741,17,6,79,56,95,253,不合格
20171742,50,89,38,66,19,262,不合格
20171743,45,10,84,24,58,221,不合格
20171744,69,6,40,84,1,200,不合格
20171745,16,35,95,64,70,280,不合格
20171746,44,70,45,38,20,217,不合格
20171747,12,18,8,4,35,77,不合格
20171748,44,45,58,17,54,218,不合格
20171749,87,93,86,72,33,371,合格
20171750,82,56,3,25,75,241,不合格
20171751,36,82,33,0,28,179,不合格
20171752,56,22,64,16,93,251,不合格
20171753,36,58,17,40,69,220,不合格
20171754,8,52,75,5,3,143,不合格
20171755,56,29,22,83,5,195,不合格
20171756,72,56,56,12,15,211,不合格
20171757,86,79,82,52,3,302,合格
20171758,31,1,30,29,10,101,不合格
20171759,67,90,6,81,63,307,合格
20171760,41,21,57,45,91,255,不合格
20171761,34,80,97,18,2,231,不合格
20171762,63,31,97,58,83,332,合格
20171763,37,32,98,67,49,283,不合格
20171764,41,51,23,48,82,245,不合格
20171765,44,34,26,11,86,201,不合格
20171766,12,61,33,92,86,284,不合格
20171767,56,46,46,3,34,185,不合格
20171768,37,80,19,42,54,232,不合格
20171769,27,92,50,74,19,262,不合格
20171770,40,48,74,0,28,190,不合格
20171771,12,48,39,1,29,129,不合格
20171772,79,76,26,76,89,346,合格
20171773,22,28,23,35,52,160,不合格
20171774,90,0,55,14,78,237,不合格
20171775,0,94,60,30,3,187,不合格
20171776,57,29,97,74,17,274,不合格
20171777,84,0,33,32,11,160,不合格
20171778,67,87,5,11,20,190,不合格
20171779,96,71,94,51,51,363,合格
20171780,50,0,70,39,73,232,不合格
20171781,70,76,2,64,57,269,不合格
20171782,38,40,6,61,45,190,不合格
20171783,13,10,88,73,40,224,不合格
20171784,35,55,52,47,67,256,不合格
20171785,22,61,36,53,52,224,不合格
20171786,72,24,41,9,69,215,不合格
20171787,36,82,98,93,58,367,合格
20171788,27,17,99,44,21,208,不合格
20171789,30,81,91,93,22,317,合格
20171790,87,80,1,13,57,238,不合格
20171791,53,47,35,99,54,288,不合格
20171792,61,1,69,79,93,303,合格
20171793,13,87,93,97,13,303,合格
20171794,1,88,7,90,83,269,不合格
20171795,24,71,72,72,97,336,合格
20171796,23,54,93,17,31,218,不合格
20171797,44,44,8,94,87,277,不合格
20171798,69,23,76,62,10,240,不合格
20171799,81,38,57,11,74,261,不合格
20171800,84,78,1,0,70,233,不合格
20171801,27,38,30,55,35,185,不合格
20171802,72,26,17,57,52,224,不合格
20171803,85,85,49,67,31,317,合格
20171804,28,95,65,60,48,296,不合格
20171805,96,37,10,7,65,215,不合格
20171806,4,24,95,66,57,246,不合格
20171807,65,77,45,15,16,218,不合格
20171808,41,14,48,93,88,284,不合格
20171809,18,96,3,95,72,284,不合格
20171810,66,39,5,25,59,194,不合格
20171811,25,39,62,50,81,257,不合格
20171812,11,77,76,71,94,329,合格
20171813,16,10,51,92,26,195,不合格
20171814,96,66,38,43,85,328,合格
20171815,21,46,90,24,3,184,不合格
20171816,30,48,81,1,92,252,不合格
20171817,20,92,92,24,22,250,不合格
20171818,44,25,23,32,9,133,不合格
20171819,53,22,32,85,87,279,不合格
20171820,55,36,73,11,89,264,不合格
20171821,1,67,69,88,61,286,不合格
20171822,24,43,19,3,38,127,不合格
20171823,13,94,43,76,40,266,不合格
20171824,22,81,75,60,68,306,合格
20171825,61,10,56,88,37,252,不合格
20171826,85,74,95,95,29,378,合格
20171827,92,98,85,65,33,373,合格
20171828,19,69,39,6,57,190,不合格
20171829,73,98,16,70,64,321,合格
20171830,57,61,55,34,96,303,合格
20171831,56,16,74,12,64,222,不合格
20171832,7,91,68,54,22,242,不合格
20171833,99,1,4,63,2,169,不合格
20171834,21,81,24,52,89,267,不合格
20171835,19,92,55,66,45,277,不合格
20171836,99,41,67,42,53,302,合格
20171837,43,2,78,39,59,221,不合格
20171838,16,10,8,70,60,164,不合格
20171839,62,5,9,35,92,203,不合格
20171840,64,34,45,98,92,333,合格
20171841,27,24,3,49,52,155,不合格
20171842,55,60,45,91,85,336,合格
20171843,94,68,90,32,75,359,合格
20171844,33,9,12,1,97,152,不合格
20171845,99,45,49,56,25,274,不合格
20171846,93,64,81,77,18,333,合格
20171847,0,79,87,87,33,286,不合格
20171848,40,21,69,38,38,206,不合格
20171849,57,58,46,85,66,312,合格
20171850,94,25,41,20,51,231,不合格
20171851,7,56,3,27,90,183,不合格
20171852,74,89,18,45,21,247,不合格
20171853,34,13,29,38,76,190,不合格
20171854,14,16,34,50,15,129,不合格
20171855,73,86,66,18,52,295,不合格
20171856,27,65,12,44,67,215,不合格
20171857,91,91,37,98,77,394,合格
20171858,62,47,53,25,65,252,不合格
20171859,23,29,51,98,1,202,不合格
20171860,46,52,76,11,46,231,不合格
20171861,37,13,87,33,44,214,不合格
20171862,72,61,15,79,61,288,不合格
20171863,14,46,59,4,85,208,不合格
20171864,15,59,99,97,73,343,合格
20171865,13,10,17,66,4,110,不合格
20171866,71,88,81,52,47,339,合格
20171867,11,24,33,6,44,118,不合格
20171868,13,79,12,48,35,187,不合格
20171869,84,95,24,28,36,267,不合格
20171870,1,3,50,27,97,178,不合格
20171871,65,78,64,65,1,273,不合格
20171872,37,25,67,8,97,234,不合格
20171873,19,74,39,82,2,216,不合格
20171874,47,67,62,19,71,266,不合格
20171875,46,41,47,8,76,218,不合格
20171876,83,50,42,44,86,305,合格
20171877,66,23,18,45,34,186,不合格
20171878,72,54,27,20,47,220,不合格
20171879,14,74,15,31,27,161,不合格
20171880,81,54,74,1,58,268,不合格
20171881,2,41,35,81,58,217,不合格
20171882,63,82,91,12,32,280,不合格
20171883,9,41,77,84,38,249,不合格
20171884,42,55,5,95,98,295,不合格
20171885,77,25,77,13,37,229,不合格
20171886,82,81,16,31,51,261,不合格
20171887,74,55,13,84,55,281,不合格
20171888,67,16,85,52,55,275,不合格
20171889,77,11,39,99,95,321,合格
20171890,12,8,19,63,56,158,不合格
20171891,57,11,76,73,52,269,不合格
20171892,30,17,81,38,20,186,不合格
20171893,79,49,33,68,58,287,不合格
20171894,19,39,47,68,73,246,不合格
20171895,23,9,27,1,6,66,不合格
20171896,10,19,33,40,30,132,不合格
20171897,40,9,28,51,78,206,不合格
20171898,72,40,46,66,32,256,不合格
20171899,3,58,88,73,82,304,合格
20171900,54,44,58,70,5,231,不合格
20171901,77,11,26,73,6,193,不合格
20171902,4,75,42,2,92,215,不合格
20171903,66,84,50,17,71,288,不合格
20171904,60,22,23,59,29,193,不合格
20171905,7,92,12,50,86,247,不合格
20171906,39,22,20,20,12,113,不合格
20171907,14,43,9,85,44,195,不合格
20171908,8,72,9,23,52,164,不合格
20171909,25,1,28,77,33,164,不合格
20171910,60,58,19,78,42,257,不合格
20171911,40,64,6,52,68,230,不合格
20171912,55,89,65,50,39,298,不合格
20171913,79,13,45,32,47,216,不合格
20171914,29,58,48,19,38,192,不合格
20171915,49,15,74,24,59,221,不合格
20171916,61,95,62,32,83,333,合格
20171917,47,42,29,16,78,212,不合格
20171918,64,16,47,57,89,273,不合格
20171919,62,85,8,25,90,270,不合格
20171920,2,23,42,50,70,187,不合格
20171921,54,56,9,22,24,165,不合格
20171922,79,9,32,83,64,267,不合格
20171923,93,7,13,82,61,256,不合格
20171924,96,8,88,74,49,315,合格
20171925,26,57,8,55,69,215,不合格
20171926,6,78,98,13,53,248,不合格
20171927,0,1,43,50,84,178,不合格
20171928,44,10,58,86,54,252,不合格
20171929,45,94,48,63,77,327,合格
20171930,47,65,68,95,65,340,合格
20171931,60,27,53,38,22,200,不合格
20171932,83,35,42,7,10,177,不合格
20171933,43,57,76,59,26,261,不合格
20171934,31,24,30,92,43,220,不合格
20171935,32,0,79,42,27,180,不合格
20171936,56,35,77,98,70,336,合格
20171937,29,63,66,77,26,261,不合格
20171938,46,88,55,38,41,268,不合格
20171939,4,73,39,10,55,181,不合格
20171940,87,13,19,96,14,229,不合格
20171941,51,43,82,2,27,205,不合格
20171942,75,7,56,6,5,149,不合格
20171943,49,56,52,50,73,280,不合格
20171944,55,9,57,14,14,149,不合格
20171945,40,84,88,85,5,302,合格
20171946,89,45,41,47,48,270,不合格
20171947,38,46,99,53,55,291,不合格
20171948,49,57,90,49,2,247,不合格
20171949,24,26,39,68,90,247,不合格
20171950,80,96,63,95,76,410,合格
20171951,70,67,55,93,93,378,合格
20171952,46,93,0,55,27,221,不合格
20171953,90,56,90,45,19,300,合格
20171954,47,95,32,69,0,243,不合格
20171955,76,0,71,60,43,250,不合格
20171956,46,1,27,12,29,115,不合格
20171957,52,77,80,82,51,342,合格
20171958,2,51,50,10,2,115,不合格
20171959,1,12,17,10,64,104,不合格
20171960,53,61,20,27,16,177,不合格
20171961,82,62,71,20,98,333,合格
20171962,1,23,52,12,86,174,不合格
20171963,27,87,28,36,53,231,不合格
20171964,71,30,21,32,39,193,不合格
20171965,56,55,66,80,71,328,合格
20171966,78,84,65,87,30,344,合格
20171967,2,39,23,23,58,145,不合格
20171968,55,81,68,30,62,296,不合格
20171969,44,17,97,87,80,325,合格
20171970,25,19,12,47,52,155,不合格
20171971,55,78,63,4,67,267,不合格
20171972,30,37,32,9,96,204,不合格
20171973,42,51,21,9,49,172,不合格
20171974,98,84,89,48,92,411,合格
20171975,68,53,0,56,26,203,不合格
20171976,5,0,76,70,80,231,不合格
20171977,79,28,10,76,68,261,不合格
20171978,11,56,93,40,19,219,不合格
20171979,18,0,89,12,4,123,不合格
20171980,70,64,84,31,17,266,不合格
20171981,85,81,2,97,48,313,合格
20171982,2,93,63,90,76,324,合格
20171983,51,6,52,72,31,212,不合格
20171984,57,7,89,1,18,172,不合格
20171985,0,78,21,81,40,220,不合格
20171986,11,48,97,55,68,279,不合格
20171987,89,59,7,88,6,249,不合格
20171988,44,83,96,38,78,339,合格
20171989,57,91,58,57,38,301,合格
20171990,28,83,42,41,89,283,不合格
20171991,57,60,50,0,16,183,不合格
20171992,54,0,97,9,29,189,不合格
20171993,54,26,17,13,52,162,不合格
20171994,38,27,65,82,60,272,不合格
20171995,28,49,75,55,14,221,不合格
20171996,63,87,85,8,35,278,不合格
20171997,38,74,5,14,83,214,不合格
20171998,47,49,37,66,32,231,不合格
20171999,41,8,4,83,42,178,不合格
20172000,59,34,58,10,41,202,不合格
20172001,55,63,19,47,79,263,不合格
20172002,99,20,95,47,92,353,合格
20172003,75,46,20,32,29,202,不合格
20172004,83,25,69,23,43,243,不合格
20172005,84,53,90,37,81,345,合格
20172006,67,89,41,29,18,244,不合格
20172007,59,66,60,36,41,262,不合格
20172008,79,31,47,53,54,264,不合格
20172009,92,92,15,39,35,273,不合格
20172010,20,0,48,6,10,84,不合格
20172011,28,25,91,51,29,224,不合格
20172012,43,84,92,64,77,360,合格
20172013,60,0,78,33,35,206,不合格
20172014,95,43,21,11,11,181,不合格
20172015,24,34,61,43,62,224,不合格
20172016,97,69,41,18,38,263,不合格
20172017,21,66,8,6,97,198,不合格
20172018,73,39,67,79,62,320,合格
20172019,14,76,19,30,30,169,不合格
20172020,64,68,75,87,54,348,合格
20172021,59,22,40,84,35,240,不合格
20172022,14,62,5,32,22,135,不合格
20172023,61,24,54,14,12,165,不合格
20172024,23,0,91,49,64,227,不合格
20172025,52,94,71,91,97,405,合格
20172026,82,38,25,56,96,297,不合格
20172027,59,16,27,42,63,207,不合格
20172028,82,7,38,19,89,235,不合格
20172029,32,29,14,91,99,265,不合格
20172030,95,27,29,78,64,293,不合格
20172031,64,33,12,69,95,273,不合格
20172032,11,71,91,1,24,198,不合格
20172033,90,88,12,32,0,222,不合格
20172034,4,31,24,80,49,188,不合格
20172035,30,3,15,74,52,174,不合格
20172036,9,52,21,76,34,192,不合格
20172037,50,65,17,99,90,321,合格
20172038,51,72,4,36,83,246,不合格
20172039,22,13,54,80,62,231,不合格
20172040,78,24,30,15,75,222,不合格
20172041,48,69,95,77,75,364,合格
20172042,43,59,98,49,95,344,合格
20172043,4,92,9,60,55,220,不合格
20172044,13,76,36,24,91,240,不合格
20172045,86,54,25,82,52,299,不合格
20172046,79,35,37,13,58,222,不合格
20172047,77,33,24,67,53,254,不合格
20172048,92,29,37,61,78,297,不合格
20172049,16,54,78,24,28,200,不合格
20172050,63,0,91,11,81,246,不合格
20172051,15,96,89,95,77,372,合格
20172052,86,79,2,74,12,253,不合格
20172053,71,76,16,67,16,246,不合格
20172054,69,33,68,99,82,351,合格
20172055,23,73,85,86,14,281,不合格
20172056,49,63,61,13,44,230,不合格
20172057,47,23,67,49,51,237,不合格
20172058,58,99,30,72,46,305,合格
20172059,44,3,94,40,1,182,不合格
20172060,54,62,65,39,73,293,不合格
20172061,20,96,6,34,16,172,不合格
20172062,10,71,81,76,15,253,不合格
20172063,21,87,85,78,85,356,合格
20172064,35,41,51,45,1,173,不合格
20172065,48,0,42,29,77,196,不合格
20172066,93,49,48,42,5,237,不合格
20172067,72,80,10,68,23,253,不合格
20172068,73,16,8,60,3,160,不合格
20172069,34,29,39,98,46,246,不合格
20172070,24,45,88,83,30,270,不合格
20172071,75,95,84,97,84,435,合格
20172072,62,57,76,4,77,276,不合格
20172073,92,35,95,13,21,256,不合格
20172074,62,61,92,59,33,307,合格
20172075,29,80,40,54,23,226,不合格
20172076,62,49,8,95,94,308,合格
20172077,88,25,53,97,24,287,不合格
20172078,85,2,44,77,74,282,不合格
20172079,31,5,34,39,1,110,不合格
20172080,94,73,14,45,28,254,不合格
20172081,39,59,22,62,16,198,不合格
20172082,54,7,4,59,35,159,不合格
20172083,93,87,92,33,89,394,合格
20172084,74,88,99,6,73,340,合格
20172085,34,14,71,94,61,274,不合格
20172086,68,64,12,56,61,261,不合格
20172087,32,25,60,57,31,205,不合格
20172088,7,5,63,95,12,182,不合格
20172089,83,42,36,65,14,240,不合格
20172090,1,92,95,48,38,274,不合格
20172091,31,86,24,69,99,309,合格
20172092,90,99,71,98,1,359,合格
20172093,41,93,44,46,18,242,不合格
20172094,55,10,76,16,31,188,不合格
20172095,52,0,80,6,83,221,不合格
20172096,42,69,69,73,30,283,不合格
20172097,84,84,24,46,44,282,不合格
20172098,23,17,96,76,58,270,不合格
20172099,50,72,82,56,42,302,合格
20172100,3,27,31,5,83,149,不合格
20172101,91,6,55,33,24,209,不合格
20172102,3,69,95,61,88,316,合格
20172103,42,18,46,90,32,228,不合格
20172104,71,92,12,11,12,198,不合格
20172105,43,19,14,83,32,191,不合格
20172106,58,46,80,31,15,230,不合格
20172107,26,73,39,14,75,227,不合格
20172108,13,88,34,53,4,192,不合格
20172109,23,58,54,97,6,238,不合格
20172110,74,9,95,22,69,269,不合格
20172111,96,50,65,8,42,261,不合格
20172112,37,9,7,73,2,128,不合格
20172113,40,91,62,69,28,290,不合格
20172114,8,22,33,54,3,120,不合格
20172115,37,87,23,54,69,270,不合格
20172116,19,6,94,9,44,172,不合格
20172117,33,67,86,5,71,262,不合格
20172118,70,88,21,38,1,218,不合格
20172119,99,11,61,0,37,208,不合格
20172120,75,98,93,69,97,432,合格
20172121,47,94,12,18,78,249,不合格
20172122,92,47,94,58,90,381,合格
20172123,11,91,66,26,36,230,不合格
20172124,46,46,84,94,63,333,合格
20172125,14,38,52,90,7,201,不合格
20172126,78,79,80,95,3,335,合格
20172127,58,94,12,75,94,333,合格
20172128,63,52,21,19,3,158,不合格
20172129,74,88,97,15,18,292,不合格
20172130,8,40,52,81,8,189,不合格
20172131,99,51,24,38,20,232,不合格
20172132,48,25,26,63,27,189,不合格
20172133,24,22,9,44,49,148,不合格
20172134,80,36,33,54,46,249,不合格
20172135,68,11,20,55,7,161,不合格
20172136,15,75,61,52,9,212,不合格
20172137,64,91,26,61,9,251,不合格
20172138,42,18,84,40,29,213,不合格
20172139,59,53,33,65,52,262,不合格
20172140,19,21,25,69,64,198,不合格
20172141,87,77,74,14,24,276,不合格
20172142,2,1,12,42,2,59,不合格
20172143,53,26,92,81,38,290,不合格
20172144,97,99,45,88,80,409,合格
20172145,68,1,90,8,88,255,不合格
20172146,84,81,21,77,29,292,不合格
20172147,57,81,67,97,8,310,合格
20172148,48,42,38,50,64,242,不合格
20172149,66,95,19,33,6,219,不合格
20172150,33,50,86,74,73,316,合格
20172151,74,83,22,58,45,282,不合格
20172152,52,23,14,10,98,197,不合格
20172153,92,78,89,13,38,310,合格
20172154,9,24,59,94,7,193,不合格
20172155,8,99,6,33,57,203,不合格
20172156,1,18,99,96,57,271,不合格
20172157,7,59,95,83,17,261,不合格
20172158,33,86,43,53,35,250,不合格
20172159,59,35,31,7,65,197,不合格
20172160,8,60,95,79,43,285,不合格
20172161,70,88,86,29,52,325,合格
20172162,80,76,1,92,56,305,合格
20172163,54,76,72,22,76,300,合格
20172164,45,64,10,87,18,224,不合格
20172165,69,87,22,16,85,279,不合格
20172166,84,20,74,10,67,255,不合格
20172167,54,47,59,43,46,249,不合格
20172168,54,57,16,57,46,230,不合格
20172169,97,61,92,45,19,314,合格
20172170,21,87,37,14,7,166,不合格
20172171,76,17,55,70,4,222,不合格
20172172,64,67,43,63,97,334,合格
20172173,62,73,64,70,66,335,合格
20172174,95,87,2,5,14,203,不合格
20172175,62,28,24,89,34,237,不合格
20172176,87,70,22,30,56,265,不合格
20172177,2,13,45,92,0,152,不合格
20172178,39,71,14,5,45,174,不合格
20172179,84,93,23,88,13,301,合格
20172180,45,48,82,76,61,312,合格
20172181,57,50,49,20,43,219,不合格
20172182,0,40,16,60,61,177,不合格
20172183,89,36,51,53,26,255,不合格
20172184,68,85,95,59,17,324,合格
20172185,46,83,23,28,4,184,不合格
20172186,77,50,9,84,38,258,不合格
20172187,27,15,7,82,33,164,不合格
20172188,97,29,11,28,79,244,不合格
20172189,90,27,21,95,7,240,不合格
20172190,8,8,53,54,58,181,不合格
20172191,56,19,65,84,75,299,不合格
20172192,55,10,56,14,96,231,不合格
20172193,10,86,61,95,68,320,合格
20172194,44,74,34,73,4,229,不合格
20172195,5,0,53,17,13,88,不合格
20172196,41,15,63,31,42,192,不合格
20172197,7,84,44,63,49,247,不合格
20172198,17,35,74,35,59,220,不合格
20172199,67,73,9,35,67,251,不合格
20172200,2,82,68,78,43,273,不合格
20172201,17,26,33,46,66,188,不合格
20172202,50,69,50,10,36,215,不合格
20172203,69,68,9,59,51,256,不合格
20172204,23,99,66,99,99,386,合格
20172205,81,94,84,88,23,370,合格
20172206,53,29,86,89,68,325,合格
20172207,34,64,9,98,50,255,不合格
20172208,81,17,58,85,28,269,不合格
20172209,65,46,58,86,58,313,合格
20172210,50,82,69,39,80,320,合格
20172211,58,18,91,86,51,304,合格
20172212,87,60,39,42,38,266,不合格
20172213,37,21,85,29,19,191,不合格
20172214,12,67,52,78,58,267,不合格
20172215,40,51,21,62,67,241,不合格
20172216,58,23,30,77,61,249,不合格
20172217,32,26,52,8,7,125,不合格
20172218,36,20,84,51,52,243,不合格
20172219,44,30,98,2,9,183,不合格
20172220,53,67,19,20,19,178,不合格
20172221,89,42,26,96,87,340,合格
20172222,79,83,26,57,37,282,不合格
20172223,10,40,25,73,54,202,不合格
20172224,57,70,87,41,45,300,合格
20172225,73,91,42,41,86,333,合格
20172226,58,30,34,9,13,144,不合格
20172227,26,50,16,41,34,167,不合格
20172228,31,14,93,79,86,303,合格
20172229,63,24,65,65,31,248,不合格
20172230,68,31,29,17,15,160,不合格
20172231,45,15,76,98,73,307,合格
20172232,96,41,72,80,39,328,合格
20172233,65,1,71,95,42,274,不合格
20172234,65,86,59,22,55,287,不合格
20172235,38,37,43,64,64,246,不合格
20172236,8,68,11,25,50,162,不合格
20172237,56,40,43,67,60,266,不合格
20172238,35,95,27,84,42,283,不合格
20172239,35,33,11,8,1,88,不合格
20172240,29,45,2,11,14,101,不合格
20172241,37,2,69,76,22,206,不合格
20172242,21,11,10,99,25,166,不合格
20172243,44,21,30,26,55,176,不合格
20172244,40,90,22,48,11,211,不合格
20172245,87,23,52,11,39,212,不合格
20172246,83,78,70,98,50,379,合格
20172247,31,15,79,35,83,243,不合格
20172248,76,76,51,26,33,262,不合格
20172249,78,56,19,33,96,282,不合格
20172250,15,81,9,72,87,264,不合格
20172251,28,9,96,22,62,217,不合格
20172252,66,60,83,75,24,308,合格
20172253,70,20,32,29,21,172,不合格
20172254,20,13,43,47,17,140,不合格
20172255,31,37,14,80,85,247,不合格
20172256,37,4,11,74,45,171,不合格
20172257,19,43,97,87,18,264,不合格
20172258,91,83,83,35,30,322,合格
20172259,62,45,51,73,43,274,不合格
20172260,59,85,98,57,11,310,合格
20172261,10,4,97,39,43,193,不合格
20172262,22,14,17,19,31,103,不合格
20172263,54,34,85,29,83,285,不合格
20172264,37,68,11,11,23,150,不合格
20172265,15,70,27,22,47,181,不合格
20172266,99,55,92,78,71,395,合格
20172267,59,51,53,45,8,216,不合格
20172268,12,68,27,49,3,159,不合格
20172269,46,49,46,20,74,235,不合格
20172270,30,79,13,60,28,210,不合格
20172271,22,77,28,24,92,243,不合格
20172272,30,92,29,94,61,306,合格
20172273,59,88,55,28,31,261,不合格
20172274,30,90,90,94,37,341,合格
20172275,83,84,59,13,45,284,不合格
20172276,3,32,53,22,57,167,不合格
20172277,88,10,64,74,10,246,不合格
20172278,70,64,0,85,92,311,合格
20172279,47,15,24,90,91,267,不合格
20172280,9,91,0,10,36,146,不合格
20172281,83,76,20,17,75,271,不合格
20172282,23,31,50,14,3,121,不合格
20172283,14,3,57,40,18,132,不合格
20172284,75,4,72,55,85,291,不合格
20172285,74,3,46,9,70,202,不合格
20172286,17,11,83,74,3,188,不合格
20172287,4,5,91,51,36,187,不合格
20172288,59,2,3,15,70,149,不合格
20172289,75,63,49,83,26,296,不合格
20172290,2,66,51,37,15,171,不合格
20172291,80,96,7,30,16,229,不合格
20172292,64,54,2,62,20,202,不合格
20172293,76,51,30,80,54,291,不合格
20172294,75,50,2,21,53,201,不合格
20172295,10,95,51,82,20,258,不合格
20172296,0,73,76,88,86,323,合格
20172297,44,26,56,98,44,268,不合格
20172298,17,91,71,4,36,219,不合格
20172299,27,8,50,11,75,171,不合格
20172300,42,5,61,53,61,222,不合格
20172301,27,43,18,77,11,176,不合格
20172302,25,37,82,60,44,248,不合格
20172303,92,44,19,88,74,317,合格
20172304,63,54,66,4,97,284,不合格
20172305,20,87,22,57,49,235,不合格
20172306,77,21,92,89,76,355,合格
20172307,17,38,76,93,38,262,不合格
20172308,42,68,9,9,58,186,不合格
20172309,74,97,36,71,28,306,合格
20172310,77,5,54,32,58,226,不合格
20172311,2,20,11,17,95,145,不合格
20172312,6,68,65,19,37,195,不合格
20172313,26,91,80,26,8,231,不合格
20172314,13,5,18,30,49,115,不合格
20172315,94,21,19,72,75,281,不合格
20172316,21,61,60,19,41,202,不合格
20172317,58,82,10,97,6,253,不合格
20172318,32,77,69,31,75,284,不合格
20172319,17,43,53,66,32,211,不合格
20172320,70,74,35,14,22,215,不合格
20172321,32,45,94,84,28,283,不合格
20172322,4,55,45,29,99,232,不合格
20172323,46,81,59,72,86,344,合格
20172324,45,0,14,29,21,109,不合格
20172325,6,32,42,43,74,197,不合格
20172326,88,88,72,36,55,339,合格
20172327,10,8,55,57,42,172,不合格
20172328,88,30,22,22,77,239,不合格
20172329,69,88,88,18,42,305,合格
20172330,21,86,65,59,35,266,不合格
20172331,97,91,38,84,56,366,合格
20172332,36,11,37,21,51,156,不合格
20172333,64,66,8,42,22,202,不合格
20172334,70,77,74,7,31,259,不合格
20172335,51,60,4,8,26,149,不合格
20172336,98,89,28,47,37,299,不合格
20172337,65,13,39,26,99,242,不合格
20172338,90,77,85,35,2,289,不合格
20172339,12,33,4,9,8,66,不合格
20172340,92,1,78,72,70,313,合格
20172341,68,95,94,19,3,279,不合格
20172342,89,2,40,42,6,179,不合格
20172343,47,30,72,68,76,293,不合格
20172344,56,62,82,29,56,285,不合格
20172345,53,84,31,59,3,230,不合格
20172346,3,59,47,91,7,207,不合格
20172347,1,11,70,63,28,173,不合格
20172348,93,42,41,54,72,302,合格
20172349,81,85,63,86,38,353,合格
20172350,92,14,33,8,5,152,不合格
20172351,35,56,69,93,40,293,不合格
20172352,96,12,96,19,89,312,合格
20172353,54,75,3,5,54,191,不合格
20172354,47,26,58,51,23,205,不合格
20172355,4,42,5,87,62,200,不合格
20172356,9,39,11,52,36,147,不合格
20172357,32,77,84,7,73,273,不合格
20172358,34,55,54,63,97,303,合格
20172359,75,2,8,65,93,243,不合格
20172360,23,36,21,38,77,195,不合格
20172361,79,70,63,72,74,358,合格
20172362,34,16,27,24,51,152,不合格
20172363,80,86,62,46,88,362,合格
20172364,32,33,88,36,45,234,不合格
20172365,22,76,4,5,58,165,不合格
20172366,69,86,23,20,55,253,不合格
20172367,3,74,87,92,97,353,合格
20172368,39,94,33,93,95,354,合格
20172369,40,7,54,40,39,180,不合格
20172370,9,38,59,75,85,266,不合格
20172371,86,67,41,67,81,342,合格
20172372,31,62,45,86,19,243,不合格
20172373,32,29,42,32,39,174,不合格
20172374,71,50,49,18,17,205,不合格
20172375,19,23,88,22,68,220,不合格
20172376,10,76,48,37,22,193,不合格
20172377,59,15,74,40,73,261,不合格
20172378,28,47,36,8,13,132,不合格
20172379,99,28,32,58,20,237,不合格
20172380,24,40,8,19,67,158,不合格
20172381,83,34,55,68,41,281,不合格
20172382,85,90,89,1,60,325,合格
20172383,34,0,34,3,12,83,不合格
20172384,47,80,80,85,39,331,合格
20172385,52,33,37,15,55,192,不合格
20172386,8,32,66,38,10,154,不合格
20172387,7,66,28,2,24,127,不合格
20172388,0,27,7,99,9,142,不合格
20172389,62,68,53,56,83,322,合格
20172390,67,3,56,83,6,215,不合格
20172391,10,65,51,3,14,143,不合格
20172392,26,98,81,97,23,325,合格
20172393,51,12,61,88,95,307,合格
20172394,68,64,43,81,19,275,不合格
20172395,78,49,96,26,22,271,不合格
20172396,85,1,67,86,74,313,合格
20172397,43,84,59,5,92,283,不合格
20172398,36,47,63,55,30,231,不合格
20172399,26,74,29,96,73,298,不合格
20172400,23,51,46,35,23,178,不合格
20172401,13,18,99,78,35,243,不合格
20172402,13,81,62,92,2,250,不合格
20172403,52,53,41,27,89,262,不合格
20172404,45,13,25,64,23,170,不合格
20172405,44,42,28,83,83,280,不合格
20172406,28,82,35,47,23,215,不合格
20172407,32,32,16,50,14,144,不合格
20172408,56,98,39,34,65,292,不合格
20172409,2,26,24,18,16,86,不合格
20172410,96,88,41,47,37,309,合格
20172411,17,81,15,41,74,228,不合格
20172412,47,73,16,40,45,221,不合格
20172413,53,38,45,86,78,300,合格
20172414,50,71,27,9,0,157,不合格
20172415,20,96,38,86,71,311,合格
20172416,72,41,81,89,77,360,合格
20172417,85,68,46,17,43,259,不合格
20172418,71,25,36,25,23,180,不合格
20172419,90,75,66,33,82,346,合格
20172420,21,78,70,24,6,199,不合格
20172421,32,94,1,96,47,270,不合格
20172422,39,73,53,81,74,320,合格
20172423,30,37,69,56,59,251,不合格
20172424,4,1,62,29,70,166,不合格
20172425,36,13,62,88,75,274,不合格
20172426,44,29,17,37,2,129,不合格
20172427,55,51,61,87,93,347,合格
20172428,16,60,17,35,51,179,不合格
20172429,62,8,20,68,87,245,不合格
20172430,68,42,22,58,25,215,不合格
20172431,74,57,47,69,77,324,合格
20172432,46,16,14,93,16,185,不合格
20172433,95,37,76,9,73,290,不合格
20172434,61,73,70,59,89,352,合格
20172435,45,27,99,21,63,255,不合格
20172436,37,19,51,97,35,239,不合格
20172437,4,39,27,32,86,188,不合格
20172438,66,32,8,30,40,176,不合格
20172439,5,68,99,34,33,239,不合格
20172440,74,9,77,66,67,293,不合格
20172441,56,19,58,58,18,209,不合格
20172442,35,41,67,4,38,185,不合格
20172443,62,71,94,53,13,293,不合格
20172444,35,17,44,94,42,232,不合格
20172445,46,69,96,87,79,377,合格
20172446,45,47,97,29,11,229,不合格
20172447,96,14,61,69,57,297,不合格
20172448,53,13,81,9,69,225,不合格
20172449,81,1,24,70,0,176,不合格
20172450,99,61,22,17,71,270,不合格
20172451,37,11,0,94,14,156,不合格
20172452,21,17,87,49,78,252,不合格
20172453,52,74,92,84,50,352,合格
20172454,85,74,65,62,34,320,合格
20172455,79,66,56,92,89,382,合格
20172456,76,78,66,71,53,344,合格
20172457,57,85,65,78,59,344,合格
20172458,67,80,24,5,31,207,不合格
20172459,37,88,46,95,35,301,合格
20172460,28,3,52,78,46,207,不合格
20172461,34,77,2,0,54,167,不合格
20172462,4,47,10,46,28,135,不合格
20172463,97,79,28,29,7,240,不合格
20172464,57,65,57,84,64,327,合格
20172465,25,88,15,25,61,214,不合格
20172466,67,56,40,34,17,214,不合格
20172467,59,68,65,74,74,340,合格
20172468,88,3,17,84,39,231,不合格
20172469,38,92,1,4,46,181,不合格
20172470,96,17,82,74,59,328,合格
20172471,37,18,97,28,98,278,不合格
20172472,48,76,4,84,10,222,不合格
20172473,75,79,16,83,32,285,不合格
20172474,47,48,36,18,22,171,不合格
20172475,44,59,23,52,3,181,不合格
20172476,17,41,80,39,72,249,不合格
20172477,23,35,55,13,56,182,不合格
20172478,9,13,21,96,70,209,不合格
20172479,62,7,19,71,62,221,不合格
20172480,9,38,16,41,89,193,不合格
20172481,66,78,29,23,25,221,不合格
20172482,56,43,53,76,13,241,不合格
20172483,57,82,21,18,74,252,不合格
20172484,21,23,50,54,81,229,不合格
20172485,60,94,56,70,37,317,合格
20172486,35,24,97,29,17,202,不合格
20172487,7,66,14,91,83,261,不合格
20172488,77,59,13,37,92,278,不合格
20172489,96,70,83,55,18,322,合格
20172490,4,89,19,88,6,206,不合格
20172491,1,82,81,1,36,201,不合格
20172492,67,25,50,70,31,243,不合格
20172493,93,67,62,60,97,379,合格
20172494,82,45,22,41,85,275,不合格
20172495,51,51,20,29,52,203,不合格
20172496,53,67,21,90,82,313,合格
20172497,97,40,91,70,17,315,合格
20172498,65,24,88,47,71,295,不合格
20172499,79,55,43,1,15,193,不合格
20172500,25,79,30,2,19,155,不合格
20172501,1,39,27,8,62,137,不合格
20172502,20,29,49,32,32,162,不合格
20172503,38,86,19,82,8,233,不合格
20172504,50,89,41,91,57,328,合格
20172505,26,10,45,22,62,165,不合格
20172506,23,13,61,54,74,225,不合格
20172507,10,64,0,77,67,218,不合格
20172508,79,61,14,12,55,221,不合格
20172509,35,40,42,81,19,217,不合格
20172510,11,46,39,17,63,176,不合格
20172511,36,99,61,55,55,306,合格
20172512,61,21,86,18,52,238,不合格
20172513,23,31,7,23,20,104,不合格
20172514,91,12,28,86,27,244,不合格
20172515,24,2,83,59,39,207,不合格
20172516,56,74,0,62,61,253,不合格
20172517,28,25,1,75,72,201,不合格
20172518,14,89,49,48,57,257,不合格
20172519,29,46,36,59,28,198,不合格
20172520,0,48,12,73,24,157,不合格
20172521,35,28,48,19,16,146,不合格
20172522,10,49,95,25,80,259,不合格
20172523,34,55,17,59,79,244,不合格
20172524,88,43,99,46,22,298,不合格
20172525,19,23,65,46,92,245,不合格
20172526,1,49,23,76,75,224,不合格
20172527,41,18,58,19,93,229,不合格
20172528,27,28,73,32,23,183,不合格
20172529,10,60,89,97,28,284,不合格
20172530,13,25,28,4,21,91,不合格
20172531,88,33,33,98,79,331,合格
20172532,59,66,88,45,1,259,不合格
20172533,69,27,80,78,28,282,不合格
20172534,57,46,4,68,85,260,不合格
20172535,78,25,24,89,48,264,不合格
20172536,51,97,20,79,56,303,合格
20172537,6,65,99,41,45,256,不合格
20172538,74,49,18,2,15,158,不合格
20172539,12,12,29,90,40,183,不合格
20172540,45,96,33,94,93,361,合格
20172541,97,56,1,88,33,275,不合格
20172542,5,55,59,24,36,179,不合格
20172543,41,70,11,34,95,251,不合格
20172544,29,77,68,52,96,322,合格
20172545,75,71,5,84,64,299,不合格
20172546,13,41,29,40,28,151,不合格
20172547,86,83,28,20,55,272,不合格
20172548,96,65,47,12,69,289,不合格
20172549,18,25,47,27,40,157,不合格
20172550,85,91,17,96,31,320,合格
20172551,49,66,39,82,41,277,不合格
20172552,31,57,33,63,76,260,不合格
20172553,57,26,68,17,60,228,不合格
20172554,86,22,82,42,31,263,不合格
20172555,23,66,87,61,30,267,不合格
20172556,31,99,10,61,46,247,不合格
20172557,74,39,72,75,69,329,合格
20172558,6,75,96,8,60,245,不合格
20172559,79,55,50,43,51,278,不合格
20172560,39,43,74,92,50,298,不合格
20172561,90,0,87,91,28,296,不合格
20172562,12,30,7,98,4,151,不合格
20172563,58,67,65,94,11,295,不合格
20172564,91,50,96,56,24,317,合格
20172565,62,91,41,67,68,329,合格
20172566,0,23,36,86,2,147,不合格
20172567,66,26,24,94,59,269,不合格
20172568,61,49,73,27,29,239,不合格
20172569,28,33,17,34,42,154,不合格
20172570,94,49,59,63,67,332,合格
20172571,34,74,57,23,16,204,不合格
20172572,49,33,95,59,64,300,合格
20172573,69,73,87,48,36,313,合格
20172574,30,43,18,51,41,183,不合格
20172575,74,17,74,35,41,241,不合格
20172576,13,6,43,4,99,165,不合格
20172577,59,82,52,67,17,277,不合格
20172578,38,55,44,48,13,198,不合格
20172579,95,13,68,23,82,281,不合格
20172580,86,19,38,2,52,197,不合格
20172581,79,88,74,17,53,311,合格
20172582,13,54,14,34,15,130,不合格
20172583,94,0,49,50,94,287,不合格
20172584,44,78,88,52,94,356,合格
20172585,89,89,59,85,84,406,合格
20172586,83,16,76,13,39,227,不合格
20172587,74,56,90,91,91,402,合格
20172588,95,69,80,39,37,320,合格
20172589,49,46,38,3,71,207,不合格
20172590,11,98,59,3,79,250,不合格
20172591,1,39,52,19,43,154,不合格
20172592,4,1,86,65,20,176,不合格
20172593,69,25,67,61,92,314,合格
20172594,73,19,4,18,95,209,不合格
20172595,29,42,94,44,18,227,不合格
20172596,0,44,15,34,90,183,不合格
20172597,79,49,11,87,53,279,不合格
20172598,55,53,83,61,56,308,合格
20172599,98,45,26,2,38,209,不合格
20172600,99,5,72,31,21,228,不合格
20172601,11,18,9,80,11,129,不合格
20172602,1,32,2,18,34,87,不合格
20172603,33,34,55,16,2,140,不合格
20172604,70,66,61,89,43,329,合格
20172605,95,76,24,83,43,321,合格
20172606,85,27,55,60,92,319,合格
20172607,82,83,85,58,48,356,合格
20172608,71,83,36,23,98,311,合格
20172609,57,11,2,73,4,147,不合格
20172610,77,31,9,20,79,216,不合格
20172611,69,80,58,26,44,277,不合格
20172612,29,3,73,88,71,264,不合格
20172613,10,54,39,71,4,178,不合格
20172614,52,79,48,8,90,277,不合格
20172615,46,67,56,80,3,252,不合格
20172616,59,57,94,56,53,319,合格
20172617,28,87,77,75,13,280,不合格
20172618,88,95,88,93,78,442,合格
20172619,1,32,21,20,49,123,不合格
20172620,35,81,78,54,64,312,合格
20172621,80,52,45,10,17,204,不合格
20172622,83,45,30,68,31,257,不合格
20172623,70,61,3,76,69,279,不合格
20172624,1,70,3,97,94,265,不合格
20172625,14,22,67,55,6,164,不合格
20172626,67,40,47,68,7,229,不合格
20172627,79,28,64,57,43,271,不合格
20172628,21,96,83,52,89,341,合格
20172629,56,86,97,78,38,355,合格
20172630,47,80,46,67,88,328,合格
20172631,45,78,5,81,14,223,不合格
20172632,10,33,19,59,3,124,不合格
20172633,54,68,16,40,38,216,不合格
20172634,75,79,12,90,29,285,不合格
20172635,1,93,47,66,94,301,合格
20172636,1,73,43,72,50,239,不合格
20172637,85,53,38,6,78,260,不合格
20172638,28,38,10,72,89,237,不合格
20172639,52,18,39,13,66,188,不合格
20172640,58,65,21,40,94,278,不合格
20172641,42,52,3,92,84,273,不合格
20172642,86,16,32,46,92,272,不合格
20172643,96,4,1,20,21,142,不合格
20172644,76,92,60,42,36,306,合格
20172645,44,7,74,18,59,202,不合格
20172646,0,48,32,3,34,117,不合格
20172647,11,78,5,38,68,200,不合格
20172648,1,23,3,25,71,123,不合格
20172649,6,5,49,41,51,152,不合格
20172650,3,1,3,56,59,122,不合格
20172651,54,3,88,13,13,171,不合格
20172652,99,48,37,12,23,219,不合格
20172653,53,93,84,97,10,337,合格
20172654,56,27,56,34,15,188,不合格
20172655,24,61,19,26,43,173,不合格
20172656,92,70,57,18,82,319,合格
20172657,68,40,99,67,88,362,合格
20172658,83,44,38,1,6,172,不合格
20172659,69,66,38,78,1,252,不合格
20172660,5,78,45,46,14,188,不合格
20172661,40,48,71,27,42,228,不合格
20172662,9,27,22,51,14,123,不合格
20172663,63,93,31,40,18,245,不合格
20172664,65,56,64,41,7,233,不合格
20172665,70,16,47,22,89,244,不合格
20172666,92,65,95,7,34,293,不合格
20172667,77,16,35,56,55,239,不合格
20172668,30,0,56,58,68,212,不合格
20172669,38,4,58,91,9,200,不合格
20172670,96,10,78,63,47,294,不合格
20172671,7,1,90,1,78,177,不合格
20172672,32,27,28,93,44,224,不合格
20172673,28,48,73,10,73,232,不合格
20172674,91,48,22,46,5,212,不合格
20172675,2,63,48,71,64,248,不合格
20172676,15,57,67,33,46,218,不合格
20172677,82,34,7,23,94,240,不合格
20172678,85,23,22,38,69,237,不合格
20172679,21,6,24,72,90,213,不合格
20172680,19,65,48,10,50,192,不合格
20172681,78,31,45,38,82,274,不合格
20172682,30,63,80,3,41,217,不合格
20172683,84,70,37,26,13,230,不合格
20172684,11,58,14,61,20,164,不合格
20172685,41,28,12,60,49,190,不合格
20172686,71,31,41,42,79,264,不合格
20172687,57,86,60,66,33,302,合格
20172688,43,59,58,88,21,269,不合格
20172689,36,26,13,77,29,181,不合格
20172690,98,15,99,56,47,315,合格
20172691,91,79,0,97,87,354,合格
20172692,67,89,32,75,92,355,合格
20172693,32,95,76,42,41,286,不合格
20172694,78,84,59,3,87,311,合格
20172695,16,79,20,19,84,218,不合格
20172696,74,11,42,5,82,214,不合格
20172697,92,22,27,84,43,268,不合格
20172698,96,86,7,43,36,268,不合格
20172699,18,93,3,49,70,233,不合格
20172700,21,91,54,66,47,279,不合格
20172701,57,79,35,11,79,261,不合格
20172702,40,43,26,48,3,160,不合格
20172703,7,39,73,4,16,139,不合格
20172704,88,20,82,96,56,342,合格
20172705,5,49,46,45,66,211,不合格
20172706,69,68,95,45,77,354,合格
20172707,14,98,47,16,48,223,不合格
20172708,76,7,82,1,32,198,不合格
20172709,28,7,79,44,48,206,不合格
20172710,60,72,97,34,94,357,合格
20172711,99,31,9,80,24,243,不合格
20172712,59,37,87,56,57,296,不合格
20172713,8,34,73,56,15,186,不合格
20172714,87,7,10,1,94,199,不合格
20172715,7,94,70,68,50,289,不合格
20172716,44,79,7,79,40,249,不合格
20172717,62,20,19,25,84,210,不合格
20172718,61,69,66,86,63,345,合格
20172719,40,74,59,39,82,294,不合格
20172720,15,64,45,18,36,178,不合格
20172721,13,19,32,36,54,154,不合格
20172722,63,2,77,79,54,275,不合格
20172723,33,26,27,12,98,196,不合格
20172724,12,74,20,42,54,202,不合格
20172725,95,86,67,25,83,356,合格
20172726,12,18,10,10,81,131,不合格
20172727,27,37,49,24,72,209,不合格
20172728,58,45,40,43,76,262,不合格
20172729,54,91,71,49,1,266,不合格
20172730,35,66,87,22,41,251,不合格
20172731,46,0,90,38,48,222,不合格
20172732,0,44,1,93,29,167,不合格
20172733,78,70,15,20,35,218,不合格
20172734,41,47,17,75,58,238,不合格
20172735,64,88,20,2,89,263,不合格
20172736,87,77,17,79,89,349,合格
20172737,88,59,2,94,22,265,不合格
20172738,41,11,17,35,25,129,不合格
20172739,60,39,42,75,58,274,不合格
20172740,89,58,40,47,10,244,不合格
20172741,39,99,61,3,91,293,不合格
20172742,26,53,73,27,78,257,不合格
20172743,54,8,25,0,74,161,不合格
20172744,22,0,0,7,92,121,不合格
20172745,31,53,61,12,4,161,不合格
20172746,37,86,96,94,0,313,合格
20172747,35,19,1,57,80,192,不合格
20172748,96,6,36,75,41,254,不合格
20172749,87,44,59,34,93,317,合格
20172750,62,53,0,33,71,219,不合格
20172751,44,36,38,45,4,167,不合格
20172752,62,59,91,34,45,291,不合格
20172753,34,44,30,15,67,190,不合格
20172754,27,94,1,57,80,259,不合格
20172755,50,17,51,96,93,307,合格
20172756,99,66,6,59,87,317,合格
20172757,22,71,43,17,24,177,不合格
20172758,4,85,0,92,51,232,不合格
20172759,64,49,9,89,20,231,不合格
20172760,39,55,15,45,3,157,不合格
20172761,6,48,58,58,90,260,不合格
20172762,72,69,65,17,73,296,不合格
20172763,30,45,95,2,53,225,不合格
20172764,15,89,50,98,30,282,不合格
20172765,35,68,88,81,72,344,合格
20172766,48,89,37,86,75,335,合格
20172767,10,38,76,33,94,251,不合格
20172768,35,71,17,64,87,274,不合格
20172769,28,76,15,69,29,217,不合格
20172770,33,97,61,77,26,294,不合格
20172771,45,15,7,39,80,186,不合格
20172772,86,72,72,85,88,403,合格
20172773,5,42,83,81,96,307,合格
20172774,48,52,88,21,44,253,不合格
20172775,52,8,65,24,87,236,不合格
20172776,77,11,69,18,80,255,不合格
20172777,98,25,22,9,91,245,不合格
20172778,12,56,39,60,42,209,不合格
20172779,63,33,46,11,47,200,不合格
20172780,25,4,27,28,17,101,不合格
20172781,99,57,49,69,3,277,不合格
20172782,38,65,5,81,40,229,不合格
20172783,81,47,16,82,43,269,不合格
20172784,29,10,29,17,96,181,不合格
20172785,23,40,26,48,47,184,不合格
20172786,72,93,70,7,37,279,不合格
20172787,37,43,37,98,59,274,不合格
20172788,5,41,86,13,39,184,不合格
20172789,22,75,96,27,13,233,不合格
20172790,90,68,47,28,66,299,不合格
20172791,58,96,63,19,97,333,合格
20172792,24,58,69,9,57,217,不合格
20172793,44,66,27,37,89,263,不合格
20172794,98,59,43,35,38,273,不合格
20172795,66,70,80,14,73,303,合格
20172796,88,18,4,98,89,297,不合格
20172797,4,28,86,57,81,256,不合格
20172798,16,22,52,12,34,136,不合格
20172799,38,20,29,81,83,251,不合格
20172800,43,9,15,27,60,154,不合格
20172801,2,70,30,76,58,236,不合格
20172802,78,0,33,73,71,255,不合格
20172803,48,23,40,70,79,260,不合格
20172804,24,71,21,72,94,282,不合格
20172805,56,78,42,14,30,220,不合格
20172806,68,6,99,63,77,313,合格
20172807,30,13,98,1,65,207,不合格
20172808,17,24,90,78,74,283,不合格
20172809,37,47,44,73,84,285,不合格
20172810,39,54,59,94,50,296,不合格
20172811,29,16,36,72,97,250,不合格
20172812,10,70,46,33,39,198,不合格
20172813,83,31,21,90,83,308,合格
20172814,25,2,67,79,55,228,不合格
20172815,97,99,22,40,50,308,合格
20172816,18,53,37,45,58,211,不合格
20172817,61,43,22,12,87,225,不合格
20172818,76,26,91,49,11,253,不合格
20172819,6,3,77,52,19,157,不合格
20172820,2,5,76,1,39,123,不合格
20172821,13,22,93,1,62,191,不合格
20172822,12,27,96,23,91,249,不合格
20172823,81,69,88,11,20,269,不合格
20172824,7,43,51,7,1,109,不合格
20172825,80,88,4,17,85,274,不合格
20172826,74,81,5,64,68,292,不合格
20172827,60,81,14,53,89,297,不合格
20172828,54,47,41,34,6,182,不合格
20172829,57,88,32,34,59,270,不合格
20172830,56,69,34,6,49,214,不合格
20172831,19,29,13,50,89,200,不合格
20172832,32,4,49,88,91,264,不合格
20172833,12,23,38,18,26,117,不合格
20172834,24,96,76,79,29,304,合格
20172835,60,35,38,72,48,253,不合格
20172836,37,38,82,67,76,300,合格
20172837,35,94,30,79,81,319,合格
20172838,20,50,43,19,63,195,不合格
20172839,28,67,33,15,42,185,不合格
20172840,95,38,7,39,25,204,不合格
20172841,78,64,7,8,35,192,不合格
20172842,34,29,50,29,73,215,不合格
20172843,51,23,4,48,60,186,不合格
20172844,90,99,73,17,83,362,合格
20172845,24,67,34,22,63,210,不合格
20172846,79,92,77,2,44,294,不合格
20172847,3,6,81,18,26,134,不合格
20172848,65,82,3,60,33,243,不合格
20172849,83,3,35,80,53,254,不合格
20172850,91,22,55,35,37,240,不合格
20172851,54,66,38,36,98,292,不合格
20172852,7,47,48,23,66,191,不合格
20172853,5,83,0,93,3,184,不合格
20172854,48,17,62,59,37,223,不合格
20172855,44,74,72,38,68,296,不合格
20172856,80,79,21,46,32,258,不合格
20172857,19,0,1,19,2,41,不合格
20172858,13,80,24,80,94,291,不合格
20172859,25,0,97,63,69,254,不合格
20172860,55,53,56,90,59,313,合格
20172861,31,63,62,83,29,268,不合格
20172862,2,66,4,70,62,204,不合格
20172863,24,27,95,4,85,235,不合格
20172864,58,43,81,74,36,292,不合格
20172865,37,81,78,64,0,260,不合格
20172866,31,66,24,87,55,263,不合格
20172867,91,23,72,20,42,248,不合格
20172868,89,15,82,56,48,290,不合格
20172869,71,70,88,3,85,317,合格
20172870,3,2,53,29,52,139,不合格
20172871,50,31,46,8,21,156,不合格
20172872,62,4,12,38,57,173,不合格
20172873,66,25,0,59,17,167,不合格
20172874,52,87,61,27,61,288,不合格
20172875,89,25,92,37,88,331,合格
20172876,64,12,54,78,20,228,不合格
20172877,8,7,35,40,5,95,不合格
20172878,63,97,18,60,75,313,合格
20172879,29,94,5,66,25,219,不合格
20172880,1,44,18,41,72,176,不合格
20172881,90,96,56,18,28,288,不合格
20172882,15,92,69,7,76,259,不合格
20172883,74,56,74,33,58,295,不合格
20172884,24,28,93,85,32,262,不合格
20172885,4,84,67,10,96,261,不合格
20172886,56,56,48,92,0,252,不合格
20172887,0,89,20,23,39,171,不合格
20172888,56,48,84,38,80,306,合格
20172889,60,89,33,12,99,293,不合格
20172890,33,0,53,26,97,209,不合格
20172891,87,76,82,12,57,314,合格
20172892,33,98,97,73,21,322,合格
20172893,7,37,17,62,54,177,不合格
20172894,10,38,74,11,62,195,不合格
20172895,98,57,4,84,90,333,合格
20172896,48,81,27,37,57,250,不合格
20172897,74,52,82,1,74,283,不合格
20172898,77,11,60,59,97,304,合格
20172899,55,22,14,47,48,186,不合格
20172900,64,85,31,70,72,322,合格
20172901,14,48,21,86,21,190,不合格
20172902,97,40,60,57,18,272,不合格
20172903,14,74,25,94,65,272,不合格
20172904,83,20,75,90,25,293,不合格
20172905,85,30,87,15,21,238,不合格
20172906,50,55,42,14,77,238,不合格
20172907,78,20,29,54,30,211,不合格
20172908,75,89,3,15,36,218,不合格
20172909,64,2,11,52,26,155,不合格
20172910,29,72,50,45,85,281,不合格
20172911,86,33,97,15,30,261,不合格
20172912,25,86,60,44,24,239,不合格
20172913,59,27,14,67,91,258,不合格
20172914,19,88,30,79,70,286,不合格
20172915,10,17,47,70,2,146,不合格
20172916,90,35,51,45,92,313,合格
20172917,28,51,4,76,22,181,不合格
20172918,75,92,21,53,94,335,合格
20172919,89,56,76,50,69,340,合格
20172920,94,21,40,87,16,258,不合格
20172921,83,14,64,23,0,184,不合格
20172922,38,49,80,31,99,297,不合格
20172923,26,97,89,22,76,310,合格
20172924,4,26,31,73,4,138,不合格
20172925,62,99,14,53,39,267,不合格
20172926,6,62,53,16,67,204,不合格
20172927,79,51,81,51,44,306,合格
20172928,36,55,40,86,93,310,合格
20172929,50,94,27,63,20,254,不合格
20172930,12,99,57,13,12,193,不合格
20172931,42,69,16,74,8,209,不合格
20172932,77,31,98,86,58,350,合格
20172933,80,34,36,72,49,271,不合格
20172934,70,51,77,67,65,330,合格
20172935,86,96,77,83,99,441,合格
20172936,57,80,47,83,74,341,合格
20172937,81,26,66,14,41,228,不合格
20172938,75,20,49,73,65,282,不合格
20172939,24,53,27,4,80,188,不合格
20172940,1,70,16,94,2,183,不合格
20172941,16,14,76,17,75,198,不合格
20172942,15,74,88,95,84,356,合格
20172943,8,54,37,33,26,158,不合格
20172944,63,61,82,64,93,363,合格
20172945,57,83,58,58,8,264,不合格
20172946,62,16,99,48,54,279,不合格
20172947,70,46,92,56,13,277,不合格
20172948,76,97,44,27,74,318,合格
20172949,42,88,97,53,4,284,不合格
20172950,9,36,16,29,24,114,不合格
20172951,71,38,70,14,66,259,不合格
20172952,98,56,38,0,13,205,不合格
20172953,91,61,74,97,45,368,合格
20172954,62,72,94,18,83,329,合格
20172955,53,65,84,20,37,259,不合格
20172956,34,41,30,12,88,205,不合格
20172957,27,92,8,93,79,299,不合格
20172958,4,54,57,53,80,248,不合格
20172959,59,64,65,39,20,247,不合格
20172960,99,78,46,71,68,362,合格
20172961,45,69,59,32,51,256,不合格
20172962,42,4,70,13,57,186,不合格
20172963,23,27,77,57,70,254,不合格
20172964,22,29,82,60,72,265,不合格
20172965,16,56,64,27,18,181,不合格
20172966,25,65,99,58,0,247,不合格
20172967,92,95,11,97,32,327,合格
20172968,92,87,45,77,43,344,合格
20172969,56,18,89,46,17,226,不合格
20172970,34,95,46,54,47,276,不合格
20172971,0,72,7,87,57,223,不合格
20172972,39,44,32,1,75,191,不合格
20172973,7,54,0,99,13,173,不合格
20172974,71,11,19,19,96,216,不合格
20172975,11,98,25,81,52,267,不合格
20172976,86,46,86,90,5,313,合格
20172977,42,75,99,30,29,275,不合格
20172978,32,39,7,77,50,205,不合格
20172979,76,80,30,84,36,306,合格
20172980,52,78,71,25,18,244,不合格
20172981,58,78,90,18,25,269,不合格
20172982,27,62,78,51,57,275,不合格
20172983,58,45,50,77,28,258,不合格
20172984,63,79,17,93,24,276,不合格
20172985,45,55,9,69,21,199,不合格
20172986,1,52,91,90,33,267,不合格
20172987,19,79,17,7,38,160,不合格
20172988,6,68,69,61,20,224,不合格
20172989,72,49,1,59,59,240,不合格
20172990,62,59,67,87,36,311,合格
20172991,66,81,11,99,38,295,不合格
20172992,99,20,94,78,64,355,合格
20172993,73,61,6,56,29,225,不合格
20172994,88,97,60,32,3,280,不合格
20172995,60,35,62,30,46,233,不合格
20172996,13,99,78,37,76,303,合格
20172997,87,23,32,62,88,292,不合格
20172998,62,74,29,84,28,277,不合格
20172999,42,89,26,51,63,271,不合格
20173000,76,37,48,60,90,311,合格
20173001,72,15,40,67,95,289,不合格
20173002,24,3,94,79,24,224,不合格
20173003,38,19,72,74,81,284,不合格
20173004,16,86,71,58,68,299,不合格
20173005,89,89,4,87,18,287,不合格
20173006,16,36,11,91,29,183,不合格
20173007,42,30,38,93,77,280,不合格
20173008,18,97,83,95,45,338,合格
20173009,66,75,25,15,91,272,不合格
20173010,69,96,10,19,96,290,不合格
20173011,75,12,87,4,82,260,不合格
20173012,94,90,59,89,17,349,合格
20173013,10,89,41,35,89,264,不合格
20173014,38,81,89,98,47,353,合格
20173015,88,98,54,8,76,324,合格
20173016,15,57,42,4,72,190,不合格
20173017,48,11,87,41,99,286,不合格
20173018,80,72,98,97,45,392,合格
20173019,12,2,69,14,97,194,不合格
20173020,34,14,49,79,7,183,不合格
20173021,54,11,77,29,0,171,不合格
20173022,61,32,53,90,81,317,合格
20173023,75,6,95,44,52,272,不合格
20173024,78,92,50,54,95,369,合格
20173025,70,44,80,22,5,221,不合格
20173026,60,57,89,75,22,303,合格
20173027,38,60,82,0,21,201,不合格
20173028,14,70,32,55,12,183,不合格
20173029,89,99,13,11,57,269,不合格
20173030,76,45,43,89,44,297,不合格
20173031,62,47,59,56,62,286,不合格
20173032,44,4,60,90,22,220,不合格
20173033,27,75,59,99,24,284,不合格
20173034,98,12,49,36,88,283,不合格
20173035,2,0,29,29,56,116,不合格
20173036,25,57,43,72,7,204,不合格
20173037,26,8,9,90,56,189,不合格
20173038,62,96,88,52,83,381,合格
20173039,38,31,23,90,28,210,不合格
20173040,71,58,86,20,66,301,合格
20173041,67,42,14,38,99,260,不合格
20173042,86,53,99,31,51,320,合格
20173043,71,53,78,94,10,306,合格
20173044,56,61,28,27,71,243,不合格
20173045,50,7,12,5,32,106,不合格
20173046,45,45,1,82,95,268,不合格
20173047,23,81,16,51,74,245,不合格
20173048,10,59,3,51,83,206,不合格
20173049,57,75,86,99,75,392,合格
20173050,39,95,63,78,42,317,合格
20173051,14,45,3,25,24,111,不合格
20173052,46,44,18,91,57,256,不合格
20173053,3,29,88,11,85,216,不合格
20173054,83,94,75,11,39,302,合格
20173055,8,11,12,35,30,96,不合格
20173056,69,76,78,19,62,304,合格
20173057,98,73,44,76,84,375,合格
20173058,48,83,49,93,91,364,合格
20173059,57,50,67,28,65,267,不合格
20173060,31,76,86,57,8,258,不合格
20173061,82,55,10,18,37,202,不合格
20173062,26,98,49,51,49,273,不合格
20173063,69,73,53,60,24,279,不合格
20173064,93,30,93,10,44,270,不合格
20173065,68,33,85,54,80,320,合格
20173066,26,81,29,18,75,229,不合格
20173067,92,12,0,78,12,194,不合格
20173068,1,31,14,25,75,146,不合格
20173069,43,56,6,17,30,152,不合格
20173070,13,33,78,34,26,184,不合格
20173071,41,96,72,97,90,396,合格
20173072,82,37,78,90,65,352,合格
20173073,9,79,70,77,97,332,合格
20173074,86,72,1,21,19,199,不合格
20173075,9,41,91,9,25,175,不合格
20173076,77,39,56,28,43,243,不合格
20173077,97,9,21,96,33,256,不合格
20173078,82,50,73,54,10,269,不合格
20173079,42,41,63,56,8,210,不合格
20173080,45,73,20,28,59,225,不合格
20173081,32,7,90,33,39,201,不合格
20173082,16,96,76,77,30,295,不合格
20173083,19,61,15,40,9,144,不合格
20173084,22,61,20,78,69,250,不合格
20173085,88,51,87,61,61,348,合格
20173086,32,96,96,72,16,312,合格
20173087,61,41,60,77,43,282,不合格
20173088,0,21,35,75,9,140,不合格
20173089,21,66,64,31,39,221,不合格
20173090,96,85,49,8,72,310,合格
20173091,86,11,22,15,34,168,不合格
20173092,69,38,7,42,40,196,不合格
20173093,14,87,97,84,95,377,合格
20173094,92,59,80,5,60,296,不合格
20173095,74,51,44,85,57,311,合格
20173096,16,4,19,82,38,159,不合格
20173097,50,46,83,61,96,336,合格
20173098,30,34,14,10,43,131,不合格
20173099,5,45,28,42,14,134,不合格
20173100,63,34,92,54,6,249,不合格
20173101,66,18,91,7,11,193,不合格
20173102,57,59,72,86,19,293,不合格
20173103,35,26,86,35,92,274,不合格
20173104,16,99,74,47,98,334,合格
20173105,0,24,61,66,85,236,不合格
20173106,99,88,91,18,1,297,不合格
20173107,99,53,86,10,81,329,合格
20173108,52,57,65,58,6,238,不合格
20173109,82,13,31,84,63,273,不合格
20173110,66,48,68,44,14,240,不合格
20173111,73,71,69,73,22,308,合格
20173112,93,89,56,14,53,305,合格
20173113,6,0,50,67,55,178,不合格
20173114,38,19,30,75,95,257,不合格
20173115,48,56,6,32,98,240,不合格
20173116,93,97,2,70,63,325,合格
20173117,86,53,80,77,23,319,合格
20173118,13,99,78,27,35,252,不合格
20173119,92,16,48,67,98,321,合格
20173120,91,52,72,58,41,314,合格
20173121,62,17,31,98,82,290,不合格
20173122,35,20,13,50,60,178,不合格
20173123,82,88,25,51,15,261,不合格
20173124,18,18,1,32,59,128,不合格
20173125,22,19,26,94,49,210,不合格
20173126,18,68,94,9,71,260,不合格
20173127,22,19,91,68,16,216,不合格
20173128,4,40,88,15,41,188,不合格
20173129,37,93,52,65,91,338,合格
20173130,81,53,56,9,70,269,不合格
20173131,84,32,53,10,52,231,不合格
20173132,93,65,21,89,90,358,合格
20173133,88,94,24,24,25,255,不合格
20173134,38,21,85,63,63,270,不合格
20173135,5,74,1,62,39,181,不合格
20173136,23,26,80,13,31,173,不合格
20173137,65,56,63,28,90,302,合格
20173138,33,99,6,50,71,259,不合格
20173139,56,22,88,53,6,225,不合格
20173140,9,61,4,55,1,130,不合格
20173141,97,43,78,84,72,374,合格
20173142,91,71,33,67,83,345,合格
20173143,64,60,19,51,53,247,不合格
20173144,12,49,4,11,60,136,不合格
20173145,39,25,58,30,28,180,不合格
20173146,35,12,25,12,83,167,不合格
20173147,12,65,79,70,61,287,不合格
20173148,21,38,75,65,52,251,不合格
20173149,60,6,90,94,68,318,合格
20173150,24,63,62,80,17,246,不合格
20173151,93,3,28,84,91,299,不合格
20173152,64,94,80,90,25,353,合格
20173153,28,70,46,39,87,270,不合格
20173154,96,50,99,58,32,335,合格
20173155,94,17,21,41,86,259,不合格
20173156,56,51,98,54,65,324,合格
20173157,41,69,15,84,4,213,不合格
20173158,78,43,87,29,59,296,不合格
20173159,64,51,80,54,51,300,合格
20173160,35,93,35,34,86,283,不合格
20173161,72,79,31,13,66,261,不合格
20173162,52,80,26,78,31,267,不合格
20173163,18,36,12,76,57,199,不合格
20173164,12,86,79,54,86,317,合格
20173165,14,3,34,95,93,239,不合格
20173166,53,78,49,79,97,356,合格
20173167,41,34,36,70,22,203,不合格
20173168,41,64,68,68,6,247,不合格
20173169,7,84,3,96,75,265,不合格
20173170,17,39,84,18,35,193,不合格
20173171,87,38,26,13,49,213,不合格
20173172,34,36,72,17,15,174,不合格
20173173,40,77,20,32,54,223,不合格
20173174,93,89,17,15,45,259,不合格
20173175,99,65,30,34,23,251,不合格
20173176,75,12,12,72,82,253,不合格
20173177,70,25,74,65,46,280,不合格
20173178,60,14,93,47,19,233,不合格
20173179,13,52,15,51,52,183,不合格
20173180,5,17,91,26,45,184,不合格
20173181,67,92,72,19,35,285,不合格
20173182,15,85,49,83,94,326,合格
20173183,76,7,44,81,9,217,不合格
20173184,79,63,82,80,29,333,合格
20173185,76,52,25,86,40,279,不合格
20173186,38,34,65,86,68,291,不合格
20173187,7,63,34,84,15,203,不合格
20173188,88,12,10,68,7,185,不合格
20173189,70,12,50,74,44,250,不合格
20173190,96,78,39,82,26,321,合格
20173191,5,76,17,47,57,202,不合格
20173192,40,71,95,27,94,327,合格
20173193,95,2,12,58,92,259,不合格
20173194,8,32,28,4,36,108,不合格
20173195,81,84,63,75,26,329,合格
20173196,65,70,74,84,94,387,合格
20173197,77,6,10,58,2,153,不合格
20173198,45,24,22,29,75,195,不合格
20173199,90,78,12,69,33,282,不合格
20173200,96,52,62,13,75,298,不合格
20173201,84,71,70,4,88,317,合格
20173202,99,20,19,44,96,278,不合格
20173203,69,77,67,69,12,294,不合格
20173204,7,49,40,44,55,195,不合格
20173205,40,67,96,97,13,313,合格
20173206,36,80,98,39,86,339,合格
20173207,91,52,15,48,51,257,不合格
20173208,25,83,95,31,82,316,合格
20173209,2,63,5,53,55,178,不合格
20173210,84,74,19,53,28,258,不合格
20173211,91,39,79,92,48,349,合格
20173212,69,46,42,41,4,202,不合格
20173213,98,34,53,6,71,262,不合格
20173214,78,88,74,93,83,416,合格
20173215,43,64,56,29,39,231,不合格
20173216,82,46,29,31,61,249,不合格
20173217,11,62,62,70,68,273,不合格
20173218,89,58,98,71,88,404,合格
20173219,66,90,89,84,5,334,合格
20173220,48,43,52,49,82,274,不合格
20173221,41,10,1,29,28,109,不合格
20173222,5,95,57,86,66,309,合格
20173223,48,81,36,29,25,219,不合格
20173224,40,54,97,11,50,252,不合格
20173225,54,95,57,24,99,329,合格
20173226,23,65,1,82,93,264,不合格
20173227,32,12,66,93,66,269,不合格
20173228,41,18,71,66,12,208,不合格
20173229,51,81,48,96,36,312,合格
20173230,34,43,26,8,93,204,不合格
20173231,47,41,25,19,12,144,不合格
20173232,56,52,58,16,31,213,不合格
20173233,76,70,39,38,36,259,不合格
20173234,47,17,55,37,26,182,不合格
20173235,20,27,77,86,98,308,合格
20173236,55,34,27,94,4,214,不合格
20173237,87,46,42,23,48,246,不合格
20173238,20,83,47,8,32,190,不合格
20173239,24,99,27,12,93,255,不合格
20173240,68,68,34,69,46,285,不合格
20173241,33,74,12,37,73,229,不合格
20173242,84,97,11,75,10,277,不合格
20173243,22,91,25,88,38,264,不合格
20173244,5,91,52,94,23,265,不合格
20173245,39,40,37,78,20,214,不合格
20173246,53,35,87,18,44,237,不合格
20173247,23,44,47,96,92,302,合格
20173248,31,27,27,25,83,193,不合格
20173249,64,68,43,27,45,247,不合格
20173250,92,2,83,45,92,314,合格
20173251,19,57,91,77,49,293,不合格
20173252,34,53,97,61,92,337,合格
20173253,5,18,6,20,83,132,不合格
20173254,16,0,17,13,89,135,不合格
20173255,72,13,52,69,29,235,不合格
20173256,59,26,54,90,21,250,不合格
20173257,54,53,23,12,91,233,不合格
20173258,56,14,84,48,35,237,不合格
20173259,5,63,78,62,65,273,不合格
20173260,34,33,68,22,18,175,不合格
20173261,79,9,97,30,17,232,不合格
20173262,9,39,45,57,18,168,不合格
20173263,94,79,19,10,17,219,不合格
20173264,50,98,98,13,89,348,合格
20173265,0,94,86,16,17,213,不合格
20173266,28,3,85,51,50,217,不合格
20173267,76,75,97,21,82,351,合格
20173268,72,56,0,10,37,175,不合格
20173269,56,92,97,93,97,435,合格
20173270,65,72,63,67,98,365,合格
20173271,3,68,21,91,85,268,不合格
20173272,13,50,96,30,73,262,不合格
20173273,34,63,36,56,46,235,不合格
20173274,68,3,15,17,72,175,不合格
20173275,21,56,68,85,97,327,合格
20173276,14,31,14,0,30,89,不合格
20173277,91,38,88,99,40,356,合格
20173278,95,42,17,87,66,307,合格
20173279,97,64,89,29,11,290,不合格
20173280,55,21,13,27,6,122,不合格
20173281,27,19,2,59,91,198,不合格
20173282,54,91,35,74,7,261,不合格
20173283,72,59,51,33,50,265,不合格
20173284,18,4,54,84,2,162,不合格
20173285,89,95,58,89,41,372,合格
20173286,73,8,86,40,55,262,不合格
20173287,54,22,34,43,79,232,不合格
20173288,15,56,15,99,27,212,不合格
20173289,62,88,45,92,53,340,合格
20173290,32,76,2,89,10,209,不合格
20173291,37,68,44,26,53,228,不合格
20173292,26,39,2,84,82,233,不合格
20173293,83,23,83,50,20,259,不合格
20173294,55,96,63,1,52,267,不合格
20173295,7,99,47,87,59,299,不合格
20173296,46,20,91,84,49,290,不合格
20173297,40,51,7,26,24,148,不合格
20173298,15,93,93,97,88,386,合格
20173299,22,19,12,27,8,88,不合格
20173300,64,30,63,15,25,197,不合格
20173301,80,86,55,57,47,325,合格
20173302,38,69,23,67,22,219,不合格
20173303,52,58,39,38,4,191,不合格
20173304,71,15,34,43,43,206,不合格
20173305,75,1,35,17,28,156,不合格
20173306,65,23,47,10,80,225,不合格
20173307,92,47,31,16,66,252,不合格
20173308,34,89,48,52,37,260,不合格
20173309,72,6,75,18,7,178,不合格
20173310,62,34,50,82,25,253,不合格
20173311,89,40,97,7,29,262,不合格
20173312,39,42,40,60,99,280,不合格
20173313,74,96,28,37,89,324,合格
20173314,40,72,53,85,47,297,不合格
20173315,96,72,93,93,57,411,合格
20173316,69,23,41,55,96,284,不合格
20173317,81,77,84,81,11,334,合格
20173318,64,30,18,77,65,254,不合格
20173319,80,53,27,55,11,226,不合格
20173320,28,29,22,95,18,192,不合格
20173321,69,95,71,83,50,368,合格
20173322,30,13,83,26,60,212,不合格
20173323,0,87,80,27,27,221,不合格
20173324,55,96,61,66,36,314,合格
20173325,0,89,53,84,64,290,不合格
20173326,18,46,90,53,47,254,不合格
20173327,57,63,7,90,34,251,不合格
20173328,25,54,91,4,66,240,不合格
20173329,36,74,51,38,98,297,不合格
20173330,57,85,23,2,36,203,不合格
20173331,70,56,97,0,31,254,不合格
20173332,64,4,41,86,42,237,不合格
20173333,18,79,20,1,67,185,不合格
20173334,87,32,70,15,99,303,合格
20173335,32,55,62,49,83,281,不合格
20173336,32,97,61,50,65,305,合格
20173337,42,26,90,81,91,330,合格
20173338,59,97,44,71,49,320,合格
20173339,56,48,92,54,24,274,不合格
20173340,91,5,26,22,81,225,不合格
20173341,59,42,0,10,66,177,不合格
20173342,62,90,36,95,52,335,合格
20173343,77,92,78,96,42,385,合格
20173344,71,15,26,10,40,162,不合格
20173345,37,10,53,23,35,158,不合格
20173346,90,74,49,51,38,302,合格
20173347,46,28,49,16,35,174,不合格
20173348,34,64,93,0,48,239,不合格
20173349,13,58,80,5,25,181,不合格
20173350,69,46,86,15,49,265,不合格
20173351,59,75,97,0,43,274,不合格
20173352,62,56,96,22,51,287,不合格
20173353,93,24,5,99,96,317,合格
20173354,90,25,78,71,96,360,合格
20173355,43,56,25,36,89,249,不合格
20173356,79,0,58,75,59,271,不合格
20173357,19,91,42,38,88,278,不合格
20173358,14,87,2,72,50,225,不合格
20173359,0,94,12,8,2,116,不合格
20173360,69,77,36,35,40,257,不合格
20173361,20,92,33,46,60,251,不合格
20173362,58,72,80,57,68,335,合格
20173363,58,5,3,71,52,189,不合格
20173364,36,22,25,99,92,274,不合格
20173365,77,98,27,90,61,353,合格
20173366,12,1,53,94,13,173,不合格
20173367,2,59,67,12,27,167,不合格
20173368,21,80,40,69,17,227,不合格
20173369,79,12,49,58,99,297,不合格
20173370,22,33,50,87,13,205,不合格
20173371,93,81,93,16,28,311,合格
20173372,18,57,39,27,60,201,不合格
20173373,52,5,79,19,35,190,不合格
20173374,21,64,97,20,70,272,不合格
20173375,20,96,64,71,88,339,合格
20173376,87,50,73,71,54,335,合格
20173377,59,69,10,15,29,182,不合格
20173378,20,95,64,53,0,232,不合格
20173379,12,9,48,4,59,132,不合格
20173380,34,84,42,36,95,291,不合格
20173381,66,56,31,36,99,288,不合格
20173382,89,52,80,34,94,349,合格
20173383,74,24,53,40,27,218,不合格
20173384,61,62,43,11,54,231,不合格
20173385,4,31,8,78,19,140,不合格
20173386,7,82,90,23,29,231,不合格
20173387,11,18,57,94,97,277,不合格
20173388,53,48,50,88,87,326,合格
20173389,20,34,10,82,50,196,不合格
20173390,69,20,90,54,81,314,合格
20173391,14,47,7,46,59,173,不合格
20173392,70,34,23,74,35,236,不合格
20173393,85,56,59,24,11,235,不合格
20173394,10,78,27,4,82,201,不合格
20173395,24,84,62,10,74,254,不合格
20173396,74,61,64,18,26,243,不合格
20173397,49,21,10,35,52,167,不合格
20173398,3,60,92,53,4,212,不合格
20173399,14,2,50,69,0,135,不合格
20173400,97,94,61,57,63,372,合格
20173401,59,5,74,84,86,308,合格
20173402,81,65,82,64,49,341,合格
20173403,54,63,19,27,87,250,不合格
20173404,22,7,22,14,33,98,不合格
20173405,35,40,59,11,28,173,不合格
20173406,49,22,45,16,9,141,不合格
20173407,37,47,3,51,97,235,不合格
20173408,6,32,1,27,34,100,不合格
20173409,39,12,48,63,98,260,不合格
20173410,88,10,77,3,49,227,不合格
20173411,9,17,51,1,58,136,不合格
20173412,48,25,27,64,29,193,不合格
20173413,89,43,73,41,64,310,合格
20173414,94,39,50,58,67,308,合格
20173415,72,86,17,48,46,269,不合格
20173416,56,10,54,59,70,249,不合格
20173417,68,26,94,98,38,324,合格
20173418,49,39,11,36,78,213,不合格
20173419,57,66,89,22,86,320,合格
20173420,15,62,7,88,34,206,不合格
20173421,95,74,12,1,11,193,不合格
20173422,95,84,97,84,96,456,合格
20173423,30,68,52,21,91,262,不合格
20173424,79,36,42,91,7,255,不合格
20173425,85,89,9,5,58,246,不合格
20173426,33,12,84,31,26,186,不合格
20173427,65,57,93,65,98,378,合格
20173428,81,69,48,62,86,346,合格
20173429,44,32,62,53,35,226,不合格
20173430,58,24,57,72,83,294,不合格
20173431,1,62,8,46,40,157,不合格
20173432,89,63,14,90,17,273,不合格
20173433,48,76,48,41,83,296,不合格
20173434,20,28,53,48,7,156,不合格
20173435,34,15,50,34,58,191,不合格
20173436,17,20,58,99,38,232,不合格
20173437,78,36,37,14,6,171,不合格
20173438,90,10,3,91,97,291,不合格
20173439,3,54,31,27,69,184,不合格
20173440,72,88,36,55,38,289,不合格
20173441,23,44,37,26,66,196,不合格
20173442,51,30,25,62,44,212,不合格
20173443,14,36,50,30,52,182,不合格
20173444,56,64,71,86,91,368,合格
20173445,4,97,8,3,1,113,不合格
20173446,84,36,47,35,86,288,不合格
20173447,11,2,35,48,21,117,不合格
20173448,65,65,7,79,50,266,不合格
20173449,86,12,39,67,25,229,不合格
20173450,54,23,7,17,74,175,不合格
20173451,16,94,27,43,80,260,不合格
20173452,16,77,96,45,45,279,不合格
20173453,28,54,62,30,43,217,不合格
20173454,99,61,91,60,62,373,合格
20173455,32,98,32,74,28,264,不合格
20173456,44,80,74,17,61,276,不合格
20173457,89,46,64,53,19,271,不合格
20173458,13,63,44,75,68,263,不合格
20173459,82,18,61,79,80,320,合格
20173460,88,81,19,30,2,220,不合格
20173461,88,11,87,24,36,246,不合格
20173462,15,88,42,51,97,293,不合格
20173463,19,17,97,48,68,249,不合格
20173464,93,44,56,91,16,300,合格
20173465,64,46,31,38,98,277,不合格
20173466,15,82,14,97,59,267,不合格
20173467,68,47,31,77,68,291,不合格
20173468,5,67,76,68,73,289,不合格
20173469,54,64,84,96,2,300,合格
20173470,49,49,83,53,86,320,合格
20173471,4,60,58,81,69,272,不合格
20173472,71,13,78,63,63,288,不合格
20173473,90,97,64,81,18,350,合格
20173474,48,72,24,83,72,299,不合格
20173475,16,17,39,32,74,178,不合格
20173476,73,72,66,20,15,246,不合格
20173477,31,50,6,94,26,207,不合格
20173478,67,14,33,41,90,245,不合格
20173479,1,10,94,72,39,216,不合格
20173480,92,17,61,43,85,298,不合格
20173481,66,54,61,94,33,308,合格
20173482,30,21,82,95,32,260,不合格
20173483,17,72,3,63,14,169,不合格
20173484,3,75,12,40,61,191,不合格
20173485,50,84,15,22,77,248,不合格
20173486,80,28,59,89,62,318,合格
20173487,79,6,78,31,23,217,不合格
20173488,86,58,14,26,84,268,不合格
20173489,79,95,2,35,8,219,不合格
20173490,82,19,13,40,15,169,不合格
20173491,79,76,2,64,59,280,不合格
20173492,90,27,77,65,30,289,不合格
20173493,98,13,89,79,52,331,合格
20173494,86,42,53,42,6,229,不合格
20173495,35,85,57,95,56,328,合格
20173496,21,95,46,10,0,172,不合格
20173497,89,31,1,38,93,252,不合格
20173498,66,18,41,53,88,266,不合格
20173499,54,53,76,10,70,263,不合格
20173500,84,9,89,24,36,242,不合格
20173501,63,46,43,25,27,204,不合格
20173502,17,36,83,5,53,194,不合格
20173503,68,79,24,36,0,207,不合格
20173504,76,9,89,96,94,364,合格
20173505,57,29,2,19,34,141,不合格
20173506,92,71,52,80,72,367,合格
20173507,86,65,59,43,46,299,不合格
20173508,32,28,15,4,91,170,不合格
20173509,16,31,19,82,36,184,不合格
20173510,40,60,20,26,65,211,不合格
20173511,81,68,9,29,89,276,不合格
20173512,36,67,83,44,54,284,不合格
20173513,11,9,74,15,11,120,不合格
20173514,97,19,80,55,95,346,合格
20173515,19,98,99,22,74,312,合格
20173516,4,12,97,43,59,215,不合格
20173517,48,59,46,56,98,307,合格
20173518,16,14,87,16,34,167,不合格
20173519,35,25,79,35,28,202,不合格
20173520,1,47,89,70,13,220,不合格
20173521,51,49,3,97,20,220,不合格
20173522,17,75,54,26,80,252,不合格
20173523,56,52,45,51,75,279,不合格
20173524,30,51,50,21,72,224,不合格
20173525,8,46,4,53,22,133,不合格
20173526,46,89,33,98,56,322,合格
20173527,65,43,89,9,75,281,不合格
20173528,41,79,67,22,97,306,合格
20173529,59,21,8,90,35,213,不合格
20173530,89,53,66,77,16,301,合格
20173531,66,92,80,47,23,308,合格
20173532,51,2,51,9,79,192,不合格
20173533,98,33,47,89,93,360,合格
20173534,39,19,48,94,2,202,不合格
20173535,25,43,91,4,94,257,不合格
20173536,51,85,27,34,87,284,不合格
20173537,43,59,79,38,4,223,不合格
20173538,40,50,98,0,14,202,不合格
20173539,16,63,92,83,59,313,合格
20173540,9,85,95,2,10,201,不合格
20173541,50,68,49,10,48,225,不合格
20173542,62,98,92,68,77,397,合格
20173543,88,75,28,29,85,305,合格
20173544,73,76,41,92,89,371,合格
20173545,93,30,29,1,12,165,不合格
20173546,43,3,17,50,48,161,不合格
20173547,83,52,24,55,0,214,不合格
20173548,13,27,14,50,63,167,不合格
20173549,91,84,38,94,89,396,合格
20173550,55,51,69,75,56,306,合格
20173551,0,86,49,64,14,213,不合格
20173552,81,86,36,75,46,324,合格
20173553,60,88,96,28,39,311,合格
20173554,32,66,32,80,37,247,不合格
20173555,44,0,63,16,94,217,不合格
20173556,85,7,84,17,8,201,不合格
20173557,51,28,6,31,59,175,不合格
20173558,38,15,86,43,85,267,不合格
20173559,79,41,93,48,79,340,合格
20173560,57,32,14,70,60,233,不合格
20173561,43,91,76,18,31,259,不合格
20173562,78,28,54,88,73,321,合格
20173563,94,26,90,18,91,319,合格
20173564,63,23,81,35,4,206,不合格
20173565,45,87,14,18,89,253,不合格
20173566,8,1,42,70,35,156,不合格
20173567,13,16,51,5,12,97,不合格
20173568,20,6,71,0,15,112,不合格
20173569,64,94,73,57,97,385,合格
20173570,69,32,35,92,53,281,不合格
20173571,44,46,42,89,41,262,不合格
20173572,20,46,84,3,9,162,不合格
20173573,71,86,99,27,36,319,合格
20173574,68,1,64,19,10,162,不合格
20173575,88,10,61,66,12,237,不合格
20173576,97,78,95,37,75,382,合格
20173577,43,51,99,28,24,245,不合格
20173578,65,27,72,41,94,299,不合格
20173579,29,70,55,20,36,210,不合格
20173580,13,89,62,54,82,300,合格
20173581,96,49,40,97,60,342,合格
20173582,1,30,96,28,75,230,不合格
20173583,30,23,65,72,67,257,不合格
20173584,71,95,39,68,88,361,合格
20173585,22,17,30,44,63,176,不合格
20173586,13,33,25,79,64,214,不合格
20173587,90,9,75,80,69,323,合格
20173588,62,6,16,73,78,235,不合格
20173589,57,81,53,98,23,312,合格
20173590,17,37,9,3,15,81,不合格
20173591,46,25,32,81,43,227,不合格
20173592,17,75,51,26,66,235,不合格
20173593,79,61,70,17,75,302,合格
20173594,14,27,16,64,6,127,不合格
20173595,62,26,38,54,6,186,不合格
20173596,10,83,45,92,42,272,不合格
20173597,55,76,0,82,47,260,不合格
20173598,31,80,80,66,58,315,合格
20173599,2,17,41,35,80,175,不合格
20173600,27,11,52,73,34,197,不合格
20173601,27,32,1,52,78,190,不合格
20173602,85,52,13,70,70,290,不合格
20173603,62,85,70,37,95,349,合格
20173604,24,73,96,15,6,214,不合格
20173605,11,96,86,51,0,244,不合格
20173606,81,26,26,80,10,223,不合格
20173607,16,18,89,39,80,242,不合格
20173608,72,59,31,62,37,261,不合格
20173609,66,84,0,20,84,254,不合格
20173610,40,89,87,20,96,332,合格
20173611,95,62,33,55,34,279,不合格
20173612,19,14,30,4,40,107,不合格
20173613,0,3,6,4,26,39,不合格
20173614,91,71,35,52,35,284,不合格
20173615,56,7,44,10,34,151,不合格
20173616,56,98,61,82,51,348,合格
20173617,83,39,77,95,12,306,合格
20173618,66,75,46,67,44,298,不合格
20173619,89,55,55,89,74,362,合格
20173620,63,81,48,40,36,268,不合格
20173621,82,52,13,54,59,260,不合格
20173622,21,96,76,23,59,275,不合格
20173623,42,55,66,75,43,281,不合格
20173624,94,99,89,22,77,381,合格
20173625,99,23,26,34,93,275,不合格
20173626,36,21,12,39,84,192,不合格
20173627,6,7,11,95,37,156,不合格
20173628,39,52,29,29,42,191,不合格
20173629,9,12,41,17,43,122,不合格
20173630,74,26,72,25,0,197,不合格
20173631,59,49,39,66,40,253,不合格
20173632,24,86,33,55,50,248,不合格
20173633,75,38,13,47,65,238,不合格
20173634,44,40,87,48,30,249,不合格
20173635,72,81,46,2,28,229,不合格
20173636,6,84,39,87,16,232,不合格
20173637,64,42,58,43,12,219,不合格
20173638,38,64,30,74,12,218,不合格
20173639,13,64,77,61,79,294,不合格
20173640,91,4,39,93,26,253,不合格
20173641,42,78,14,64,68,266,不合格
20173642,26,49,84,90,68,317,合格
20173643,16,49,92,96,75,328,合格
20173644,81,63,41,32,52,269,不合格
20173645,38,1,63,54,33,189,不合格
20173646,64,27,11,93,77,272,不合格
20173647,99,77,98,91,53,418,合格
20173648,24,91,22,87,72,296,不合格
20173649,51,36,44,63,46,240,不合格
20173650,75,20,16,50,56,217,不合格
20173651,36,74,85,43,67,305,合格
20173652,72,82,65,59,7,285,不合格
20173653,19,75,62,1,18,175,不合格
20173654,65,44,89,37,47,282,不合格
20173655,96,15,71,45,83,310,合格
20173656,22,83,59,31,49,244,不合格
20173657,31,29,38,72,60,230,不合格
20173658,27,38,61,47,52,225,不合格
20173659,88,47,67,16,48,266,不合格
20173660,30,62,40,31,23,186,不合格
20173661,63,77,53,12,90,295,不合格
20173662,96,56,53,90,87,382,合格
20173663,32,17,78,18,81,226,不合格
20173664,41,3,4,19,1,68,不合格
20173665,83,0,72,89,55,299,不合格
20173666,5,4,60,50,47,166,不合格
20173667,80,25,7,78,40,230,不合格
20173668,47,30,91,54,82,304,合格
20173669,15,27,83,97,94,316,合格
20173670,17,67,42,18,22,166,不合格
20173671,42,7,78,42,16,185,不合格
20173672,16,36,14,93,76,235,不合格
20173673,0,26,45,53,56,180,不合格
20173674,59,10,58,87,33,247,不合格
20173675,63,17,41,29,62,212,不合格
20173676,46,23,90,75,94,328,合格
20173677,65,15,70,3,65,218,不合格
20173678,37,14,71,57,44,223,不合格
20173679,59,0,2,33,9,103,不合格
20173680,33,89,32,23,96,273,不合格
20173681,75,29,37,26,20,187,不合格
20173682,27,45,50,5,12,139,不合格
20173683,98,10,41,25,58,232,不合格
20173684,74,96,81,77,23,351,合格
20173685,72,7,8,30,19,136,不合格
20173686,59,30,22,31,25,167,不合格
20173687,48,15,72,54,25,214,不合格
20173688,99,11,91,24,18,243,不合格
20173689,49,52,66,63,29,259,不合格
20173690,98,59,91,34,95,377,合格
20173691,3,97,17,20,89,226,不合格
20173692,0,22,64,79,89,254,不合格
20173693,98,92,30,20,96,336,合格
20173694,49,61,40,17,3,170,不合格
20173695,67,55,53,85,27,287,不合格
20173696,6,70,27,98,98,299,不合格
20173697,63,78,41,68,79,329,合格
20173698,67,38,3,63,24,195,不合格
20173699,59,52,40,62,78,291,不合格
20173700,29,33,39,15,95,211,不合格
20173701,78,33,64,74,96,345,合格
20173702,56,70,95,80,94,395,合格
20173703,59,95,94,40,34,322,合格
20173704,8,1,23,77,60,169,不合格
20173705,76,18,71,29,38,232,不合格
20173706,38,67,44,17,3,169,不合格
20173707,74,56,37,27,58,252,不合格
20173708,62,82,58,66,76,344,合格
20173709,42,65,56,96,64,323,合格
20173710,40,28,70,10,22,170,不合格
20173711,64,30,40,25,98,257,不合格
20173712,17,96,31,43,35,222,不合格
20173713,85,23,76,17,74,275,不合格
20173714,41,44,89,41,30,245,不合格
20173715,3,6,10,22,26,67,不合格
20173716,66,72,52,1,41,232,不合格
20173717,15,13,71,17,45,161,不合格
20173718,47,99,93,81,16,336,合格
20173719,64,17,60,72,70,283,不合格
20173720,31,92,58,47,70,298,不合格
20173721,1,65,80,76,89,311,合格
20173722,1,92,76,66,43,278,不合格
20173723,29,52,88,19,63,251,不合格
20173724,12,70,12,36,95,225,不合格
20173725,53,28,25,38,95,239,不合格
20173726,69,77,82,81,34,343,合格
20173727,64,24,96,1,10,195,不合格
20173728,87,83,22,26,72,290,不合格
20173729,14,2,19,26,47,108,不合格
20173730,58,6,45,77,1,187,不合格
20173731,89,39,18,54,92,292,不合格
20173732,54,41,49,62,97,303,合格
20173733,1,39,53,46,39,178,不合格
20173734,88,1,95,40,48,272,不合格
20173735,15,6,92,39,42,194,不合格
20173736,92,45,17,76,60,290,不合格
20173737,98,65,59,57,39,318,合格
20173738,52,84,18,4,75,233,不合格
20173739,99,30,98,36,34,297,不合格
20173740,60,35,36,14,78,223,不合格
20173741,3,14,37,14,35,103,不合格
20173742,52,21,91,72,28,264,不合格
20173743,28,5,61,53,69,216,不合格
20173744,62,22,63,96,72,315,合格
20173745,80,33,51,4,37,205,不合格
20173746,57,68,57,99,89,370,合格
20173747,23,21,59,81,16,200,不合格
20173748,89,48,58,35,4,234,不合格
20173749,70,11,88,20,23,212,不合格
20173750,54,47,84,56,57,298,不合格
20173751,81,3,99,66,21,270,不合格
20173752,93,94,97,82,77,443,合格
20173753,78,25,46,10,87,246,不合格
20173754,34,76,89,98,96,393,合格
20173755,39,7,66,49,63,224,不合格
20173756,18,1,78,83,52,232,不合格
20173757,31,71,30,80,7,219,不合格
20173758,67,39,87,36,61,290,不合格
20173759,72,10,65,32,12,191,不合格
20173760,28,84,8,99,41,260,不合格
20173761,44,30,38,20,74,206,不合格
20173762,18,48,71,79,17,233,不合格
20173763,49,20,73,86,14,242,不合格
20173764,35,29,29,78,73,244,不合格
20173765,94,92,34,98,63,381,合格
20173766,90,33,14,22,60,219,不合格
20173767,33,14,18,1,27,93,不合格
20173768,14,57,53,73,28,225,不合格
20173769,88,6,31,35,16,176,不合格
20173770,1,19,81,50,50,201,不合格
20173771,42,53,77,55,12,239,不合格
20173772,75,71,65,75,98,384,合格
20173773,70,73,62,0,40,245,不合格
20173774,17,56,96,76,75,320,合格
20173775,86,19,66,71,23,265,不合格
20173776,76,81,60,49,37,303,合格
20173777,19,65,76,22,3,185,不合格
20173778,40,61,7,73,52,233,不合格
20173779,73,70,16,49,49,257,不合格
20173780,35,38,79,54,69,275,不合格
20173781,98,69,69,37,96,369,合格
20173782,22,51,67,15,0,155,不合格
20173783,39,5,32,97,96,269,不合格
20173784,16,53,80,88,74,311,合格
20173785,47,39,58,75,29,248,不合格
20173786,44,73,40,22,81,260,不合格
20173787,5,45,54,77,9,190,不合格
20173788,67,99,63,57,70,356,合格
20173789,28,98,17,97,58,298,不合格
20173790,48,22,49,3,60,182,不合格
20173791,43,53,99,13,15,223,不合格
20173792,45,92,78,34,6,255,不合格
20173793,61,30,27,53,73,244,不合格
20173794,25,25,14,42,63,169,不合格
20173795,60,57,24,67,41,249,不合格
20173796,22,34,47,20,21,144,不合格
20173797,30,10,57,10,91,198,不合格
20173798,26,76,61,3,22,188,不合格
20173799,34,19,59,17,23,152,不合格
20173800,25,5,97,70,26,223,不合格
20173801,80,20,88,85,52,325,合格
20173802,60,65,40,24,49,238,不合格
20173803,39,24,66,23,91,243,不合格
20173804,93,32,33,86,95,339,合格
20173805,34,74,23,87,37,255,不合格
20173806,14,45,43,61,78,241,不合格
20173807,5,15,55,66,6,147,不合格
20173808,61,84,38,5,2,190,不合格
20173809,93,74,79,59,18,323,合格
20173810,85,4,26,90,93,298,不合格
20173811,76,0,46,55,83,260,不合格
20173812,83,67,77,2,33,262,不合格
20173813,27,23,68,37,26,181,不合格
20173814,54,31,35,93,2,215,不合格
20173815,21,5,5,25,36,92,不合格
20173816,47,96,39,42,17,241,不合格
20173817,94,56,99,0,23,272,不合格
20173818,59,68,92,23,60,302,合格
20173819,44,1,14,21,96,176,不合格
20173820,46,49,8,2,57,162,不合格
20173821,1,69,29,36,60,195,不合格
20173822,38,93,65,69,59,324,合格
20173823,44,18,8,43,11,124,不合格
20173824,9,88,76,53,19,245,不合格
20173825,78,81,41,99,16,315,合格
20173826,60,62,27,87,61,297,不合格
20173827,35,83,62,19,22,221,不合格
20173828,56,64,19,81,11,231,不合格
20173829,63,80,93,63,48,347,合格
20173830,88,89,12,19,12,220,不合格
20173831,24,73,57,66,66,286,不合格
20173832,86,53,39,82,95,355,合格
20173833,23,78,74,85,39,299,不合格
20173834,30,19,37,80,0,166,不合格
20173835,26,97,71,49,49,292,不合格
20173836,14,3,75,52,57,201,不合格
20173837,93,52,0,24,46,215,不合格
20173838,24,94,47,35,7,207,不合格
20173839,55,13,61,95,64,288,不合格
20173840,60,20,51,41,46,218,不合格
20173841,47,35,65,45,87,279,不合格
20173842,0,76,16,96,7,195,不合格
20173843,82,83,45,26,44,280,不合格
20173844,99,97,28,90,98,412,合格
20173845,18,5,77,93,18,211,不合格
20173846,7,82,43,94,49,275,不合格
20173847,44,6,76,90,82,298,不合格
20173848,16,95,87,32,73,303,合格
20173849,71,19,63,62,29,244,不合格
20173850,74,81,89,46,13,303,合格
20173851,99,13,63,14,14,203,不合格
20173852,52,38,40,0,15,145,不合格
20173853,97,47,47,0,86,277,不合格
20173854,13,43,55,83,44,238,不合格
20173855,83,58,84,18,76,319,合格
20173856,62,10,92,27,84,275,不合格
20173857,20,64,49,76,86,295,不合格
20173858,28,42,61,15,8,154,不合格
20173859,50,73,38,41,46,248,不合格
20173860,85,63,72,28,51,299,不合格
20173861,0,48,14,32,21,115,不合格
20173862,81,54,91,64,93,383,合格
20173863,32,88,47,65,33,265,不合格
20173864,81,39,82,7,26,235,不合格
20173865,61,88,75,7,61,292,不合格
20173866,81,27,98,68,22,296,不合格
20173867,53,90,67,42,88,340,合格
20173868,37,42,60,29,91,259,不合格
20173869,21,75,2,64,74,236,不合格
20173870,27,64,41,56,37,225,不合格
20173871,42,19,35,81,22,199,不合格
20173872,8,52,66,48,69,243,不合格
20173873,73,0,96,18,42,229,不合格
20173874,21,87,33,35,16,192,不合格
20173875,31,16,54,93,16,210,不合格
20173876,54,59,85,2,79,279,不合格
20173877,36,88,29,41,91,285,不合格
20173878,3,31,35,4,43,116,不合格
20173879,91,76,76,67,9,319,合格
20173880,18,51,22,45,89,225,不合格
20173881,97,37,32,61,83,310,合格
20173882,17,70,27,60,86,260,不合格
20173883,54,54,65,65,98,336,合格
20173884,30,44,67,15,93,249,不合格
20173885,43,71,37,77,95,323,合格
20173886,0,62,1,50,15,128,不合格
20173887,2,64,0,27,63,156,不合格
20173888,68,49,51,83,77,328,合格
20173889,98,44,76,86,66,370,合格
20173890,44,18,38,82,36,218,不合格
20173891,48,63,42,74,6,233,不合格
20173892,48,51,12,6,51,168,不合格
20173893,53,70,87,65,6,281,不合格
20173894,25,94,19,70,5,213,不合格
20173895,84,42,7,30,4,167,不合格
20173896,91,65,72,77,95,400,合格
20173897,14,47,29,11,22,123,不合格
20173898,94,6,58,34,55,247,不合格
20173899,76,50,94,34,46,300,合格
20173900,58,95,99,35,37,324,合格
20173901,73,63,13,39,96,284,不合格
20173902,71,12,84,12,29,208,不合格
20173903,70,22,42,93,74,301,合格
20173904,73,66,37,27,83,286,不合格
20173905,21,75,87,62,47,292,不合格
20173906,98,80,6,48,74,306,合格
20173907,19,53,88,77,31,268,不合格
20173908,8,3,56,41,72,180,不合格
20173909,41,93,7,90,8,239,不合格
20173910,73,42,30,63,41,249,不合格
20173911,69,68,49,35,84,305,合格
20173912,93,49,64,8,48,262,不合格
20173913,37,90,87,66,98,378,合格
20173914,83,56,76,70,72,357,合格
20173915,44,43,12,15,52,166,不合格
20173916,97,3,55,3,89,247,不合格
20173917,61,83,42,38,43,267,不合格
20173918,44,75,69,34,96,318,合格
20173919,9,9,7,70,85,180,不合格
20173920,25,7,4,87,91,214,不合格
20173921,90,79,4,55,20,248,不合格
20173922,59,79,65,81,19,303,合格
20173923,10,7,60,98,45,220,不合格
20173924,63,51,85,80,44,323,合格
20173925,83,97,35,8,90,313,合格
20173926,82,92,83,68,52,377,合格
20173927,73,4,39,94,71,281,不合格
20173928,11,4,88,44,87,234,不合格
20173929,72,6,87,54,28,247,不合格
20173930,58,28,79,51,97,313,合格
20173931,75,31,9,77,60,252,不合格
20173932,57,37,23,95,26,238,不合格
20173933,80,36,63,80,14,273,不合格
20173934,63,84,61,43,95,346,合格
20173935,13,15,57,28,71,184,不合格
20173936,63,12,28,52,90,245,不合格
20173937,92,11,96,5,86,290,不合格
20173938,98,48,20,45,99,310,合格
20173939,25,31,34,21,19,130,不合格
20173940,59,48,11,43,77,238,不合格
20173941,68,76,88,2,85,319,合格
20173942,60,90,96,54,36,336,合格
20173943,65,20,93,2,5,185,不合格
20173944,42,6,32,82,20,182,不合格
20173945,58,24,14,15,94,205,不合格
20173946,75,97,84,71,34,361,合格
20173947,84,12,87,35,19,237,不合格
20173948,4,87,77,47,60,275,不合格
20173949,98,89,60,38,32,317,合格
20173950,35,25,51,36,24,171,不合格
20173951,81,5,11,15,16,128,不合格
20173952,71,86,69,74,91,391,合格
20173953,74,60,77,35,52,298,不合格
20173954,56,88,36,7,37,224,不合格
20173955,68,35,16,37,53,209,不合格
20173956,67,99,33,18,75,292,不合格
20173957,68,98,57,46,50,319,合格
20173958,68,84,90,71,7,320,合格
20173959,77,77,37,45,3,239,不合格
20173960,10,15,90,50,47,212,不合格
20173961,50,17,2,0,59,128,不合格
20173962,38,65,30,41,10,184,不合格
20173963,52,84,37,86,76,335,合格
20173964,3,57,94,37,35,226,不合格
20173965,37,48,21,71,52,229,不合格
20173966,20,50,81,36,85,272,不合格
20173967,52,65,51,24,82,274,不合格
20173968,34,16,17,86,69,222,不合格
20173969,85,5,60,86,97,333,合格
20173970,77,39,32,12,42,202,不合格
20173971,59,8,8,41,88,204,不合格
20173972,5,10,8,43,36,102,不合格
20173973,80,93,78,38,38,327,合格
20173974,41,75,64,77,52,309,合格
20173975,26,38,69,27,74,234,不合格
20173976,39,43,9,5,2,98,不合格
20173977,10,43,86,17,74,230,不合格
20173978,39,30,86,47,84,286,不合格
20173979,20,45,17,20,18,120,不合格
20173980,52,35,45,21,54,207,不合格
20173981,45,17,9,19,40,130,不合格
20173982,51,2,26,20,83,182,不合格
20173983,97,46,98,76,11,328,合格
20173984,11,99,54,25,3,192,不合格
20173985,59,86,32,85,48,310,合格
20173986,56,30,85,66,47,284,不合格
20173987,83,36,94,80,87,380,合格
20173988,54,81,48,87,19,289,不合格
20173989,79,98,31,18,44,270,不合格
20173990,23,86,71,36,75,291,不合格
20173991,63,94,94,29,24,304,合格
20173992,29,85,56,55,80,305,合格
20173993,56,66,9,2,48,181,不合格
20173994,92,90,32,49,42,305,合格
20173995,8,59,0,49,35,151,不合格
20173996,5,88,66,85,14,258,不合格
20173997,46,35,1,27,0,109,不合格
20173998,41,53,40,23,35,192,不合格
20173999,24,67,78,61,66,296,不合格
20174000,4,81,96,62,42,285,不合格
20174001,55,24,27,34,4,144,不合格
20174002,24,62,55,35,71,247,不合格
20174003,63,83,32,75,11,264,不合格
20174004,4,22,2,18,73,119,不合格
20174005,74,88,6,19,27,214,不合格
20174006,94,46,94,71,28,333,合格
20174007,47,72,49,13,66,247,不合格
20174008,83,73,69,63,82,370,合格
20174009,48,69,92,30,48,287,不合格
20174010,61,73,43,98,64,339,合格
20174011,63,93,36,53,85,330,合格
20174012,35,29,20,66,34,184,不合格
20174013,90,52,76,46,42,306,合格
20174014,92,66,79,58,10,305,合格
20174015,49,61,58,22,90,280,不合格
20174016,17,45,59,64,38,223,不合格
20174017,73,31,54,48,73,279,不合格
20174018,92,24,52,22,22,212,不合格
20174019,92,65,42,63,73,335,合格
20174020,9,91,75,6,54,235,不合格
20174021,64,25,41,65,71,266,不合格
20174022,84,37,77,42,68,308,合格
20174023,44,70,96,13,24,247,不合格
20174024,39,33,72,8,30,182,不合格
20174025,16,59,79,30,64,248,不合格
20174026,67,42,43,30,24,206,不合格
20174027,77,14,34,41,72,238,不合格
20174028,0,82,86,9,47,224,不合格
20174029,73,6,74,24,68,245,不合格
20174030,61,97,91,66,99,414,合格
20174031,28,87,14,89,48,266,不合格
20174032,60,79,21,85,4,249,不合格
20174033,44,29,2,95,98,268,不合格
20174034,88,55,18,16,72,249,不合格
20174035,43,55,15,22,35,170,不合格
20174036,49,51,98,80,34,312,合格
20174037,10,78,33,42,79,242,不合格
20174038,57,66,65,41,57,286,不合格
20174039,96,36,34,44,95,305,合格
20174040,96,85,54,95,39,369,合格
20174041,3,6,2,93,65,169,不合格
20174042,31,80,8,63,65,247,不合格
20174043,92,91,16,50,97,346,合格
20174044,14,81,63,21,55,234,不合格
20174045,18,45,45,58,31,197,不合格
20174046,2,30,79,32,43,186,不合格
20174047,98,39,24,31,18,210,不合格
20174048,12,19,64,21,79,195,不合格
20174049,64,64,31,75,94,328,合格
20174050,42,22,37,4,31,136,不合格
20174051,29,64,38,7,39,177,不合格
20174052,36,11,46,36,35,164,不合格
20174053,50,76,88,13,10,237,不合格
20174054,93,95,72,83,99,442,合格
20174055,43,72,8,15,85,223,不合格
20174056,93,61,91,75,75,395,合格
20174057,12,48,17,77,68,222,不合格
20174058,41,88,64,43,31,267,不合格
20174059,32,42,56,81,0,211,不合格
20174060,62,31,87,59,23,262,不合格
20174061,43,94,58,94,99,388,合格
20174062,43,61,68,55,65,292,不合格
20174063,51,13,18,61,79,222,不合格
20174064,81,52,48,77,70,328,合格
20174065,85,67,6,82,32,272,不合格
20174066,5,51,10,33,12,111,不合格
20174067,10,79,89,99,38,315,合格
20174068,29,68,89,39,26,251,不合格
20174069,63,63,74,55,32,287,不合格
20174070,6,2,2,45,84,139,不合格
20174071,44,79,72,39,66,300,合格
20174072,1,34,60,67,24,186,不合格
20174073,3,93,42,37,21,196,不合格
20174074,37,87,1,16,22,163,不合格
20174075,46,57,91,43,81,318,合格
20174076,88,56,82,26,73,325,合格
20174077,65,46,84,51,21,267,不合格
20174078,43,52,76,55,33,259,不合格
20174079,46,61,10,38,70,225,不合格
20174080,94,30,1,86,41,252,不合格
20174081,3,7,54,71,81,216,不合格
20174082,7,1,95,52,43,198,不合格
20174083,77,78,98,65,99,417,合格
20174084,99,68,81,54,96,398,合格
20174085,76,98,22,96,36,328,合格
20174086,77,59,3,19,89,247,不合格
20174087,86,36,66,17,68,273,不合格
20174088,94,99,21,40,47,301,合格
20174089,31,3,59,55,29,177,不合格
20174090,70,0,16,42,87,215,不合格
20174091,90,2,3,40,36,171,不合格
20174092,97,43,90,58,2,290,不合格
20174093,67,31,78,57,53,286,不合格
20174094,43,79,72,19,14,227,不合格
20174095,40,44,89,42,63,278,不合格
20174096,82,15,39,21,33,190,不合格
20174097,92,16,33,51,16,208,不合格
20174098,27,32,75,38,78,250,不合格
20174099,96,77,84,7,37,301,合格
20174100,55,47,68,84,68,322,合格
20174101,71,3,75,30,46,225,不合格
20174102,40,88,39,14,47,228,不合格
20174103,75,33,69,74,89,340,合格
20174104,27,4,12,61,81,185,不合格
20174105,59,72,52,2,28,213,不合格
20174106,67,69,45,96,35,312,合格
20174107,0,82,77,80,98,337,合格
20174108,3,33,22,11,56,125,不合格
20174109,23,0,3,45,52,123,不合格
20174110,54,59,17,18,24,172,不合格
20174111,37,27,6,33,45,148,不合格
20174112,49,76,22,81,89,317,合格
20174113,82,46,49,88,40,305,合格
20174114,56,65,93,57,2,273,不合格
20174115,8,95,50,49,99,301,合格
20174116,5,65,49,29,85,233,不合格
20174117,91,27,38,64,43,263,不合格
20174118,71,80,32,59,7,249,不合格
20174119,27,70,18,81,89,285,不合格
20174120,9,69,22,97,55,252,不合格
20174121,44,2,11,54,84,195,不合格
20174122,8,46,99,50,83,286,不合格
20174123,61,17,2,7,7,94,不合格
20174124,90,54,35,42,2,223,不合格
20174125,97,96,14,58,40,305,合格
20174126,45,50,41,25,4,165,不合格
20174127,40,1,85,54,75,255,不合格
20174128,92,18,25,86,75,296,不合格
20174129,81,75,38,86,10,290,不合格
20174130,91,55,96,9,6,257,不合格
20174131,33,92,37,86,10,258,不合格
20174132,18,21,9,80,96,224,不合格
20174133,48,36,9,31,16,140,不合格
20174134,3,55,51,19,58,186,不合格
20174135,26,69,13,11,77,196,不合格
20174136,85,34,29,50,49,247,不合格
20174137,65,95,45,98,12,315,合格
20174138,10,2,3,6,35,56,不合格
20174139,4,10,56,51,99,220,不合格
20174140,83,59,60,85,63,350,合格
20174141,55,20,0,88,40,203,不合格
20174142,2,74,45,27,39,187,不合格
20174143,28,21,79,52,95,275,不合格
20174144,26,70,58,58,30,242,不合格
20174145,60,53,63,31,75,282,不合格
20174146,31,0,25,93,1,150,不合格
20174147,0,39,46,78,44,207,不合格
20174148,91,43,0,63,57,254,不合格
20174149,32,85,26,23,71,237,不合格
20174150,84,60,24,24,56,248,不合格
20174151,63,38,4,46,90,241,不合格
20174152,42,40,50,79,27,238,不合格
20174153,68,34,53,56,9,220,不合格
20174154,49,18,14,41,78,200,不合格
20174155,76,23,93,53,64,309,合格
20174156,46,56,14,12,45,173,不合格
20174157,39,73,55,15,31,213,不合格
20174158,43,6,87,23,75,234,不合格
20174159,38,77,26,74,24,239,不合格
20174160,78,41,14,51,36,220,不合格
20174161,97,47,33,13,72,262,不合格
20174162,90,34,75,96,46,341,合格
20174163,98,63,42,8,45,256,不合格
20174164,46,82,76,59,73,336,合格
20174165,35,40,87,97,19,278,不合格
20174166,3,35,45,73,9,165,不合格
20174167,49,48,43,77,52,269,不合格
20174168,88,26,48,35,29,226,不合格
20174169,67,95,47,87,45,341,合格
20174170,60,45,81,53,27,266,不合格
20174171,93,34,39,23,37,226,不合格
20174172,7,11,98,85,27,228,不合格
20174173,60,64,54,94,71,343,合格
20174174,18,57,79,46,13,213,不合格
20174175,95,5,36,53,45,234,不合格
20174176,22,75,98,84,54,333,合格
20174177,30,81,51,27,36,225,不合格
20174178,59,15,19,95,79,267,不合格
20174179,47,36,65,22,67,237,不合格
20174180,77,22,88,1,70,258,不合格
20174181,7,14,70,6,0,97,不合格
20174182,10,16,91,83,22,222,不合格
20174183,75,75,49,59,23,281,不合格
20174184,69,29,80,11,73,262,不合格
20174185,51,58,69,79,34,291,不合格
20174186,11,33,48,72,69,233,不合格
20174187,43,66,90,13,11,223,不合格
20174188,7,49,8,85,55,204,不合格
20174189,22,57,34,82,77,272,不合格
20174190,41,53,30,55,8,187,不合格
20174191,30,54,20,32,32,168,不合格
20174192,3,30,90,54,86,263,不合格
20174193,91,60,40,40,72,303,合格
20174194,42,3,88,31,80,244,不合格
20174195,70,95,40,22,39,266,不合格
20174196,68,32,51,66,29,246,不合格
20174197,96,10,88,33,9,236,不合格
20174198,22,94,52,35,67,270,不合格
20174199,52,22,65,46,40,225,不合格
20174200,39,54,91,99,50,333,合格
20174201,67,49,26,36,96,274,不合格
20174202,41,79,40,4,64,228,不合格
20174203,53,48,99,11,57,268,不合格
20174204,61,47,93,39,44,284,不合格
20174205,28,89,43,74,87,321,合格
20174206,97,67,99,16,86,365,合格
20174207,9,8,13,13,46,89,不合格
20174208,58,70,38,67,31,264,不合格
20174209,22,54,65,23,46,210,不合格
20174210,82,1,92,84,90,349,合格
20174211,27,65,63,84,42,281,不合格
20174212,89,80,43,81,17,310,合格
20174213,76,69,52,87,5,289,不合格
20174214,18,66,30,12,41,167,不合格
20174215,31,84,27,74,92,308,合格
20174216,48,14,92,12,10,176,不合格
20174217,92,84,45,42,56,319,合格
20174218,37,94,36,7,49,223,不合格
20174219,29,74,88,2,27,220,不合格
20174220,29,56,98,74,11,268,不合格
20174221,41,87,87,39,82,336,合格
20174222,76,84,40,54,25,279,不合格
20174223,71,0,84,76,95,326,合格
20174224,85,28,46,97,56,312,合格
20174225,68,43,22,31,44,208,不合格
20174226,42,51,43,43,45,224,不合格
20174227,19,33,15,88,35,190,不合格
20174228,31,17,19,46,60,173,不合格
20174229,19,79,91,6,90,285,不合格
20174230,11,41,86,4,85,227,不合格
20174231,54,80,85,8,95,322,合格
20174232,78,11,11,63,29,192,不合格
20174233,88,31,73,7,35,234,不合格
20174234,87,88,38,43,17,273,不合格
20174235,97,94,84,61,5,341,合格
20174236,64,44,49,49,50,256,不合格
20174237,40,23,50,4,76,193,不合格
20174238,53,61,20,12,21,167,不合格
20174239,3,75,91,46,26,241,不合格
20174240,87,41,63,77,32,300,合格
20174241,91,22,72,19,40,244,不合格
20174242,67,2,44,20,34,167,不合格
20174243,48,19,18,48,19,152,不合格
20174244,80,13,96,44,42,275,不合格
20174245,47,12,71,76,43,249,不合格
20174246,35,82,84,96,32,329,合格
20174247,41,88,3,84,77,293,不合格
20174248,2,59,87,40,3,191,不合格
20174249,89,94,34,52,12,281,不合格
20174250,93,86,55,96,2,332,合格
20174251,8,32,32,91,60,223,不合格
20174252,72,61,21,70,65,289,不合格
20174253,50,44,53,78,73,298,不合格
20174254,81,79,28,59,58,305,合格
20174255,48,67,7,4,91,217,不合格
20174256,20,72,32,84,16,224,不合格
20174257,53,53,51,91,19,267,不合格
20174258,68,78,86,72,27,331,合格
20174259,38,55,95,48,55,291,不合格
20174260,87,52,56,43,67,305,合格
20174261,40,13,80,1,54,188,不合格
20174262,86,30,20,42,66,244,不合格
20174263,85,9,4,12,50,160,不合格
20174264,95,93,79,22,23,312,合格
20174265,42,54,87,79,42,304,合格
20174266,34,36,46,38,47,201,不合格
20174267,8,15,56,54,85,218,不合格
20174268,32,72,86,79,56,325,合格
20174269,43,1,14,21,52,131,不合格
20174270,18,29,71,56,14,188,不合格
20174271,67,36,31,45,38,217,不合格
20174272,22,88,54,39,2,205,不合格
20174273,40,78,26,51,4,199,不合格
20174274,36,86,97,3,15,237,不合格
20174275,65,50,29,98,1,243,不合格
20174276,16,75,94,23,11,219,不合格
20174277,62,38,49,27,93,269,不合格
20174278,11,46,46,68,78,249,不合格
20174279,2,5,58,62,0,127,不合格
20174280,62,66,57,5,58,248,不合格
20174281,9,82,94,10,32,227,不合格
20174282,17,48,60,91,17,233,不合格
20174283,14,17,80,86,27,224,不合格
20174284,74,16,47,94,60,291,不合格
20174285,28,90,10,77,13,218,不合格
20174286,40,94,87,59,9,289,不合格
20174287,66,87,1,43,95,292,不合格
20174288,25,67,68,63,58,281,不合格
20174289,12,92,67,21,91,283,不合格
20174290,97,68,12,48,69,294,不合格
20174291,48,12,63,38,8,169,不合格
20174292,5,36,92,58,11,202,不合格
20174293,89,63,99,67,59,377,合格
20174294,3,33,58,88,11,193,不合格
20174295,85,58,5,14,69,231,不合格
20174296,60,1,5,66,57,189,不合格
20174297,98,17,43,80,76,314,合格
20174298,80,9,67,46,86,288,不合格
20174299,83,76,21,58,95,333,合格
20174300,28,9,61,68,44,210,不合格
20174301,90,38,46,7,83,264,不合格
20174302,64,79,2,60,49,254,不合格
20174303,67,24,35,68,53,247,不合格
20174304,62,85,71,60,42,320,合格
20174305,81,63,15,3,54,216,不合格
20174306,27,22,59,24,48,180,不合格
20174307,16,91,56,5,92,260,不合格
20174308,56,76,24,44,42,242,不合格
20174309,83,78,7,50,18,236,不合格
20174310,40,97,2,43,10,192,不合格
20174311,6,80,8,11,30,135,不合格
20174312,62,19,42,37,46,206,不合格
20174313,1,58,35,83,52,229,不合格
20174314,25,67,35,7,34,168,不合格
20174315,42,75,56,67,90,330,合格
20174316,65,95,3,72,39,274,不合格
20174317,62,86,84,43,98,373,合格
20174318,87,92,12,8,94,293,不合格
20174319,26,37,2,32,76,173,不合格
20174320,98,71,98,56,55,378,合格
20174321,61,87,30,30,4,212,不合格
20174322,95,55,0,37,0,187,不合格
20174323,35,33,17,66,58,209,不合格
20174324,47,79,31,15,1,173,不合格
20174325,72,1,81,8,51,213,不合格
20174326,74,5,58,18,81,236,不合格
20174327,94,27,9,77,54,261,不合格
20174328,66,99,21,67,20,273,不合格
20174329,4,71,31,0,56,162,不合格
20174330,28,32,99,11,28,198,不合格
20174331,19,18,87,31,1,156,不合格
20174332,31,29,9,69,5,143,不合格
20174333,20,18,25,34,82,179,不合格
20174334,60,4,49,7,42,162,不合格
20174335,54,94,64,74,55,341,合格
20174336,87,79,30,29,68,293,不合格
20174337,50,90,78,7,11,236,不合格
20174338,89,95,74,90,49,397,合格
20174339,89,94,77,15,49,324,合格
20174340,87,49,20,97,33,286,不合格
20174341,78,75,64,48,8,273,不合格
20174342,21,52,58,7,33,171,不合格
20174343,31,74,18,39,1,163,不合格
20174344,72,15,47,49,13,196,不合格
20174345,95,18,71,60,1,245,不合格
20174346,68,24,88,40,15,235,不合格
20174347,10,65,36,74,10,195,不合格
20174348,72,18,16,84,61,251,不合格
20174349,48,83,52,72,74,329,合格
20174350,63,53,45,16,70,247,不合格
20174351,52,92,50,25,72,291,不合格
20174352,57,53,28,69,74,281,不合格
20174353,78,45,38,7,43,211,不合格
20174354,86,32,21,27,91,257,不合格
20174355,63,46,56,79,39,283,不合格
20174356,73,19,52,50,73,267,不合格
20174357,76,7,74,1,95,253,不合格
20174358,65,2,79,95,14,255,不合格
20174359,70,92,95,61,50,368,合格
20174360,17,32,93,25,86,253,不合格
20174361,50,48,57,25,27,207,不合格
20174362,81,35,92,21,51,280,不合格
20174363,92,72,69,40,23,296,不合格
20174364,7,78,38,38,65,226,不合格
20174365,43,2,45,37,23,150,不合格
20174366,87,15,77,14,48,241,不合格
20174367,34,1,96,81,2,214,不合格
20174368,76,33,97,81,90,377,合格
20174369,22,28,1,40,86,177,不合格
20174370,76,11,60,9,13,169,不合格
20174371,27,33,38,17,65,180,不合格
20174372,5,6,21,70,60,162,不合格
20174373,59,50,42,34,56,241,不合格
20174374,12,27,34,94,28,195,不合格
20174375,16,73,85,73,64,311,合格
20174376,51,64,10,45,91,261,不合格
20174377,87,1,81,82,29,280,不合格
20174378,83,13,91,49,79,315,合格
20174379,16,70,76,60,66,288,不合格
20174380,74,63,46,92,38,313,合格
20174381,64,69,33,8,10,184,不合格
20174382,74,24,95,76,25,294,不合格
20174383,1,27,9,55,28,120,不合格
20174384,53,33,48,29,34,197,不合格
20174385,40,48,8,24,7,127,不合格
20174386,49,3,62,23,1,138,不合格
20174387,42,96,22,88,21,269,不合格
20174388,82,44,76,1,75,278,不合格
20174389,47,16,38,21,30,152,不合格
20174390,10,12,27,59,79,187,不合格
20174391,68,45,53,0,75,241,不合格
20174392,2,79,4,88,37,210,不合格
20174393,34,53,71,78,68,304,合格
20174394,69,1,89,17,9,185,不合格
20174395,67,27,94,21,81,290,不合格
20174396,5,38,77,91,8,219,不合格
20174397,28,89,99,84,15,315,合格
20174398,2,63,71,25,48,209,不合格
20174399,24,95,66,2,59,246,不合格
20174400,19,96,7,36,85,243,不合格
20174401,98,93,61,17,50,319,合格
20174402,41,98,15,43,11,208,不合格
20174403,64,11,30,48,86,239,不合格
20174404,78,35,32,16,76,237,不合格
20174405,90,24,21,4,75,214,不合格
20174406,36,12,71,94,37,250,不合格
20174407,33,49,82,6,48,218,不合格
20174408,89,8,78,56,29,260,不合格
20174409,84,43,93,63,11,294,不合格
20174410,19,26,92,66,32,235,不合格
20174411,67,32,39,93,38,269,不合格
20174412,34,7,44,80,63,228,不合格
20174413,70,4,81,8,48,211,不合格
20174414,34,35,98,75,39,281,不合格
20174415,94,54,57,75,81,361,合格
20174416,10,60,42,53,27,192,不合格
20174417,54,33,46,28,87,248,不合格
20174418,11,10,0,7,78,106,不合格
20174419,39,99,2,18,20,178,不合格
20174420,38,46,67,38,3,192,不合格
20174421,61,51,52,58,46,268,不合格
20174422,80,5,68,24,36,213,不合格
20174423,30,92,77,76,99,374,合格
20174424,84,32,77,93,65,351,合格
20174425,20,90,37,77,40,264,不合格
20174426,32,57,69,82,68,308,合格
20174427,59,57,36,93,18,263,不合格
20174428,21,30,27,38,89,205,不合格
20174429,12,75,77,93,79,336,合格
20174430,43,1,57,34,69,204,不合格
20174431,98,57,47,51,46,299,不合格
20174432,76,6,20,95,67,264,不合格
20174433,58,27,96,27,46,254,不合格
20174434,2,48,20,86,30,186,不合格
20174435,53,48,74,50,77,302,合格
20174436,98,19,45,97,46,305,合格
20174437,59,52,88,10,54,263,不合格
20174438,48,42,65,66,66,287,不合格
20174439,11,77,69,5,44,206,不合格
20174440,54,17,20,28,49,168,不合格
20174441,47,11,44,28,17,147,不合格
20174442,63,0,67,17,99,246,不合格
20174443,22,54,76,44,25,221,不合格
20174444,9,97,36,78,58,278,不合格
20174445,11,40,19,28,93,191,不合格
20174446,53,11,40,24,73,201,不合格
20174447,87,3,57,98,87,332,合格
20174448,47,61,47,53,14,222,不合格
20174449,43,86,31,55,34,249,不合格
20174450,70,75,66,93,8,312,合格
20174451,67,68,2,91,50,278,不合格
20174452,79,88,34,31,74,306,合格
20174453,84,43,40,68,40,275,不合格
20174454,6,7,79,7,64,163,不合格
20174455,29,59,50,46,5,189,不合格
20174456,20,16,71,47,65,219,不合格
20174457,39,96,19,77,48,279,不合格
20174458,28,83,19,44,10,184,不合格
20174459,2,22,10,33,55,122,不合格
20174460,39,13,12,9,73,146,不合格
20174461,5,35,19,21,5,85,不合格
20174462,96,37,87,78,9,307,合格
20174463,54,85,89,51,44,323,合格
20174464,88,37,72,31,26,254,不合格
20174465,85,71,66,5,45,272,不合格
20174466,45,13,30,42,45,175,不合格
20174467,37,92,36,37,56,258,不合格
20174468,22,51,74,6,58,211,不合格
20174469,11,45,40,78,6,180,不合格
20174470,73,61,76,10,86,306,合格
20174471,74,85,77,5,97,338,合格
20174472,83,72,87,24,67,333,合格
20174473,93,46,70,81,76,366,合格
20174474,22,47,31,39,97,236,不合格
20174475,27,67,15,25,84,218,不合格
20174476,90,34,29,19,79,251,不合格
20174477,79,18,95,52,49,293,不合格
20174478,70,19,7,25,62,183,不合格
20174479,61,25,43,20,53,202,不合格
20174480,60,35,33,92,95,315,合格
20174481,28,26,92,19,86,251,不合格
20174482,38,12,90,23,84,247,不合格
20174483,22,38,64,94,95,313,合格
20174484,86,28,97,67,88,366,合格
20174485,80,9,98,96,83,366,合格
20174486,72,37,31,95,0,235,不合格
20174487,55,4,44,12,75,190,不合格
20174488,78,27,24,23,79,231,不合格
20174489,54,58,38,5,24,179,不合格
20174490,84,87,13,6,6,196,不合格
20174491,45,77,12,85,13,232,不合格
20174492,53,82,21,92,15,263,不合格
20174493,63,48,64,70,35,280,不合格
20174494,62,54,55,32,83,286,不合格
20174495,40,59,42,50,16,207,不合格
20174496,97,41,71,12,95,316,合格
20174497,58,14,45,64,70,251,不合格
20174498,95,44,42,82,79,342,合格
20174499,74,56,88,53,10,281,不合格
20174500,15,84,12,66,46,223,不合格
20174501,54,93,21,76,90,334,合格
20174502,31,83,83,57,4,258,不合格
20174503,51,50,31,60,94,286,不合格
20174504,83,67,67,46,22,285,不合格
20174505,4,17,90,19,6,136,不合格
20174506,60,35,14,8,54,171,不合格
20174507,98,58,44,52,3,255,不合格
20174508,97,96,49,32,59,333,合格
20174509,21,70,78,31,54,254,不合格
20174510,35,27,65,84,64,275,不合格
20174511,25,35,74,73,15,222,不合格
20174512,86,14,14,27,30,171,不合格
20174513,81,81,46,87,27,322,合格
20174514,29,89,25,32,77,252,不合格
20174515,44,95,60,43,15,257,不合格
20174516,86,98,12,76,41,313,合格
20174517,95,53,93,61,20,322,合格
20174518,6,19,11,52,75,163,不合格
20174519,32,87,97,29,47,292,不合格
20174520,5,48,50,19,73,195,不合格
20174521,55,24,62,83,92,316,合格
20174522,96,29,3,89,67,284,不合格
20174523,69,21,0,38,74,202,不合格
20174524,34,73,32,70,93,302,合格
20174525,80,11,17,11,42,161,不合格
20174526,63,67,54,81,67,332,合格
20174527,53,71,87,98,6,315,合格
20174528,88,80,83,18,46,315,合格
20174529,23,16,40,67,11,157,不合格
20174530,88,43,60,12,52,255,不合格
20174531,2,16,70,4,86,178,不合格
20174532,77,3,3,82,15,180,不合格
20174533,16,89,35,36,37,213,不合格
20174534,14,80,39,43,21,197,不合格
20174535,2,62,22,17,36,139,不合格
20174536,49,2,12,87,72,222,不合格
20174537,93,85,67,58,58,361,合格
20174538,53,65,94,57,31,300,合格
20174539,95,43,39,37,53,267,不合格
20174540,24,62,28,42,92,248,不合格
20174541,11,33,26,73,21,164,不合格
20174542,7,83,64,7,59,220,不合格
20174543,3,82,75,84,80,324,合格
20174544,49,92,44,62,92,339,合格
20174545,8,51,2,31,45,137,不合格
20174546,40,68,32,30,21,191,不合格
20174547,44,84,43,37,49,257,不合格
20174548,55,52,56,36,70,269,不合格
20174549,73,14,18,95,97,297,不合格
20174550,2,10,35,24,23,94,不合格
20174551,49,69,3,0,80,201,不合格
20174552,47,36,17,3,44,147,不合格
20174553,21,12,25,16,34,108,不合格
20174554,43,81,45,67,12,248,不合格
20174555,79,61,89,30,34,293,不合格
20174556,14,20,87,90,84,295,不合格
20174557,84,48,59,45,74,310,合格
20174558,7,45,3,63,13,131,不合格
20174559,34,98,70,57,5,264,不合格
20174560,60,4,85,13,88,250,不合格
20174561,14,56,29,60,81,240,不合格
20174562,40,99,85,14,30,268,不合格
20174563,79,21,45,81,85,311,合格
20174564,14,12,88,54,99,267,不合格
20174565,46,71,72,2,78,269,不合格
20174566,87,93,77,78,26,361,合格
20174567,26,11,57,97,89,280,不合格
20174568,31,75,82,3,34,225,不合格
20174569,84,41,66,9,4,204,不合格
20174570,1,35,37,23,75,171,不合格
20174571,35,99,77,75,99,385,合格
20174572,56,80,57,24,57,274,不合格
20174573,32,69,71,3,19,194,不合格
20174574,17,47,57,3,67,191,不合格
20174575,6,51,31,73,80,241,不合格
20174576,37,41,61,51,19,209,不合格
20174577,73,53,86,69,41,322,合格
20174578,36,78,71,38,97,320,合格
20174579,37,62,62,92,8,261,不合格
20174580,27,70,78,65,31,271,不合格
20174581,44,28,69,0,87,228,不合格
20174582,92,83,55,0,82,312,合格
20174583,17,98,4,61,51,231,不合格
20174584,39,49,52,87,12,239,不合格
20174585,30,39,51,72,16,208,不合格
20174586,38,44,74,66,36,258,不合格
20174587,29,92,80,7,56,264,不合格
20174588,50,99,59,96,96,400,合格
20174589,21,92,40,89,65,307,合格
20174590,0,76,67,21,86,250,不合格
20174591,82,50,87,81,3,303,合格
20174592,49,36,41,30,1,157,不合格
20174593,29,65,29,57,89,269,不合格
20174594,60,35,83,85,28,291,不合格
20174595,30,22,17,89,82,240,不合格
20174596,69,14,84,31,33,231,不合格
20174597,18,56,17,11,47,149,不合格
20174598,77,39,29,93,85,323,合格
20174599,28,18,51,43,18,158,不合格
20174600,81,10,55,45,36,227,不合格
20174601,74,27,99,70,23,293,不合格
20174602,49,20,62,96,95,322,合格
20174603,41,22,65,76,90,294,不合格
20174604,32,7,45,94,40,218,不合格
20174605,5,35,83,37,24,184,不合格
20174606,69,55,70,34,90,318,合格
20174607,86,75,3,15,17,196,不合格
20174608,19,27,34,1,56,137,不合格
20174609,87,35,14,7,17,160,不合格
20174610,15,96,49,60,91,311,合格
20174611,56,7,88,47,70,268,不合格
20174612,20,77,98,13,83,291,不合格
20174613,54,55,32,4,99,244,不合格
20174614,91,66,93,41,67,358,合格
20174615,60,14,94,28,72,268,不合格
20174616,45,17,25,78,44,209,不合格
20174617,35,41,65,60,90,291,不合格
20174618,74,64,97,13,87,335,合格
20174619,84,84,70,3,75,316,合格
20174620,43,75,18,43,78,257,不合格
20174621,23,32,52,57,3,167,不合格
20174622,62,49,67,53,71,302,合格
20174623,5,47,40,37,81,210,不合格
20174624,68,0,15,78,54,215,不合格
20174625,24,2,87,24,97,234,不合格
20174626,63,97,99,5,69,333,合格
20174627,11,47,99,56,14,227,不合格
20174628,81,66,30,36,20,233,不合格
20174629,53,49,1,86,54,243,不合格
20174630,84,88,27,79,26,304,合格
20174631,53,86,39,94,84,356,合格
20174632,1,85,70,73,41,270,不合格
20174633,12,66,44,50,32,204,不合格
20174634,76,98,15,31,40,260,不合格
20174635,68,18,93,93,95,367,合格
20174636,95,77,72,9,49,302,合格
20174637,30,23,28,16,41,138,不合格
20174638,99,78,28,31,60,296,不合格
20174639,74,35,3,62,66,240,不合格
20174640,63,6,53,93,81,296,不合格
20174641,24,1,3,6,15,49,不合格
20174642,30,11,37,78,54,210,不合格
20174643,56,71,88,11,4,230,不合格
20174644,49,8,87,5,88,237,不合格
20174645,82,1,99,29,54,265,不合格
20174646,22,93,75,62,95,347,合格
20174647,44,96,9,95,12,256,不合格
20174648,28,11,16,2,80,137,不合格
20174649,88,28,26,13,83,238,不合格
20174650,91,39,78,51,75,334,合格
20174651,10,72,75,97,99,353,合格
20174652,4,97,86,1,29,217,不合格
20174653,79,83,56,68,62,348,合格
20174654,6,40,45,59,46,196,不合格
20174655,21,51,80,99,96,347,合格
20174656,27,25,39,52,32,175,不合格
20174657,99,9,41,34,56,239,不合格
20174658,79,80,4,69,51,283,不合格
20174659,43,65,44,2,51,205,不合格
20174660,87,5,62,53,44,251,不合格
20174661,78,5,48,48,82,261,不合格
20174662,90,84,19,17,37,247,不合格
20174663,90,59,34,52,8,243,不合格
20174664,7,44,99,87,62,299,不合格
20174665,26,77,10,88,10,211,不合格
20174666,28,74,1,54,12,169,不合格
20174667,7,72,84,85,50,298,不合格
20174668,49,0,55,39,85,228,不合格
20174669,54,95,33,3,75,260,不合格
20174670,87,3,93,2,6,191,不合格
20174671,79,45,76,53,6,259,不合格
20174672,72,23,9,54,96,254,不合格
20174673,50,89,94,56,69,358,合格
20174674,57,95,35,7,74,268,不合格
20174675,14,12,24,90,76,216,不合格
20174676,86,34,78,30,71,299,不合格
20174677,83,80,81,32,45,321,合格
20174678,13,17,24,34,31,119,不合格
20174679,91,54,92,42,21,300,合格
20174680,30,46,58,1,95,230,不合格
20174681,24,25,94,12,66,221,不合格
20174682,55,81,83,31,97,347,合格
20174683,19,11,68,10,29,137,不合格
20174684,71,15,71,12,6,175,不合格
20174685,6,81,69,77,18,251,不合格
20174686,3,34,54,8,84,183,不合格
20174687,62,40,15,67,19,203,不合格
20174688,64,69,89,7,7,236,不合格
20174689,74,3,50,79,47,253,不合格
20174690,30,3,32,79,66,210,不合格
20174691,82,37,4,49,5,177,不合格
20174692,47,21,9,56,78,211,不合格
20174693,57,28,47,40,99,271,不合格
20174694,0,49,67,56,72,244,不合格
20174695,44,5,85,94,90,318,合格
20174696,90,12,84,41,60,287,不合格
20174697,1,56,39,64,0,160,不合格
20174698,62,8,81,52,11,214,不合格
20174699,7,19,75,82,36,219,不合格
20174700,88,21,62,61,31,263,不合格
20174701,66,21,58,51,5,201,不合格
20174702,37,92,83,73,35,320,合格
20174703,7,71,11,51,1,141,不合格
20174704,85,29,50,87,6,257,不合格
20174705,95,98,49,49,20,311,合格
20174706,68,61,70,36,69,304,合格
20174707,82,85,16,5,12,200,不合格
20174708,19,70,80,91,74,334,合格
20174709,74,86,66,67,68,361,合格
20174710,20,38,25,47,59,189,不合格
20174711,22,97,47,72,13,251,不合格
20174712,36,42,57,23,19,177,不合格
20174713,38,16,72,57,35,218,不合格
20174714,37,39,20,20,11,127,不合格
20174715,81,84,42,29,19,255,不合格
20174716,21,6,73,29,18,147,不合格
20174717,75,99,90,26,33,323,合格
20174718,58,81,15,26,6,186,不合格
20174719,84,9,97,48,93,331,合格
20174720,16,55,63,67,9,210,不合格
20174721,31,75,57,45,69,277,不合格
20174722,36,34,58,57,43,228,不合格
20174723,38,91,55,81,31,296,不合格
20174724,85,33,35,26,0,179,不合格
20174725,74,45,76,94,2,291,不合格
20174726,51,68,99,91,88,397,合格
20174727,42,24,75,60,11,212,不合格
20174728,55,25,73,43,49,245,不合格
20174729,40,19,90,82,50,281,不合格
20174730,10,86,23,68,80,267,不合格
20174731,3,90,97,98,74,362,合格
20174732,99,27,45,13,12,196,不合格
20174733,41,91,55,30,71,288,不合格
20174734,91,48,54,33,21,247,不合格
20174735,1,44,0,95,21,161,不合格
20174736,16,58,95,27,67,263,不合格
20174737,31,24,80,24,98,257,不合格
20174738,60,59,51,39,45,254,不合格
20174739,32,92,76,72,67,339,合格
20174740,68,95,62,70,17,312,合格
20174741,26,31,55,59,49,220,不合格
20174742,24,54,39,98,36,251,不合格
20174743,10,28,80,76,82,276,不合格
20174744,29,0,30,55,22,136,不合格
20174745,29,78,25,77,60,269,不合格
20174746,38,22,90,12,81,243,不合格
20174747,50,36,33,2,62,183,不合格
20174748,37,85,40,13,95,270,不合格
20174749,87,37,22,74,80,300,合格
20174750,95,30,58,5,36,224,不合格
20174751,43,88,8,34,33,206,不合格
20174752,90,58,97,71,67,383,合格
20174753,5,58,11,17,32,123,不合格
20174754,26,13,88,51,50,228,不合格
20174755,54,63,17,61,83,278,不合格
20174756,23,33,43,8,80,187,不合格
20174757,35,50,37,67,14,203,不合格
20174758,78,85,24,59,72,318,合格
20174759,41,28,5,44,31,149,不合格
20174760,71,82,47,19,90,309,合格
20174761,76,82,98,97,42,395,合格
20174762,31,9,36,21,38,135,不合格
20174763,76,74,44,91,96,381,合格
20174764,7,41,86,81,87,302,合格
20174765,41,2,37,0,51,131,不合格
20174766,40,91,84,62,94,371,合格
20174767,7,39,75,51,70,242,不合格
20174768,40,58,71,50,45,264,不合格
20174769,81,22,47,17,2,169,不合格
20174770,27,78,58,85,18,266,不合格
20174771,53,39,62,72,65,291,不合格
20174772,88,59,27,82,77,333,合格
20174773,4,8,15,11,17,55,不合格
20174774,17,28,83,50,56,234,不合格
20174775,90,99,49,37,78,353,合格
20174776,64,80,27,31,81,283,不合格
20174777,55,91,84,29,17,276,不合格
20174778,0,82,34,80,17,213,不合格
20174779,16,57,12,3,75,163,不合格
20174780,71,81,50,71,76,349,合格
20174781,0,19,62,43,82,206,不合格
20174782,88,58,5,73,32,256,不合格
20174783,12,71,4,87,56,230,不合格
20174784,66,88,12,8,60,234,不合格
20174785,83,3,95,28,62,271,不合格
20174786,0,85,5,42,32,164,不合格
20174787,3,8,45,5,42,103,不合格
20174788,59,11,54,93,5,222,不合格
20174789,89,46,58,80,21,294,不合格
20174790,66,62,73,38,25,264,不合格
20174791,35,53,77,16,27,208,不合格
20174792,33,44,56,65,13,211,不合格
20174793,2,48,69,89,55,263,不合格
20174794,51,86,65,74,78,354,合格
20174795,7,59,52,68,4,190,不合格
20174796,4,4,35,83,70,196,不合格
20174797,17,78,11,30,30,166,不合格
20174798,73,42,39,7,83,244,不合格
20174799,71,72,64,32,37,276,不合格
20174800,27,9,36,78,65,215,不合格
20174801,24,99,34,83,47,287,不合格
20174802,6,12,13,15,87,133,不合格
20174803,34,21,93,85,48,281,不合格
20174804,61,77,72,3,78,291,不合格
20174805,49,51,67,87,68,322,合格
20174806,23,76,2,48,99,248,不合格
20174807,97,18,48,85,19,267,不合格
20174808,90,31,11,49,7,188,不合格
20174809,63,60,47,84,69,323,合格
20174810,88,24,36,98,48,294,不合格
20174811,85,66,63,19,3,236,不合格
20174812,83,58,5,45,85,276,不合格
20174813,77,11,3,18,49,158,不合格
20174814,7,45,32,94,19,197,不合格
20174815,89,60,87,10,70,316,合格
20174816,73,65,77,81,27,323,合格
20174817,82,70,83,26,62,323,合格
20174818,42,61,11,81,68,263,不合格
20174819,19,51,36,0,52,158,不合格
20174820,51,24,0,93,7,175,不合格
20174821,39,21,14,38,18,130,不合格
20174822,26,86,92,60,26,290,不合格
20174823,19,15,19,52,68,173,不合格
20174824,47,89,77,67,2,282,不合格
20174825,20,8,36,1,83,148,不合格
20174826,23,22,18,76,9,148,不合格
20174827,44,26,1,17,25,113,不合格
20174828,54,59,21,81,63,278,不合格
20174829,85,59,22,21,89,276,不合格
20174830,45,16,64,99,56,280,不合格
20174831,6,68,6,24,66,170,不合格
20174832,86,77,21,70,26,280,不合格
20174833,21,78,19,91,53,262,不合格
20174834,20,31,69,44,32,196,不合格
20174835,93,4,89,26,17,229,不合格
20174836,77,96,12,81,63,329,合格
20174837,55,29,79,1,67,231,不合格
20174838,67,94,67,76,10,314,合格
20174839,28,29,38,39,81,215,不合格
20174840,96,14,44,15,13,182,不合格
20174841,71,50,30,36,67,254,不合格
20174842,24,23,28,55,52,182,不合格
20174843,82,24,36,26,48,216,不合格
20174844,51,92,53,66,80,342,合格
20174845,97,3,34,79,61,274,不合格
20174846,44,65,97,80,67,353,合格
20174847,24,6,42,49,29,150,不合格
20174848,15,54,93,43,20,225,不合格
20174849,19,35,53,31,86,224,不合格
20174850,87,96,94,95,89,461,合格
20174851,56,43,72,38,59,268,不合格
20174852,5,99,94,48,95,341,合格
20174853,55,40,0,66,8,169,不合格
20174854,9,67,46,43,79,244,不合格
20174855,71,54,72,61,36,294,不合格
20174856,5,8,74,60,69,216,不合格
20174857,10,55,8,19,24,116,不合格
20174858,73,70,17,46,73,279,不合格
20174859,42,42,87,87,52,310,合格
20174860,29,72,37,56,21,215,不合格
20174861,11,86,11,48,85,241,不合格
20174862,40,2,15,41,48,146,不合格
20174863,84,76,85,12,95,352,合格
20174864,77,59,83,9,64,292,不合格
20174865,89,83,68,87,0,327,合格
20174866,59,43,40,88,74,304,合格
20174867,89,35,20,48,95,287,不合格
20174868,86,71,99,93,91,440,合格
20174869,94,53,84,53,75,359,合格
20174870,46,18,64,50,1,179,不合格
20174871,15,28,24,11,34,112,不合格
20174872,9,77,31,65,98,280,不合格
20174873,8,94,92,60,18,272,不合格
20174874,22,16,40,54,26,158,不合格
20174875,63,17,33,36,65,214,不合格
20174876,26,9,52,76,66,229,不合格
20174877,33,69,46,73,88,309,合格
20174878,28,9,89,77,60,263,不合格
20174879,39,53,77,7,25,201,不合格
20174880,42,84,16,99,0,241,不合格
20174881,51,29,16,64,57,217,不合格
20174882,64,1,16,31,59,171,不合格
20174883,31,27,72,5,84,219,不合格
20174884,31,49,42,3,82,207,不合格
20174885,96,27,28,77,69,297,不合格
20174886,65,0,88,40,12,205,不合格
20174887,78,69,2,54,83,286,不合格
20174888,93,1,98,24,96,312,合格
20174889,17,83,0,52,66,218,不合格
20174890,38,75,52,82,10,257,不合格
20174891,25,99,54,6,89,273,不合格
20174892,51,13,29,94,37,224,不合格
20174893,15,21,41,51,78,206,不合格
20174894,96,55,50,84,21,306,合格
20174895,89,54,4,12,82,241,不合格
20174896,22,67,81,64,12,246,不合格
20174897,19,50,1,35,84,189,不合格
20174898,1,71,22,92,59,245,不合格
20174899,7,7,1,60,9,84,不合格
20174900,19,26,69,19,31,164,不合格
20174901,17,20,95,26,21,179,不合格
20174902,15,68,75,24,68,250,不合格
20174903,92,39,16,46,68,261,不合格
20174904,42,35,24,2,4,107,不合格
20174905,23,69,7,27,28,154,不合格
20174906,97,41,45,57,13,253,不合格
20174907,9,67,29,51,90,246,不合格
20174908,70,77,70,89,35,341,合格
20174909,39,83,80,45,65,312,合格
20174910,55,44,64,28,20,211,不合格
20174911,71,87,97,47,14,316,合格
20174912,46,1,66,96,67,276,不合格
20174913,23,87,54,78,93,335,合格
20174914,67,74,81,57,6,285,不合格
20174915,60,40,98,69,3,270,不合格
20174916,53,35,15,94,84,281,不合格
20174917,87,73,21,88,95,364,合格
20174918,58,30,61,54,6,209,不合格
20174919,68,93,61,30,69,321,合格
20174920,45,29,66,23,82,245,不合格
20174921,99,61,46,31,43,280,不合格
20174922,62,55,22,88,82,309,合格
20174923,51,40,81,80,75,327,合格
20174924,91,24,80,23,84,302,合格
20174925,10,17,31,94,26,178,不合格
20174926,48,36,84,5,50,223,不合格
20174927,43,87,62,65,96,353,合格
20174928,6,72,33,62,14,187,不合格
20174929,77,32,13,91,17,230,不合格
20174930,19,92,4,19,17,151,不合格
20174931,4,30,47,66,20,167,不合格
20174932,72,17,80,76,88,333,合格
20174933,76,41,34,51,66,268,不合格
20174934,46,63,26,24,57,216,不合格
20174935,31,66,21,86,52,256,不合格
20174936,3,85,37,21,66,212,不合格
20174937,98,94,34,38,2,266,不合格
20174938,43,23,61,50,31,208,不合格
20174939,52,56,89,65,74,336,合格
20174940,6,5,31,58,30,130,不合格
20174941,59,16,74,54,74,277,不合格
20174942,90,46,36,17,88,277,不合格
20174943,89,6,35,35,85,250,不合格
20174944,78,19,15,85,32,229,不合格
20174945,92,98,41,23,51,305,合格
20174946,76,34,93,42,13,258,不合格
20174947,22,32,81,88,89,312,合格
20174948,89,15,34,40,45,223,不合格
20174949,5,53,21,71,72,222,不合格
20174950,44,9,20,21,69,163,不合格
20174951,55,91,13,92,61,312,合格
20174952,61,27,95,43,14,240,不合格
20174953,77,49,79,10,85,300,合格
20174954,55,14,99,96,79,343,合格
20174955,20,16,43,87,91,257,不合格
20174956,98,4,56,81,81,320,合格
20174957,8,29,0,34,33,104,不合格
20174958,74,99,23,32,43,271,不合格
20174959,93,91,54,33,62,333,合格
20174960,66,87,28,51,56,288,不合格
20174961,17,57,19,6,55,154,不合格
20174962,59,24,65,13,10,171,不合格
20174963,52,18,57,71,17,215,不合格
20174964,98,43,17,62,64,284,不合格
20174965,77,90,3,81,1,252,不合格
20174966,10,54,31,0,15,110,不合格
20174967,1,15,65,32,38,151,不合格
20174968,94,30,75,31,44,274,不合格
20174969,30,1,25,51,69,176,不合格
20174970,45,52,3,38,7,145,不合格
20174971,33,59,93,60,72,317,合格
20174972,93,89,24,35,87,328,合格
20174973,83,90,39,87,46,345,合格
20174974,70,3,66,53,58,250,不合格
20174975,98,45,31,7,89,270,不合格
20174976,22,56,8,46,48,180,不合格
20174977,86,68,96,13,30,293,不合格
20174978,71,50,90,22,47,280,不合格
20174979,57,4,67,1,6,135,不合格
20174980,92,38,10,3,74,217,不合格
20174981,9,24,79,93,11,216,不合格
20174982,70,65,90,51,42,318,合格
20174983,90,39,18,56,42,245,不合格
20174984,24,8,76,14,78,200,不合格
20174985,9,26,38,17,53,143,不合格
20174986,39,44,93,86,23,285,不合格
20174987,85,5,57,82,15,244,不合格
20174988,76,40,35,95,32,278,不合格
20174989,23,49,75,79,56,282,不合格
20174990,34,76,45,83,41,279,不合格
20174991,84,68,90,51,97,390,合格
20174992,98,96,99,61,63,417,合格
20174993,56,13,94,91,5,259,不合格
20174994,63,87,35,26,80,291,不合格
20174995,79,60,61,66,13,279,不合格
20174996,88,14,14,41,79,236,不合格
20174997,25,58,72,26,97,278,不合格
20174998,59,83,79,20,68,309,合格
20174999,42,8,81,56,63,250,不合格
20175000,97,58,52,19,32,258,不合格
20175001,60,47,33,12,40,192,不合格
20175002,71,56,88,68,92,375,合格
20175003,41,42,5,32,93,213,不合格
20175004,54,63,41,65,92,315,合格
20175005,93,6,41,55,84,279,不合格
20175006,22,98,31,13,31,195,不合格
20175007,20,88,11,81,92,292,不合格
20175008,39,89,19,65,61,273,不合格
20175009,28,62,7,92,88,277,不合格
20175010,77,69,80,19,8,253,不合格
20175011,15,52,15,69,68,219,不合格
20175012,95,64,90,66,14,329,合格
20175013,29,64,91,58,95,337,合格
20175014,14,19,0,25,82,140,不合格
20175015,25,29,77,10,1,142,不合格
20175016,88,65,10,49,21,233,不合格
20175017,25,66,21,78,27,217,不合格
20175018,88,86,22,70,55,321,合格
20175019,33,18,3,16,17,87,不合格
20175020,94,94,33,63,55,339,合格
20175021,54,54,45,95,71,319,合格
20175022,52,91,58,36,4,241,不合格
20175023,54,73,97,44,45,313,合格
20175024,3,32,36,29,62,162,不合格
20175025,86,14,66,8,4,178,不合格
20175026,25,81,21,96,37,260,不合格
20175027,69,94,29,14,4,210,不合格
20175028,58,59,26,82,36,261,不合格
20175029,77,76,54,14,6,227,不合格
20175030,97,88,65,72,17,339,合格
20175031,56,46,36,11,3,152,不合格
20175032,11,39,45,2,42,139,不合格
20175033,86,4,76,27,47,240,不合格
20175034,96,75,78,66,28,343,合格
20175035,57,54,72,68,32,283,不合格
20175036,90,19,44,0,71,224,不合格
20175037,74,70,92,82,28,346,合格
20175038,22,77,78,78,92,347,合格
20175039,35,62,99,83,23,302,合格
20175040,45,85,89,62,90,371,合格
20175041,25,5,96,43,75,244,不合格
20175042,11,96,13,33,30,183,不合格
20175043,67,68,58,87,94,374,合格
20175044,99,85,71,25,16,296,不合格
20175045,65,45,74,77,36,297,不合格
20175046,64,18,20,15,31,148,不合格
20175047,25,90,37,12,58,222,不合格
20175048,73,68,90,24,96,351,合格
20175049,85,58,18,64,23,248,不合格
20175050,61,24,43,38,64,230,不合格
20175051,97,74,54,84,15,324,合格
20175052,82,54,60,69,32,297,不合格
20175053,77,1,79,7,42,206,不合格
20175054,46,96,69,69,62,342,合格
20175055,13,87,55,75,62,292,不合格
20175056,17,13,0,51,82,163,不合格
20175057,64,3,62,90,26,245,不合格
20175058,55,16,87,18,20,196,不合格
20175059,57,42,10,34,15,158,不合格
20175060,75,36,26,51,21,209,不合格
20175061,37,50,47,29,75,238,不合格
20175062,94,13,87,55,28,277,不合格
20175063,20,11,77,56,59,223,不合格
20175064,65,28,5,92,8,198,不合格
20175065,40,93,11,76,38,258,不合格
20175066,84,32,60,69,21,266,不合格
20175067,81,53,54,96,33,317,合格
20175068,68,42,56,77,73,316,合格
20175069,24,83,99,79,72,357,合格
20175070,36,37,87,95,15,270,不合格
20175071,50,20,93,61,13,237,不合格
20175072,17,81,29,93,8,228,不合格
20175073,56,75,34,8,83,256,不合格
20175074,18,27,71,62,29,207,不合格
20175075,18,33,67,44,29,191,不合格
20175076,12,1,83,41,36,173,不合格
20175077,17,14,65,19,7,122,不合格
20175078,78,55,14,97,50,294,不合格
20175079,61,34,73,49,54,271,不合格
20175080,82,80,89,20,69,340,合格
20175081,19,35,2,31,46,133,不合格
20175082,51,53,70,0,14,188,不合格
20175083,90,47,45,27,97,306,合格
20175084,75,16,45,99,53,288,不合格
20175085,36,19,46,3,1,105,不合格
20175086,87,15,54,44,75,275,不合格
20175087,21,57,34,23,10,145,不合格
20175088,92,82,3,84,47,308,合格
20175089,43,62,81,86,33,305,合格
20175090,21,26,96,46,68,257,不合格
20175091,10,85,12,18,26,151,不合格
20175092,1,60,39,86,36,222,不合格
20175093,64,79,36,17,9,205,不合格
20175094,64,15,46,74,27,226,不合格
20175095,65,24,13,79,73,254,不合格
20175096,71,80,40,67,50,308,合格
20175097,99,65,80,6,11,261,不合格
20175098,46,94,71,76,83,370,合格
20175099,9,29,69,81,29,217,不合格
20175100,88,7,8,17,3,123,不合格
20175101,90,64,56,76,35,321,合格
20175102,82,86,33,84,44,329,合格
20175103,95,19,27,66,10,217,不合格
20175104,18,70,84,25,91,288,不合格
20175105,76,6,32,86,52,252,不合格
20175106,29,12,99,44,75,259,不合格
20175107,22,73,72,0,99,266,不合格
20175108,14,25,31,93,58,221,不合格
20175109,71,46,47,34,13,211,不合格
20175110,99,23,55,52,55,284,不合格
20175111,52,3,10,23,7,95,不合格
20175112,13,70,44,45,17,189,不合格
20175113,31,60,46,48,34,219,不合格
20175114,15,96,97,43,85,336,合格
20175115,64,77,60,40,31,272,不合格
20175116,92,57,61,99,3,312,合格
20175117,12,32,74,20,11,149,不合格
20175118,72,21,2,14,32,141,不合格
20175119,10,6,55,56,56,183,不合格
20175120,65,96,59,65,18,303,合格
20175121,87,42,40,89,28,286,不合格
20175122,38,40,97,2,29,206,不合格
20175123,64,13,55,20,84,236,不合格
20175124,4,76,10,50,86,226,不合格
20175125,85,96,73,49,45,348,合格
20175126,65,2,48,81,29,225,不合格
20175127,91,20,51,99,99,360,合格
20175128,61,55,56,65,42,279,不合格
20175129,92,99,54,97,76,418,合格
20175130,74,48,77,2,33,234,不合格
20175131,46,63,20,7,11,147,不合格
20175132,37,55,69,43,91,295,不合格
20175133,71,32,66,33,77,279,不合格
20175134,46,81,87,97,91,402,合格
20175135,85,60,59,97,85,386,合格
20175136,71,80,73,66,87,377,合格
20175137,63,8,61,52,64,248,不合格
20175138,47,89,29,14,31,210,不合格
20175139,99,83,43,8,92,325,合格
20175140,45,7,66,6,64,188,不合格
20175141,4,21,70,59,65,219,不合格
20175142,77,81,8,81,90,337,合格
20175143,16,87,59,40,63,265,不合格
20175144,27,48,4,81,75,235,不合格
20175145,51,20,25,14,2,112,不合格
20175146,69,36,63,49,64,281,不合格
20175147,38,35,70,60,4,207,不合格
20175148,86,25,42,32,46,231,不合格
20175149,30,83,19,23,86,241,不合格
20175150,7,31,84,63,43,228,不合格
20175151,22,29,80,60,22,213,不合格
20175152,6,83,18,88,17,212,不合格
20175153,79,20,32,10,49,190,不合格
20175154,9,96,92,10,45,252,不合格
20175155,94,0,25,94,70,283,不合格
20175156,23,20,58,54,99,254,不合格
20175157,57,50,7,76,90,280,不合格
20175158,98,16,95,96,55,360,合格
20175159,19,71,45,29,96,260,不合格
20175160,11,86,82,28,28,235,不合格
20175161,32,57,6,89,40,224,不合格
20175162,26,51,36,76,12,201,不合格
20175163,0,28,4,43,2,77,不合格
20175164,66,16,52,9,69,212,不合格
20175165,39,79,95,25,88,326,合格
20175166,32,19,46,93,46,236,不合格
20175167,83,4,40,66,74,267,不合格
20175168,38,35,55,27,92,247,不合格
20175169,83,36,64,46,25,254,不合格
20175170,80,56,83,23,40,282,不合格
20175171,47,0,64,76,43,230,不合格
20175172,42,81,89,8,79,299,不合格
20175173,83,22,53,45,38,241,不合格
20175174,76,7,68,75,78,304,合格
20175175,69,58,16,12,65,220,不合格
20175176,60,63,72,20,99,314,合格
20175177,4,91,96,11,21,223,不合格
20175178,46,46,93,28,20,233,不合格
20175179,81,38,65,90,55,329,合格
20175180,30,4,6,42,55,137,不合格
20175181,48,25,70,55,10,208,不合格
20175182,22,30,48,94,35,229,不合格
20175183,12,92,86,15,79,284,不合格
20175184,43,97,36,74,50,300,合格
20175185,72,89,94,83,46,384,合格
20175186,66,34,98,95,40,333,合格
20175187,63,60,50,72,76,321,合格
20175188,18,26,48,64,70,226,不合格
20175189,80,43,48,60,43,274,不合格
20175190,54,20,31,4,59,168,不合格
20175191,99,11,13,5,82,210,不合格
20175192,47,74,71,39,77,308,合格
20175193,63,22,51,86,68,290,不合格
20175194,23,13,95,1,79,211,不合格
20175195,83,59,65,28,85,320,合格
20175196,88,15,39,30,40,212,不合格
20175197,76,46,54,83,6,265,不合格
20175198,42,38,42,40,77,239,不合格
20175199,0,39,90,43,40,212,不合格
20175200,15,58,41,3,71,188,不合格
20175201,2,41,94,28,89,254,不合格
20175202,73,9,16,53,0,151,不合格
20175203,38,71,13,58,98,278,不合格
20175204,77,57,60,85,82,361,合格
20175205,94,67,49,92,55,357,合格
20175206,64,44,37,85,12,242,不合格
20175207,94,79,73,42,87,375,合格
20175208,75,27,90,29,31,252,不合格
20175209,40,49,52,97,29,267,不合格
20175210,75,79,57,24,3,238,不合格
20175211,37,69,15,0,60,181,不合格
20175212,44,1,87,29,13,174,不合格
20175213,36,74,87,70,64,331,合格
20175214,78,86,48,26,69,307,合格
20175215,31,85,22,82,32,252,不合格
20175216,15,95,12,44,67,233,不合格
20175217,42,89,81,41,10,263,不合格
20175218,78,43,23,10,93,247,不合格
20175219,52,71,76,33,45,277,不合格
20175220,64,39,76,83,40,302,合格
20175221,53,30,74,53,84,294,不合格
20175222,10,90,6,99,89,294,不合格
20175223,17,86,68,20,80,271,不合格
20175224,28,76,12,38,78,232,不合格
20175225,67,14,63,69,46,259,不合格
20175226,46,28,58,85,93,310,合格
20175227,76,14,89,85,36,300,合格
20175228,36,27,89,43,74,269,不合格
20175229,78,86,31,18,38,251,不合格
20175230,63,48,54,58,10,233,不合格
20175231,40,73,59,81,71,324,合格
20175232,0,17,76,9,83,185,不合格
20175233,71,1,42,41,73,228,不合格
20175234,91,62,39,61,37,290,不合格
20175235,5,53,12,99,8,177,不合格
20175236,6,38,61,64,36,205,不合格
20175237,59,14,1,4,98,176,不合格
20175238,47,13,52,2,10,124,不合格
20175239,19,3,35,96,18,171,不合格
20175240,6,81,11,23,52,173,不合格
20175241,16,95,8,9,66,194,不合格
20175242,98,1,92,77,49,317,合格
20175243,91,16,58,59,18,242,不合格
20175244,10,91,5,57,94,257,不合格
20175245,86,86,36,81,88,377,合格
20175246,31,34,57,64,5,191,不合格
20175247,63,60,44,25,37,229,不合格
20175248,41,80,49,95,6,271,不合格
20175249,61,34,18,62,91,266,不合格
20175250,4,38,81,49,92,264,不合格
20175251,22,35,19,55,91,222,不合格
20175252,17,60,90,39,72,278,不合格
20175253,37,78,45,25,65,250,不合格
20175254,79,10,33,96,9,227,不合格
20175255,46,86,33,11,33,209,不合格
20175256,28,54,51,43,27,203,不合格
20175257,47,28,8,54,18,155,不合格
20175258,73,1,38,82,0,194,不合格
20175259,7,48,21,59,63,198,不合格
20175260,9,22,57,3,64,155,不合格
20175261,0,3,20,79,68,170,不合格
20175262,74,11,6,52,91,234,不合格
20175263,22,23,78,70,87,280,不合格
20175264,37,79,64,76,29,285,不合格
20175265,23,2,16,24,3,68,不合格
20175266,40,36,96,82,96,350,合格
20175267,65,8,30,19,47,169,不合格
20175268,2,64,93,49,95,303,合格
20175269,69,62,34,22,62,249,不合格
20175270,0,2,20,46,80,148,不合格
20175271,92,88,34,34,72,320,合格
20175272,68,77,85,54,60,344,合格
20175273,45,75,65,79,92,356,合格
20175274,22,89,22,12,46,191,不合格
20175275,88,95,34,75,17,309,合格
20175276,19,37,3,65,76,200,不合格
20175277,93,37,70,44,43,287,不合格
20175278,69,67,92,23,25,276,不合格
20175279,64,42,23,74,92,295,不合格
20175280,64,64,48,25,15,216,不合格
20175281,74,70,32,74,88,338,合格
20175282,58,28,0,36,83,205,不合格
20175283,75,62,94,27,25,283,不合格
20175284,18,89,46,18,41,212,不合格
20175285,20,53,43,22,30,168,不合格
20175286,63,31,83,95,50,322,合格
20175287,40,23,87,22,26,198,不合格
20175288,1,17,59,81,18,176,不合格
20175289,66,63,59,55,16,259,不合格
20175290,1,72,92,66,50,281,不合格
20175291,73,14,96,66,93,342,合格
20175292,8,68,40,49,98,263,不合格
20175293,77,50,96,90,62,375,合格
20175294,11,16,7,60,31,125,不合格
20175295,44,95,24,47,81,291,不合格
20175296,84,37,95,18,92,326,合格
20175297,58,95,73,22,4,252,不合格
20175298,79,18,15,92,85,289,不合格
20175299,38,41,28,67,8,182,不合格
20175300,51,23,58,92,66,290,不合格
20175301,0,91,99,30,42,262,不合格
20175302,81,79,28,12,8,208,不合格
20175303,68,59,16,69,53,265,不合格
20175304,59,27,62,57,11,216,不合格
20175305,19,9,78,75,39,220,不合格
20175306,96,25,72,86,95,374,合格
20175307,48,44,18,19,56,185,不合格
20175308,19,36,67,79,34,235,不合格
20175309,98,2,17,58,99,274,不合格
20175310,90,59,69,32,57,307,合格
20175311,80,44,40,20,31,215,不合格
20175312,97,62,47,60,66,332,合格
20175313,85,48,71,81,92,377,合格
20175314,5,39,53,80,88,265,不合格
20175315,62,99,50,63,71,345,合格
20175316,54,56,72,10,49,241,不合格
20175317,18,76,7,10,55,166,不合格
20175318,33,18,27,3,67,148,不合格
20175319,91,42,82,48,4,267,不合格
20175320,70,63,61,57,43,294,不合格
20175321,94,63,6,62,77,302,合格
20175322,11,14,24,53,55,157,不合格
20175323,62,47,36,24,58,227,不合格
20175324,20,70,19,49,89,247,不合格
20175325,38,66,88,38,31,261,不合格
20175326,44,75,80,2,50,251,不合格
20175327,76,98,28,92,69,363,合格
20175328,21,50,21,1,40,133,不合格
20175329,96,38,25,27,43,229,不合格
20175330,36,70,38,4,27,175,不合格
20175331,62,41,95,61,63,322,合格
20175332,11,99,26,81,15,232,不合格
20175333,12,63,47,72,88,282,不合格
20175334,51,56,59,16,2,184,不合格
20175335,79,23,43,93,32,270,不合格
20175336,73,31,83,82,17,286,不合格
20175337,15,52,48,17,73,205,不合格
20175338,43,26,93,80,62,304,合格
20175339,75,77,60,0,11,223,不合格
20175340,20,29,85,17,70,221,不合格
20175341,70,86,87,49,58,350,合格
20175342,8,93,72,41,73,287,不合格
20175343,81,5,50,12,36,184,不合格
20175344,89,79,80,80,53,381,合格
20175345,5,45,51,84,62,247,不合格
20175346,86,86,42,54,81,349,合格
20175347,58,2,73,20,14,167,不合格
20175348,23,67,89,3,49,231,不合格
20175349,15,37,34,36,80,202,不合格
20175350,67,60,55,3,26,211,不合格
20175351,45,28,80,37,3,193,不合格
20175352,91,5,6,93,49,244,不合格
20175353,32,11,97,89,50,279,不合格
20175354,61,60,13,30,16,180,不合格
20175355,62,15,28,46,8,159,不合格
20175356,81,10,46,9,17,163,不合格
20175357,91,61,58,75,55,340,合格
20175358,56,98,30,96,36,316,合格
20175359,92,16,7,66,92,273,不合格
20175360,28,3,70,36,85,222,不合格
20175361,18,18,24,1,97,158,不合格
20175362,85,71,46,6,7,215,不合格
20175363,85,27,71,37,27,247,不合格
20175364,24,10,13,54,67,168,不合格
20175365,21,43,51,99,29,243,不合格
20175366,80,84,28,56,85,333,合格
20175367,26,27,0,35,98,186,不合格
20175368,6,4,80,5,34,129,不合格
20175369,69,57,56,78,69,329,合格
20175370,30,88,46,21,19,204,不合格
20175371,70,64,61,93,5,293,不合格
20175372,61,91,61,99,63,375,合格
20175373,81,92,2,70,65,310,合格
20175374,30,98,18,4,45,195,不合格
20175375,73,31,93,51,18,266,不合格
20175376,92,86,75,91,68,412,合格
20175377,99,21,90,37,53,300,合格
20175378,3,89,82,13,25,212,不合格
20175379,55,11,0,64,27,157,不合格
20175380,77,9,8,55,25,174,不合格
20175381,76,97,15,23,96,307,合格
20175382,20,79,29,79,49,256,不合格
20175383,54,62,3,94,95,308,合格
20175384,37,78,89,34,5,243,不合格
20175385,34,31,89,27,74,255,不合格
20175386,96,83,19,51,88,337,合格
20175387,53,79,23,84,29,268,不合格
20175388,62,10,3,44,41,160,不合格
20175389,96,1,7,82,7,193,不合格
20175390,25,27,35,70,15,172,不合格
20175391,3,53,29,23,27,135,不合格
20175392,40,8,7,91,68,214,不合格
20175393,39,63,60,2,81,245,不合格
20175394,61,17,19,94,20,211,不合格
20175395,47,84,15,37,64,247,不合格
20175396,18,52,16,71,44,201,不合格
20175397,49,78,0,42,78,247,不合格
20175398,24,29,98,55,29,235,不合格
20175399,75,71,47,94,87,374,合格
20175400,98,15,71,71,94,349,合格
20175401,29,69,45,88,91,322,合格
20175402,98,85,79,64,50,376,合格
20175403,8,77,42,26,47,200,不合格
20175404,24,22,69,41,57,213,不合格
20175405,75,21,89,85,57,327,合格
20175406,93,37,6,11,51,198,不合格
20175407,98,45,30,25,67,265,不合格
20175408,64,87,17,78,59,305,合格
20175409,44,4,54,11,31,144,不合格
20175410,95,84,33,34,26,272,不合格
20175411,9,85,69,60,63,286,不合格
20175412,20,57,42,26,77,222,不合格
20175413,32,29,42,96,12,211,不合格
20175414,0,63,17,52,5,137,不合格
20175415,11,99,28,19,8,165,不合格
20175416,10,47,33,23,96,209,不合格
20175417,77,62,53,3,94,289,不合格
20175418,57,73,61,10,2,203,不合格
20175419,57,33,66,13,69,238,不合格
20175420,70,38,43,69,55,275,不合格
20175421,3,19,95,74,57,248,不合格
20175422,38,85,77,78,77,355,合格
20175423,80,3,22,28,29,162,不合格
20175424,88,2,0,1,55,146,不合格
20175425,81,44,14,18,27,184,不合格
20175426,59,8,69,58,9,203,不合格
20175427,14,9,3,55,35,116,不合格
20175428,2,79,14,90,51,236,不合格
20175429,95,97,74,15,65,346,合格
20175430,11,98,86,50,73,318,合格
20175431,79,10,91,9,63,252,不合格
20175432,32,18,21,35,28,134,不合格
20175433,98,17,9,75,21,220,不合格
20175434,10,13,66,79,86,254,不合格
20175435,57,19,38,62,26,202,不合格
20175436,47,80,14,4,90,235,不合格
20175437,14,91,65,61,44,275,不合格
20175438,71,75,20,16,42,224,不合格
20175439,17,57,34,85,46,239,不合格
20175440,59,99,96,23,98,375,合格
20175441,93,44,28,51,4,220,不合格
20175442,48,62,23,2,88,223,不合格
20175443,39,11,46,72,21,189,不合格
20175444,98,48,71,95,60,372,合格
20175445,75,74,42,64,59,314,合格
20175446,67,38,87,12,78,282,不合格
20175447,63,29,12,47,18,169,不合格
20175448,74,59,84,77,29,323,合格
20175449,93,55,98,55,81,382,合格
20175450,71,62,94,56,76,359,合格
20175451,11,11,34,47,79,182,不合格
20175452,41,36,36,68,22,203,不合格
20175453,17,89,85,3,32,226,不合格
20175454,60,86,41,62,63,312,合格
20175455,27,89,5,32,16,169,不合格
20175456,87,3,52,27,64,233,不合格
20175457,19,67,51,65,1,203,不合格
20175458,24,7,92,70,83,276,不合格
20175459,51,60,36,67,45,259,不合格
20175460,55,97,78,11,27,268,不合格
20175461,88,92,25,73,94,372,合格
20175462,9,17,72,47,55,200,不合格
20175463,79,21,96,23,44,263,不合格
20175464,8,99,38,52,54,251,不合格
20175465,4,28,45,52,91,220,不合格
20175466,68,67,35,24,53,247,不合格
20175467,97,70,81,97,64,409,合格
20175468,64,30,84,85,29,292,不合格
20175469,73,14,2,74,43,206,不合格
20175470,93,72,89,28,55,337,合格
20175471,32,39,9,8,90,178,不合格
20175472,5,36,90,33,5,169,不合格
20175473,11,19,83,16,18,147,不合格
20175474,22,92,49,13,93,269,不合格
20175475,82,33,28,72,26,241,不合格
20175476,33,89,34,19,9,184,不合格
20175477,10,4,94,79,58,245,不合格
20175478,2,58,97,24,99,280,不合格
20175479,9,18,55,4,54,140,不合格
20175480,18,83,15,44,62,222,不合格
20175481,47,35,35,72,79,268,不合格
20175482,34,48,69,67,63,281,不合格
20175483,39,37,67,89,7,239,不合格
20175484,93,5,76,64,79,317,合格
20175485,73,39,14,11,37,174,不合格
20175486,28,29,89,29,14,189,不合格
20175487,23,17,49,51,85,225,不合格
20175488,44,35,11,61,77,228,不合格
20175489,7,46,95,64,0,212,不合格
20175490,88,15,35,43,53,234,不合格
20175491,96,69,96,4,64,329,合格
20175492,96,6,35,38,40,215,不合格
20175493,77,48,10,18,50,203,不合格
20175494,84,20,44,32,50,230,不合格
20175495,79,23,3,52,31,188,不合格
20175496,32,54,4,56,37,183,不合格
20175497,30,93,58,24,86,291,不合格
20175498,53,83,61,38,17,252,不合格
20175499,62,66,73,6,77,284,不合格
20175500,73,78,12,61,13,237,不合格
