ID,国語,数学,英語,理科,社会,合計,判定
20180001,60,92,67,31,15,265,不合格
20180002,76,48,46,30,19,219,不合格
20180003,38,30,75,44,77,264,不合格
20180004,84,59,0,47,1,191,不合格
20180005,47,94,23,38,40,242,不合格
20180006,54,58,64,15,46,237,不合格
20180007,29,96,27,68,85,305,合格
20180008,34,18,52,64,0,168,不合格
20180009,88,45,99,29,41,302,合格
20180010,19,56,75,71,94,315,合格
20180011,68,16,63,6,32,185,不合格
20180012,35,4,88,57,89,273,不合格
20180013,36,88,1,41,15,181,不合格
20180014,64,35,31,74,33,237,不合格
20180015,1,14,94,48,53,210,不合格
20180016,30,21,15,6,99,171,不合格
20180017,90,48,48,47,88,321,合格
20180018,47,6,97,5,52,207,不合格
20180019,1,99,54,45,21,220,不合格
20180020,85,19,37,26,75,242,不合格
20180021,2,90,75,74,14,255,不合格
20180022,8,76,83,45,43,255,不合格
20180023,30,12,98,91,24,255,不合格
20180024,22,89,7,47,14,179,不合格
20180025,31,23,9,7,84,154,不合格
20180026,93,26,92,70,57,338,合格
20180027,66,43,75,60,29,273,不合格
20180028,30,61,80,45,45,261,不合格
20180029,79,55,86,98,42,360,合格
20180030,99,84,91,95,38,407,合格
20180031,31,91,91,80,75,368,合格
20180032,13,21,45,97,78,254,不合格
20180033,29,96,42,6,11,184,不合格
20180034,4,73,60,40,54,231,不合格
20180035,1,3,7,50,91,152,不合格
20180036,63,45,32,63,38,241,不合格
20180037,7,63,73,84,99,326,合格
20180038,81,89,78,36,60,344,合格
20180039,21,93,95,60,89,358,合格
20180040,56,16,15,92,88,267,不合格
20180041,46,23,33,56,40,198,不合格
20180042,24,25,35,18,46,148,不合格
20180043,58,78,27,68,96,327,合格
20180044,56,84,73,78,39,330,合格
20180045,83,25,40,60,1,209,不合格
20180046,70,10,45,16,60,201,不合格
20180047,42,86,63,5,14,210,不合格
20180048,25,56,51,72,90,294,不合格
20180049,88,14,41,60,79,282,不合格
20180050,75,48,5,17,28,173,不合格
20180051,64,53,48,40,99,304,合格
20180052,93,60,95,7,58,313,合格
20180053,32,67,28,10,22,159,不合格
20180054,23,56,90,51,15,235,不合格
20180055,65,58,78,27,76,304,合格
20180056,8,42,63,97,97,307,合格
20180057,86,57,37,1,75,256,不合格
20180058,90,33,9,84,66,282,不合格
20180059,54,61,52,20,2,189,不合格
20180060,32,4,24,42,63,165,不合格
20180061,70,5,20,5,91,191,不合格
20180062,95,42,53,57,88,335,合格
20180063,30,81,11,47,38,207,不合格
20180064,35,31,32,16,17,131,不合格
20180065,96,94,97,78,81,446,合格
20180066,28,24,43,91,53,239,不合格
20180067,54,60,15,33,59,221,不合格
20180068,77,6,84,74,97,338,合格
20180069,5,25,82,88,15,215,不合格
20180070,73,94,11,62,31,271,不合格
20180071,5,67,22,76,99,269,不合格
20180072,72,18,49,80,45,264,不合格
20180073,19,96,78,72,80,345,合格
20180074,93,60,44,62,44,303,合格
20180075,6,19,87,61,42,215,不合格
20180076,81,98,16,6,69,270,不合格
20180077,48,29,41,67,38,223,不合格
20180078,11,99,44,30,41,225,不合格
20180079,53,59,24,97,73,306,合格
20180080,9,55,72,8,28,172,不合格
20180081,71,29,10,63,6,179,不合格
20180082,13,38,40,48,10,149,不合格
20180083,71,24,31,6,40,172,不合格
20180084,53,8,47,81,48,237,不合格
20180085,95,53,37,19,91,295,不合格
20180086,41,21,77,17,39,195,不合格
20180087,88,34,9,96,39,266,不合格
20180088,38,92,13,25,10,178,不合格
20180089,4,66,32,68,16,186,不合格
20180090,9,82,57,9,38,195,不合格
20180091,48,21,92,59,59,279,不合格
20180092,83,58,65,67,44,317,合格
20180093,26,9,69,65,10,179,不合格
20180094,66,11,45,92,78,292,不合格
20180095,83,56,39,34,63,275,不合格
20180096,84,17,20,55,14,190,不合格
20180097,50,74,47,69,94,334,合格
20180098,74,50,94,36,31,285,不合格
20180099,16,0,69,48,89,222,不合格
20180100,22,95,46,92,97,352,合格
20180101,48,78,56,35,39,256,不合格
20180102,21,36,65,8,15,145,不合格
20180103,1,82,94,48,66,291,不合格
20180104,89,21,57,60,98,325,合格
20180105,77,56,79,58,95,365,合格
20180106,8,55,53,9,78,203,不合格
20180107,56,4,71,95,26,252,不合格
20180108,38,94,79,19,33,263,不合格
20180109,19,44,6,45,12,126,不合格
20180110,80,76,35,57,24,272,不合格
20180111,5,54,50,79,47,235,不合格
20180112,29,99,26,17,36,207,不合格
20180113,90,87,44,36,50,307,合格
20180114,96,92,6,73,44,311,合格
20180115,75,39,93,50,1,258,不合格
20180116,44,12,63,92,9,220,不合格
20180117,3,82,71,25,2,183,不合格
20180118,82,95,55,32,84,348,合格
20180119,34,36,60,6,14,150,不合格
20180120,57,8,18,35,93,211,不合格
20180121,55,22,11,74,57,219,不合格
20180122,87,0,52,47,2,188,不合格
20180123,94,49,84,97,92,416,合格
20180124,39,70,15,37,18,179,不合格
20180125,82,46,12,61,52,253,不合格
20180126,6,14,44,61,90,215,不合格
20180127,15,27,35,7,15,99,不合格
20180128,19,13,8,10,16,66,不合格
20180129,63,87,63,42,63,318,合格
20180130,22,46,82,62,90,302,合格
20180131,2,3,87,16,46,154,不合格
20180132,76,63,45,26,60,270,不合格
20180133,82,29,88,20,67,286,不合格
20180134,17,90,91,66,96,360,合格
20180135,86,56,5,47,54,248,不合格
20180136,70,40,62,88,61,321,合格
20180137,1,94,40,0,37,172,不合格
20180138,54,98,45,30,8,235,不合格
20180139,23,74,1,78,90,266,不合格
20180140,42,31,63,51,79,266,不合格
20180141,84,43,36,94,98,355,合格
20180142,85,37,44,75,83,324,合格
20180143,46,69,18,20,70,223,不合格
20180144,95,71,12,36,31,245,不合格
20180145,88,23,52,70,69,302,合格
20180146,52,3,53,45,85,238,不合格
20180147,26,81,64,73,38,282,不合格
20180148,63,22,75,77,67,304,合格
20180149,44,54,31,70,54,253,不合格
20180150,64,50,29,20,70,233,不合格
20180151,90,88,14,33,29,254,不合格
20180152,18,41,11,91,83,244,不合格
20180153,56,77,95,50,78,356,合格
20180154,38,92,21,80,33,264,不合格
20180155,5,58,88,54,55,260,不合格
20180156,4,26,17,83,42,172,不合格
20180157,19,90,85,60,22,276,不合格
20180158,77,89,62,23,54,305,合格
20180159,14,11,90,69,78,262,不合格
20180160,24,56,81,45,77,283,不合格
20180161,32,96,16,82,13,239,不合格
20180162,64,88,5,27,95,279,不合格
20180163,3,17,88,23,25,156,不合格
20180164,56,42,22,1,66,187,不合格
20180165,80,41,90,96,33,340,合格
20180166,37,64,74,12,22,209,不合格
20180167,58,56,67,55,87,323,合格
20180168,89,62,1,77,84,313,合格
20180169,44,53,43,96,57,293,不合格
20180170,2,25,6,95,22,150,不合格
20180171,69,3,20,60,92,244,不合格
20180172,22,26,39,83,74,244,不合格
20180173,88,6,30,25,86,235,不合格
20180174,44,85,8,16,47,200,不合格
20180175,38,96,89,43,47,313,合格
20180176,44,7,7,32,1,91,不合格
20180177,38,94,42,15,93,282,不合格
20180178,82,18,28,83,68,279,不合格
20180179,52,88,11,71,27,249,不合格
20180180,29,12,5,17,85,148,不合格
20180181,49,24,51,4,11,139,不合格
20180182,81,95,92,65,13,346,合格
20180183,17,16,79,6,58,176,不合格
20180184,71,36,95,57,14,273,不合格
20180185,45,86,23,53,33,240,不合格
20180186,71,30,95,5,74,275,不合格
20180187,75,17,53,15,8,168,不合格
20180188,13,9,4,74,91,191,不合格
20180189,74,26,38,50,39,227,不合格
20180190,56,56,19,12,51,194,不合格
20180191,31,78,77,24,60,270,不合格
20180192,86,82,45,94,29,336,合格
20180193,0,55,10,58,91,214,不合格
20180194,60,68,24,21,8,181,不合格
20180195,36,17,28,90,54,225,不合格
20180196,8,16,68,32,7,131,不合格
20180197,59,5,30,89,46,229,不合格
20180198,42,29,28,65,76,240,不合格
20180199,9,69,5,33,10,126,不合格
20180200,26,56,27,26,10,145,不合格
20180201,90,32,95,65,21,303,合格
20180202,6,22,71,61,40,200,不合格
20180203,13,62,48,91,31,245,不合格
20180204,45,12,44,41,67,209,不合格
20180205,82,72,75,78,93,400,合格
20180206,69,70,37,33,8,217,不合格
20180207,79,41,48,56,63,287,不合格
20180208,97,27,65,81,17,287,不合格
20180209,30,77,39,51,39,236,不合格
20180210,42,39,80,86,35,282,不合格
20180211,2,10,73,91,53,229,不合格
20180212,98,84,17,54,62,315,合格
20180213,65,73,30,78,88,334,合格
20180214,85,3,20,29,57,194,不合格
20180215,78,24,81,70,41,294,不合格
20180216,15,14,87,70,7,193,不合格
20180217,78,47,36,22,15,198,不合格
20180218,31,33,13,3,14,94,不合格
20180219,26,74,52,61,71,284,不合格
20180220,49,67,2,53,40,211,不合格
20180221,22,70,4,38,2,136,不合格
20180222,27,19,1,5,30,82,不合格
20180223,52,65,95,3,33,248,不合格
20180224,70,49,28,48,42,237,不合格
20180225,65,74,52,67,2,260,不合格
20180226,46,95,23,88,66,318,合格
20180227,24,73,18,99,71,285,不合格
20180228,69,51,12,27,34,193,不合格
20180229,14,40,92,31,47,224,不合格
20180230,11,2,11,50,87,161,不合格
20180231,56,30,81,76,82,325,合格
20180232,29,41,36,1,34,141,不合格
20180233,78,53,43,5,83,262,不合格
20180234,38,0,90,3,2,133,不合格
20180235,76,8,60,35,14,193,不合格
20180236,49,98,39,75,7,268,不合格
20180237,94,5,77,18,84,278,不合格
20180238,59,0,45,65,91,260,不合格
20180239,89,74,54,9,96,322,合格
20180240,34,57,58,40,53,242,不合格
20180241,47,71,83,26,59,286,不合格
20180242,56,64,3,38,42,203,不合格
20180243,39,47,40,20,93,239,不合格
20180244,37,89,13,7,4,150,不合格
20180245,95,85,58,7,40,285,不合格
20180246,14,80,36,68,27,225,不合格
20180247,15,58,10,50,99,232,不合格
20180248,69,40,56,65,22,252,不合格
20180249,36,56,20,66,79,257,不合格
20180250,65,2,20,26,48,161,不合格
20180251,5,41,54,64,7,171,不合格
20180252,26,69,61,99,3,258,不合格
20180253,62,34,20,7,22,145,不合格
20180254,82,49,51,8,44,234,不合格
20180255,60,90,50,93,76,369,合格
20180256,75,95,59,37,94,360,合格
20180257,95,25,73,61,19,273,不合格
20180258,37,63,60,51,82,293,不合格
20180259,95,67,71,24,7,264,不合格
20180260,73,62,61,89,89,374,合格
20180261,10,97,6,58,9,180,不合格
20180262,21,75,7,40,26,169,不合格
20180263,17,64,64,70,38,253,不合格
20180264,33,68,17,99,58,275,不合格
20180265,41,60,59,17,42,219,不合格
20180266,10,97,59,91,12,269,不合格
20180267,56,58,29,14,61,218,不合格
20180268,19,6,26,61,88,200,不合格
20180269,23,9,62,96,71,261,不合格
20180270,71,88,32,51,75,317,合格
20180271,8,14,26,85,5,138,不合格
20180272,10,8,22,11,28,79,不合格
20180273,62,29,13,88,41,233,不合格
20180274,91,82,53,2,18,246,不合格
20180275,77,31,31,84,77,300,合格
20180276,36,93,39,98,76,342,合格
20180277,6,91,11,65,37,210,不合格
20180278,57,75,61,87,95,375,合格
20180279,34,81,55,81,44,295,不合格
20180280,48,83,91,4,99,325,合格
20180281,3,3,69,91,41,207,不合格
20180282,51,91,68,64,1,275,不合格
20180283,13,42,13,82,62,212,不合格
20180284,59,26,88,78,97,348,合格
20180285,36,45,0,66,14,161,不合格
20180286,58,64,67,53,76,318,合格
20180287,81,92,84,82,12,351,合格
20180288,79,23,77,9,94,282,不合格
20180289,27,20,3,25,44,119,不合格
20180290,61,62,0,83,26,232,不合格
20180291,71,50,65,10,3,199,不合格
20180292,6,87,3,95,88,279,不合格
20180293,59,47,68,97,80,351,合格
20180294,14,80,28,42,47,211,不合格
20180295,51,74,74,22,97,318,合格
20180296,21,83,49,47,83,283,不合格
20180297,46,4,90,6,26,172,不合格
20180298,68,2,50,40,63,223,不合格
20180299,82,11,39,14,82,228,不合格
20180300,81,37,97,13,5,233,不合格
20180301,88,9,50,27,88,262,不合格
20180302,37,70,3,48,69,227,不合格
20180303,3,16,64,94,72,249,不合格
20180304,22,92,28,61,19,222,不合格
20180305,27,27,24,78,74,230,不合格
20180306,47,23,86,10,87,253,不合格
20180307,92,89,98,49,67,395,合格
20180308,50,97,28,87,55,317,合格
20180309,27,6,18,78,56,185,不合格
20180310,23,62,54,1,33,173,不合格
20180311,71,80,57,15,99,322,合格
20180312,6,21,73,36,40,176,不合格
20180313,17,95,37,63,88,300,合格
20180314,74,67,62,18,42,263,不合格
20180315,22,83,51,96,70,322,合格
20180316,94,98,69,87,13,361,合格
20180317,80,88,38,89,1,296,不合格
20180318,87,71,99,43,13,313,合格
20180319,84,65,66,69,39,323,合格
20180320,7,75,74,52,23,231,不合格
20180321,20,53,85,8,81,247,不合格
20180322,38,50,91,16,12,207,不合格
20180323,61,44,36,44,87,272,不合格
20180324,24,62,94,82,70,332,合格
20180325,77,38,89,63,58,325,合格
20180326,47,75,40,48,43,253,不合格
20180327,7,16,68,75,10,176,不合格
20180328,43,51,52,90,5,241,不合格
20180329,33,30,93,0,55,211,不合格
20180330,25,5,64,12,11,117,不合格
20180331,5,79,40,76,67,267,不合格
20180332,12,97,67,99,99,374,合格
20180333,85,59,1,59,76,280,不合格
20180334,35,8,14,33,58,148,不合格
20180335,0,91,15,25,90,221,不合格
20180336,41,27,49,27,73,217,不合格
20180337,64,39,29,95,40,267,不合格
20180338,72,48,33,43,32,228,不合格
20180339,25,75,10,1,71,182,不合格
20180340,2,5,64,22,89,182,不合格
20180341,4,38,87,81,47,257,不合格
20180342,27,95,52,34,64,272,不合格
20180343,57,48,10,77,88,280,不合格
20180344,9,81,28,15,21,154,不合格
20180345,97,46,60,20,19,242,不合格
20180346,68,38,42,41,54,243,不合格
20180347,64,75,17,97,65,318,合格
20180348,53,12,38,55,95,253,不合格
20180349,4,88,47,26,62,227,不合格
20180350,77,86,17,40,74,294,不合格
20180351,78,22,21,90,65,276,不合格
20180352,46,70,68,10,79,273,不合格
20180353,49,10,2,72,73,206,不合格
20180354,98,4,94,19,13,228,不合格
20180355,99,52,13,9,3,176,不合格
20180356,87,31,3,32,94,247,不合格
20180357,3,15,64,4,47,133,不合格
20180358,82,0,72,61,99,314,合格
20180359,58,83,21,68,54,284,不合格
20180360,76,51,99,48,64,338,合格
20180361,29,76,4,35,19,163,不合格
20180362,95,62,93,86,78,414,合格
20180363,69,97,22,32,16,236,不合格
20180364,17,33,36,94,88,268,不合格
20180365,53,20,16,94,88,271,不合格
20180366,60,0,23,35,72,190,不合格
20180367,81,25,63,57,37,263,不合格
20180368,35,98,14,73,6,226,不合格
20180369,28,88,45,12,29,202,不合格
20180370,22,67,38,11,25,163,不合格
20180371,0,38,97,96,12,243,不合格
20180372,50,41,45,11,27,174,不合格
20180373,71,7,84,31,44,237,不合格
20180374,23,71,0,82,99,275,不合格
20180375,9,77,8,56,10,160,不合格
20180376,28,62,41,67,84,282,不合格
20180377,37,59,64,42,98,300,合格
20180378,53,99,1,45,46,244,不合格
20180379,55,63,39,45,86,288,不合格
20180380,70,82,82,45,40,319,合格
20180381,42,90,68,17,40,257,不合格
20180382,77,55,11,63,35,241,不合格
20180383,46,34,59,93,0,232,不合格
20180384,2,73,79,61,69,284,不合格
20180385,91,94,13,8,24,230,不合格
20180386,84,9,73,84,84,334,合格
20180387,69,68,8,6,44,195,不合格
20180388,39,9,12,28,26,114,不合格
20180389,71,68,64,70,32,305,合格
20180390,36,80,71,84,42,313,合格
20180391,72,67,69,65,35,308,合格
20180392,76,1,79,72,17,245,不合格
20180393,40,16,68,9,25,158,不合格
20180394,35,72,1,98,20,226,不合格
20180395,3,79,33,36,28,179,不合格
20180396,93,60,10,37,45,245,不合格
20180397,49,68,32,50,66,265,不合格
20180398,39,25,3,42,56,165,不合格
20180399,88,47,51,33,27,246,不合格
20180400,50,85,17,92,60,304,合格
20180401,63,7,71,9,17,167,不合格
20180402,69,1,70,18,66,224,不合格
20180403,79,43,24,70,85,301,合格
20180404,26,56,28,1,84,195,不合格
20180405,13,63,44,79,8,207,不合格
20180406,41,11,41,32,45,170,不合格
20180407,75,62,42,23,59,261,不合格
20180408,11,42,74,54,30,211,不合格
20180409,22,79,1,80,41,223,不合格
20180410,71,64,70,84,57,346,合格
20180411,82,54,79,71,67,353,合格
20180412,16,92,70,83,81,342,合格
20180413,74,78,70,49,64,335,合格
20180414,12,36,72,3,1,124,不合格
20180415,52,67,81,32,42,274,不合格
20180416,30,88,52,92,42,304,合格
20180417,17,75,5,8,74,179,不合格
20180418,19,97,1,56,24,197,不合格
20180419,24,95,29,80,87,315,合格
20180420,0,21,54,75,6,156,不合格
20180421,49,99,83,23,75,329,合格
20180422,1,63,27,30,44,165,不合格
20180423,80,71,14,74,77,316,合格
20180424,14,89,24,5,13,145,不合格
20180425,96,15,28,69,10,218,不合格
20180426,99,1,50,0,18,168,不合格
20180427,7,9,65,69,16,166,不合格
20180428,47,16,53,19,2,137,不合格
20180429,83,81,24,31,84,303,合格
20180430,31,3,53,99,6,192,不合格
20180431,23,52,64,13,75,227,不合格
20180432,91,56,44,56,92,339,合格
20180433,97,92,55,22,22,288,不合格
20180434,60,1,30,70,24,185,不合格
20180435,12,4,81,68,31,196,不合格
20180436,4,22,53,25,81,185,不合格
20180437,75,56,49,38,13,231,不合格
20180438,51,67,65,17,97,297,不合格
20180439,86,73,75,48,8,290,不合格
20180440,74,92,45,1,83,295,不合格
20180441,43,44,71,63,84,305,合格
20180442,90,93,65,0,31,279,不合格
20180443,57,7,55,95,56,270,不合格
20180444,59,52,43,61,60,275,不合格
20180445,1,61,88,30,37,217,不合格
20180446,62,3,92,63,63,283,不合格
20180447,0,77,87,2,8,174,不合格
20180448,86,38,51,85,49,309,合格
20180449,16,34,61,26,25,162,不合格
20180450,72,1,62,98,67,300,合格
20180451,96,47,22,9,40,214,不合格
20180452,55,19,56,36,87,253,不合格
20180453,89,59,60,9,97,314,合格
20180454,96,36,64,42,73,311,合格
20180455,28,6,92,16,15,157,不合格
20180456,95,28,64,51,82,320,合格
20180457,53,47,5,9,53,167,不合格
20180458,16,33,29,98,2,178,不合格
20180459,23,61,12,60,11,167,不合格
20180460,30,68,61,65,30,254,不合格
20180461,13,97,52,30,94,286,不合格
20180462,2,41,8,98,86,235,不合格
20180463,31,63,58,37,99,288,不合格
20180464,37,74,61,80,93,345,合格
20180465,74,12,87,95,14,282,不合格
20180466,21,38,54,1,92,206,不合格
20180467,85,29,93,78,23,308,合格
20180468,48,36,19,26,43,172,不合格
20180469,74,89,2,74,68,307,合格
20180470,49,91,37,19,50,246,不合格
20180471,63,31,66,45,43,248,不合格
20180472,45,97,41,8,9,200,不合格
20180473,99,58,11,97,85,350,合格
20180474,67,81,63,52,52,315,合格
20180475,32,3,80,95,14,224,不合格
20180476,2,77,89,57,58,283,不合格
20180477,29,74,23,30,54,210,不合格
20180478,35,37,46,76,28,222,不合格
20180479,87,19,71,63,17,257,不合格
20180480,62,94,76,12,30,274,不合格
20180481,65,28,63,65,58,279,不合格
20180482,48,28,18,13,63,170,不合格
20180483,92,98,33,48,88,359,合格
20180484,10,75,44,66,89,284,不合格
20180485,93,37,12,92,90,324,合格
20180486,77,86,54,98,88,403,合格
20180487,81,28,36,23,58,226,不合格
20180488,27,13,83,30,15,168,不合格
20180489,49,40,68,89,71,317,合格
20180490,54,55,21,66,1,197,不合格
20180491,20,27,70,26,40,183,不合格
20180492,36,20,71,70,15,212,不合格
20180493,85,15,44,37,31,212,不合格
20180494,97,53,12,21,32,215,不合格
20180495,35,56,44,42,38,215,不合格
20180496,37,53,10,55,79,234,不合格
20180497,45,61,2,52,50,210,不合格
20180498,29,87,86,48,76,326,合格
20180499,31,41,68,52,50,242,不合格
20180500,99,18,11,98,80,306,合格
20180501,93,98,19,46,56,312,合格
20180502,40,95,24,1,69,229,不合格
20180503,78,52,2,1,81,214,不合格
20180504,21,15,47,79,56,218,不合格
20180505,67,29,12,3,25,136,不合格
20180506,83,11,17,10,41,162,不合格
20180507,9,60,11,77,17,174,不合格
20180508,89,10,40,66,96,301,合格
20180509,15,22,56,13,20,126,不合格
20180510,98,81,55,69,11,314,合格
20180511,53,93,75,76,2,299,不合格
20180512,32,99,54,36,75,296,不合格
20180513,20,11,82,82,53,248,不合格
20180514,4,57,70,65,57,253,不合格
20180515,72,90,72,13,52,299,不合格
20180516,63,20,66,93,34,276,不合格
20180517,43,4,65,7,79,198,不合格
20180518,1,94,35,93,66,289,不合格
20180519,33,91,26,70,5,225,不合格
20180520,56,75,73,80,15,299,不合格
20180521,94,27,84,29,41,275,不合格
20180522,98,31,16,31,37,213,不合格
20180523,90,47,81,57,65,340,合格
20180524,69,27,78,46,61,281,不合格
20180525,0,61,79,39,27,206,不合格
20180526,16,88,6,18,32,160,不合格
20180527,46,14,63,49,89,261,不合格
20180528,91,84,48,46,50,319,合格
20180529,43,8,59,69,31,210,不合格
20180530,94,93,63,86,22,358,合格
20180531,11,62,45,19,84,221,不合格
20180532,67,22,6,73,49,217,不合格
20180533,68,95,70,60,98,391,合格
20180534,97,48,11,69,28,253,不合格
20180535,6,0,47,67,59,179,不合格
20180536,94,37,99,14,54,298,不合格
20180537,94,4,58,73,71,300,合格
20180538,96,88,4,19,85,292,不合格
20180539,14,30,92,94,28,258,不合格
20180540,33,12,78,83,89,295,不合格
20180541,75,80,68,70,37,330,合格
20180542,48,11,29,47,64,199,不合格
20180543,7,67,38,12,78,202,不合格
20180544,15,46,73,49,80,263,不合格
20180545,8,24,52,25,94,203,不合格
20180546,99,40,31,45,29,244,不合格
20180547,93,92,16,88,97,386,合格
20180548,61,57,24,97,44,283,不合格
20180549,90,8,23,42,77,240,不合格
20180550,12,52,74,6,88,232,不合格
20180551,84,11,65,46,28,234,不合格
20180552,62,39,40,51,60,252,不合格
20180553,0,22,82,88,65,257,不合格
20180554,90,88,4,54,80,316,合格
20180555,63,41,88,69,53,314,合格
20180556,84,55,61,59,0,259,不合格
20180557,29,45,81,43,32,230,不合格
20180558,85,64,92,38,42,321,合格
20180559,59,34,89,13,35,230,不合格
20180560,72,92,30,16,6,216,不合格
20180561,20,6,70,8,19,123,不合格
20180562,61,3,33,54,12,163,不合格
20180563,15,33,52,78,56,234,不合格
20180564,81,32,89,79,55,336,合格
20180565,56,6,42,42,1,147,不合格
20180566,19,16,24,30,20,109,不合格
20180567,44,90,51,99,3,287,不合格
20180568,60,66,94,3,16,239,不合格
20180569,47,89,55,19,10,220,不合格
20180570,75,14,91,6,75,261,不合格
20180571,6,79,97,62,57,301,合格
20180572,36,81,61,52,46,276,不合格
20180573,57,57,16,94,69,293,不合格
20180574,31,54,60,28,28,201,不合格
20180575,93,12,81,99,31,316,合格
20180576,72,66,7,4,54,203,不合格
20180577,73,51,25,94,10,253,不合格
20180578,84,35,42,14,91,266,不合格
20180579,12,61,21,24,11,129,不合格
20180580,43,55,13,25,40,176,不合格
20180581,95,11,2,2,68,178,不合格
20180582,21,59,79,67,79,305,合格
20180583,69,29,99,58,16,271,不合格
20180584,95,15,71,26,88,295,不合格
20180585,58,7,78,34,29,206,不合格
20180586,25,95,83,67,87,357,合格
20180587,1,20,74,83,35,213,不合格
20180588,83,89,31,24,44,271,不合格
20180589,77,73,71,26,80,327,合格
20180590,37,68,83,83,45,316,合格
20180591,46,14,35,10,75,180,不合格
20180592,86,92,42,45,94,359,合格
20180593,10,70,0,65,99,244,不合格
20180594,53,60,25,88,39,265,不合格
20180595,3,11,57,6,35,112,不合格
20180596,76,2,61,42,82,263,不合格
20180597,79,63,61,43,26,272,不合格
20180598,40,26,77,41,14,198,不合格
20180599,56,77,3,65,63,264,不合格
20180600,51,97,38,24,28,238,不合格
20180601,68,35,99,63,28,293,不合格
20180602,48,1,63,82,63,257,不合格
20180603,53,12,6,33,0,104,不合格
20180604,55,52,51,63,64,285,不合格
20180605,81,59,32,72,79,323,合格
20180606,98,34,25,72,64,293,不合格
20180607,64,10,86,99,4,263,不合格
20180608,99,21,6,7,95,228,不合格
20180609,40,51,39,40,19,189,不合格
20180610,4,35,96,99,12,246,不合格
20180611,11,35,52,16,30,144,不合格
20180612,45,70,39,47,63,264,不合格
20180613,59,58,21,93,90,321,合格
20180614,49,54,40,95,85,323,合格
20180615,8,4,25,59,64,160,不合格
20180616,0,36,23,69,43,171,不合格
20180617,24,39,95,84,28,270,不合格
20180618,55,99,65,55,58,332,合格
20180619,24,81,3,24,33,165,不合格
20180620,88,75,85,47,55,350,合格
20180621,54,30,71,41,19,215,不合格
20180622,82,23,48,85,43,281,不合格
20180623,5,46,13,25,91,180,不合格
20180624,55,50,19,84,65,273,不合格
20180625,8,80,55,22,33,198,不合格
20180626,10,83,19,68,81,261,不合格
20180627,89,6,20,99,7,221,不合格
20180628,90,32,85,69,39,315,合格
20180629,43,99,2,3,12,159,不合格
20180630,86,70,85,1,19,261,不合格
20180631,23,29,18,41,34,145,不合格
20180632,76,97,87,70,92,422,合格
20180633,37,64,32,83,68,284,不合格
20180634,28,44,40,25,40,177,不合格
20180635,67,38,38,27,13,183,不合格
20180636,45,0,58,81,42,226,不合格
20180637,16,33,60,88,89,286,不合格
20180638,39,13,2,15,36,105,不合格
20180639,45,0,4,6,56,111,不合格
20180640,83,94,7,23,20,227,不合格
20180641,16,13,76,56,94,255,不合格
20180642,8,72,12,5,74,171,不合格
20180643,77,66,81,44,14,282,不合格
20180644,97,31,40,89,54,311,合格
20180645,29,72,23,20,60,204,不合格
20180646,51,24,71,80,58,284,不合格
20180647,14,79,28,8,79,208,不合格
20180648,88,35,84,49,59,315,合格
20180649,84,51,2,37,79,253,不合格
20180650,2,90,47,93,36,268,不合格
20180651,31,27,5,25,43,131,不合格
20180652,88,90,20,92,75,365,合格
20180653,58,95,77,1,26,257,不合格
20180654,56,48,86,76,71,337,合格
20180655,21,48,22,69,8,168,不合格
20180656,77,91,51,95,39,353,合格
20180657,20,13,83,45,90,251,不合格
20180658,50,47,59,54,83,293,不合格
20180659,62,59,84,85,9,299,不合格
20180660,97,17,71,71,46,302,合格
20180661,38,47,80,10,2,177,不合格
20180662,53,0,71,39,48,211,不合格
20180663,22,21,76,21,37,177,不合格
20180664,40,92,97,64,28,321,合格
20180665,30,66,80,56,9,241,不合格
20180666,87,65,46,83,43,324,合格
20180667,19,84,91,91,65,350,合格
20180668,26,65,42,37,1,171,不合格
20180669,9,19,82,80,66,256,不合格
20180670,49,49,66,39,80,283,不合格
20180671,4,21,33,29,64,151,不合格
20180672,5,68,69,4,99,245,不合格
20180673,55,55,16,55,29,210,不合格
20180674,88,87,8,7,1,191,不合格
20180675,95,17,67,2,56,237,不合格
20180676,32,11,80,77,57,257,不合格
20180677,2,95,53,74,56,280,不合格
20180678,92,12,23,32,98,257,不合格
20180679,19,66,33,19,60,197,不合格
20180680,70,53,51,99,57,330,合格
20180681,6,40,98,80,97,321,合格
20180682,94,36,22,90,35,277,不合格
20180683,70,85,22,46,46,269,不合格
20180684,42,87,11,82,56,278,不合格
20180685,91,96,42,44,52,325,合格
20180686,58,20,26,56,71,231,不合格
20180687,88,33,2,87,65,275,不合格
20180688,11,65,1,37,1,115,不合格
20180689,96,72,82,19,2,271,不合格
20180690,32,91,70,71,9,273,不合格
20180691,80,47,77,32,22,258,不合格
20180692,34,1,71,60,56,222,不合格
20180693,25,68,65,18,23,199,不合格
20180694,88,40,19,86,23,256,不合格
20180695,4,8,49,41,69,171,不合格
20180696,46,52,3,85,15,201,不合格
20180697,10,13,28,80,69,200,不合格
20180698,81,52,81,73,83,370,合格
20180699,2,3,30,44,13,92,不合格
20180700,7,76,0,5,85,173,不合格
20180701,84,20,36,27,15,182,不合格
20180702,39,42,96,52,46,275,不合格
20180703,32,8,42,28,37,147,不合格
20180704,86,8,63,31,42,230,不合格
20180705,68,86,90,2,54,300,合格
20180706,47,61,14,98,97,317,合格
20180707,64,16,59,69,99,307,合格
20180708,70,54,13,59,24,220,不合格
20180709,38,45,5,83,57,228,不合格
20180710,87,26,0,46,58,217,不合格
20180711,7,61,57,30,65,220,不合格
20180712,99,64,54,78,19,314,合格
20180713,37,29,78,75,39,258,不合格
20180714,60,59,11,99,1,230,不合格
20180715,79,69,45,48,51,292,不合格
20180716,41,33,45,39,92,250,不合格
20180717,11,80,43,5,34,173,不合格
20180718,70,6,36,10,58,180,不合格
20180719,98,58,91,83,41,371,合格
20180720,17,36,9,84,57,203,不合格
20180721,58,50,38,93,58,297,不合格
20180722,38,67,10,45,19,179,不合格
20180723,97,86,42,97,24,346,合格
20180724,17,8,98,79,23,225,不合格
20180725,76,45,23,89,80,313,合格
20180726,42,52,8,74,64,240,不合格
20180727,29,25,73,99,86,312,合格
20180728,16,68,55,62,97,298,不合格
20180729,88,0,9,60,7,164,不合格
20180730,51,52,16,7,57,183,不合格
20180731,36,74,62,88,36,296,不合格
20180732,15,4,44,4,82,149,不合格
20180733,75,4,43,23,42,187,不合格
20180734,28,17,96,68,1,210,不合格
20180735,3,10,75,97,33,218,不合格
20180736,53,17,59,17,81,227,不合格
20180737,84,38,32,43,12,209,不合格
20180738,60,49,78,12,4,203,不合格
20180739,96,68,98,10,20,292,不合格
20180740,69,78,53,78,16,294,不合格
20180741,59,20,93,99,73,344,合格
20180742,91,8,28,46,29,202,不合格
20180743,80,75,74,66,4,299,不合格
20180744,56,1,46,86,6,195,不合格
20180745,28,88,54,50,70,290,不合格
20180746,19,91,39,76,51,276,不合格
20180747,61,19,81,88,38,287,不合格
20180748,37,7,5,19,85,153,不合格
20180749,90,24,67,18,68,267,不合格
20180750,33,96,78,4,6,217,不合格
20180751,8,57,83,90,39,277,不合格
20180752,79,73,15,16,25,208,不合格
20180753,92,2,95,62,73,324,合格
20180754,12,84,76,66,31,269,不合格
20180755,94,76,58,83,1,312,合格
20180756,87,89,0,9,16,201,不合格
20180757,86,92,98,19,79,374,合格
20180758,11,97,75,14,67,264,不合格
20180759,56,32,62,21,2,173,不合格
20180760,94,9,11,37,67,218,不合格
20180761,63,2,80,66,86,297,不合格
20180762,4,86,10,20,30,150,不合格
20180763,34,6,90,5,67,202,不合格
20180764,99,41,57,35,36,268,不合格
20180765,89,63,87,89,84,412,合格
20180766,6,99,56,23,44,228,不合格
20180767,79,66,11,84,68,308,合格
20180768,27,66,60,87,27,267,不合格
20180769,96,20,53,31,55,255,不合格
20180770,79,93,16,18,14,220,不合格
20180771,64,85,48,9,77,283,不合格
20180772,77,36,12,5,8,138,不合格
20180773,23,3,77,1,7,111,不合格
20180774,28,26,27,75,89,245,不合格
20180775,78,8,95,47,38,266,不合格
20180776,2,70,19,26,34,151,不合格
20180777,95,24,80,89,48,336,合格
20180778,16,81,51,93,40,281,不合格
20180779,22,61,83,4,93,263,不合格
20180780,99,13,32,16,38,198,不合格
20180781,43,38,76,97,38,292,不合格
20180782,23,41,39,18,47,168,不合格
20180783,90,77,70,6,35,278,不合格
20180784,78,57,52,30,77,294,不合格
20180785,79,30,97,48,55,309,合格
20180786,20,5,3,90,71,189,不合格
20180787,85,39,71,77,46,318,合格
20180788,2,85,5,95,46,233,不合格
20180789,22,13,7,42,70,154,不合格
20180790,99,26,73,36,87,321,合格
20180791,71,37,98,15,75,296,不合格
20180792,35,67,18,92,18,230,不合格
20180793,87,24,10,93,73,287,不合格
20180794,24,79,53,3,26,185,不合格
20180795,57,72,32,16,83,260,不合格
20180796,65,41,4,5,48,163,不合格
20180797,61,90,64,85,17,317,合格
20180798,7,68,55,65,36,231,不合格
20180799,80,48,80,48,22,278,不合格
20180800,90,93,29,40,66,318,合格
20180801,4,11,35,70,30,150,不合格
20180802,66,80,68,65,25,304,合格
20180803,47,83,39,40,33,242,不合格
20180804,75,56,39,69,29,268,不合格
20180805,37,80,14,47,0,178,不合格
20180806,60,76,92,80,82,390,合格
20180807,19,18,70,42,12,161,不合格
20180808,14,94,3,99,38,248,不合格
20180809,96,28,15,97,38,274,不合格
20180810,77,90,45,33,99,344,合格
20180811,54,87,74,68,52,335,合格
20180812,27,45,95,27,7,201,不合格
20180813,81,25,33,40,51,230,不合格
20180814,13,71,15,34,56,189,不合格
20180815,28,60,83,22,47,240,不合格
20180816,37,46,68,16,69,236,不合格
20180817,33,25,12,32,40,142,不合格
20180818,4,54,45,79,8,190,不合格
20180819,16,55,60,3,97,231,不合格
20180820,62,14,96,71,95,338,合格
20180821,23,52,79,33,71,258,不合格
20180822,65,60,58,4,52,239,不合格
20180823,8,44,79,76,85,292,不合格
20180824,89,12,25,86,47,259,不合格
20180825,20,71,83,49,53,276,不合格
20180826,66,72,82,78,50,348,合格
20180827,84,41,0,88,70,283,不合格
20180828,48,31,53,89,8,229,不合格
20180829,27,13,7,83,51,181,不合格
20180830,82,26,73,7,10,198,不合格
20180831,29,54,35,46,11,175,不合格
20180832,7,89,36,64,13,209,不合格
20180833,4,0,98,33,95,230,不合格
20180834,10,34,45,53,61,203,不合格
20180835,52,30,7,93,27,209,不合格
20180836,93,45,46,56,57,297,不合格
20180837,3,1,19,16,43,82,不合格
20180838,92,42,31,62,87,314,合格
20180839,51,78,38,79,0,246,不合格
20180840,57,18,69,55,52,251,不合格
20180841,56,85,91,96,35,363,合格
20180842,87,93,55,34,28,297,不合格
20180843,86,8,48,86,94,322,合格
20180844,20,8,39,35,49,151,不合格
20180845,87,41,34,76,76,314,合格
20180846,45,0,53,88,5,191,不合格
20180847,33,3,90,83,47,256,不合格
20180848,55,69,56,89,6,275,不合格
20180849,27,58,49,22,40,196,不合格
20180850,74,54,77,45,42,292,不合格
20180851,28,34,79,22,2,165,不合格
20180852,96,53,43,55,45,292,不合格
20180853,82,57,88,82,25,334,合格
20180854,0,90,52,55,83,280,不合格
20180855,94,49,84,40,84,351,合格
20180856,69,95,63,97,32,356,合格
20180857,46,54,50,25,51,226,不合格
20180858,27,62,0,39,93,221,不合格
20180859,77,8,36,95,13,229,不合格
20180860,93,10,81,99,45,328,合格
20180861,41,28,2,88,91,250,不合格
20180862,0,52,84,91,81,308,合格
20180863,16,90,57,31,51,245,不合格
20180864,15,76,25,49,34,199,不合格
20180865,20,28,30,65,14,157,不合格
20180866,93,94,6,70,29,292,不合格
20180867,66,94,56,7,68,291,不合格
20180868,35,96,69,73,0,273,不合格
20180869,76,47,47,37,80,287,不合格
20180870,53,19,12,52,51,187,不合格
20180871,67,56,47,27,13,210,不合格
20180872,85,44,30,94,56,309,合格
20180873,95,11,24,26,14,170,不合格
20180874,3,39,10,5,24,81,不合格
20180875,20,4,22,22,61,129,不合格
20180876,53,94,29,78,43,297,不合格
20180877,0,88,71,5,65,229,不合格
20180878,21,16,54,17,29,137,不合格
20180879,90,78,68,95,35,366,合格
20180880,88,2,6,76,28,200,不合格
20180881,69,43,74,11,52,249,不合格
20180882,21,71,77,57,87,313,合格
20180883,16,97,41,26,49,229,不合格
20180884,71,43,72,59,23,268,不合格
20180885,57,49,14,55,74,249,不合格
20180886,38,19,97,58,22,234,不合格
20180887,91,10,17,42,47,207,不合格
20180888,74,75,54,55,49,307,合格
20180889,28,10,12,9,87,146,不合格
20180890,35,62,33,93,93,316,合格
20180891,65,63,26,60,43,257,不合格
20180892,29,46,10,90,42,217,不合格
20180893,37,89,97,62,29,314,合格
20180894,14,63,99,97,51,324,合格
20180895,74,26,86,49,17,252,不合格
20180896,50,82,57,39,68,296,不合格
20180897,73,31,5,78,2,189,不合格
20180898,27,85,68,28,47,255,不合格
20180899,8,84,38,85,38,253,不合格
20180900,96,42,89,62,35,324,合格
20180901,84,36,96,12,57,285,不合格
20180902,77,70,90,4,52,293,不合格
20180903,40,5,66,78,57,246,不合格
20180904,96,36,59,98,96,385,合格
20180905,7,60,2,95,15,179,不合格
20180906,82,80,88,10,0,260,不合格
20180907,74,84,76,66,73,373,合格
20180908,78,42,45,91,76,332,合格
20180909,81,71,92,62,12,318,合格
20180910,49,57,39,68,16,229,不合格
20180911,37,94,26,10,48,215,不合格
20180912,57,33,67,84,14,255,不合格
20180913,22,71,7,80,97,277,不合格
20180914,10,77,69,47,87,290,不合格
20180915,27,49,76,45,4,201,不合格
20180916,20,15,38,7,95,175,不合格
20180917,94,16,23,22,65,220,不合格
20180918,29,76,13,16,78,212,不合格
20180919,54,73,99,22,84,332,合格
20180920,9,33,73,55,77,247,不合格
20180921,63,39,1,75,71,249,不合格
20180922,39,14,83,13,71,220,不合格
20180923,45,26,58,32,69,230,不合格
20180924,92,27,4,87,76,286,不合格
20180925,42,7,18,68,79,214,不合格
20180926,94,23,24,52,92,285,不合格
20180927,97,59,26,54,22,258,不合格
20180928,16,74,67,29,97,283,不合格
20180929,55,45,11,33,72,216,不合格
20180930,84,30,58,54,18,244,不合格
20180931,73,0,30,34,13,150,不合格
20180932,86,38,22,48,54,248,不合格
20180933,66,71,92,54,81,364,合格
20180934,53,96,24,35,30,238,不合格
20180935,97,35,53,28,88,301,合格
20180936,85,21,39,75,82,302,合格
20180937,72,13,1,23,1,110,不合格
20180938,1,74,47,52,97,271,不合格
20180939,82,29,94,26,29,260,不合格
20180940,98,22,9,22,48,199,不合格
20180941,96,61,36,96,83,372,合格
20180942,45,69,2,43,0,159,不合格
20180943,29,37,72,97,50,285,不合格
20180944,59,3,56,73,84,275,不合格
20180945,74,91,70,86,13,334,合格
20180946,25,50,87,50,6,218,不合格
20180947,75,19,6,24,56,180,不合格
20180948,42,18,24,98,98,280,不合格
20180949,26,73,44,37,42,222,不合格
20180950,61,57,52,43,31,244,不合格
20180951,10,79,29,30,93,241,不合格
20180952,18,70,34,73,54,249,不合格
20180953,52,88,74,53,33,300,合格
20180954,50,40,50,12,87,239,不合格
20180955,43,79,78,95,96,391,合格
20180956,55,97,67,18,62,299,不合格
20180957,94,31,23,35,37,220,不合格
20180958,71,19,70,60,93,313,合格
20180959,63,22,92,23,21,221,不合格
20180960,81,40,89,31,46,287,不合格
20180961,48,33,96,73,76,326,合格
20180962,67,72,4,19,38,200,不合格
20180963,82,54,49,67,74,326,合格
20180964,78,49,38,15,20,200,不合格
20180965,58,11,15,10,20,114,不合格
20180966,54,76,9,68,56,263,不合格
20180967,20,35,13,87,20,175,不合格
20180968,32,18,24,7,77,158,不合格
20180969,91,21,75,27,44,258,不合格
20180970,60,0,23,16,19,118,不合格
20180971,31,52,37,77,37,234,不合格
20180972,28,29,69,55,91,272,不合格
20180973,13,68,33,67,39,220,不合格
20180974,84,65,57,11,71,288,不合格
20180975,12,12,36,28,82,170,不合格
20180976,23,41,76,56,48,244,不合格
20180977,48,45,2,0,41,136,不合格
20180978,15,53,59,15,62,204,不合格
20180979,1,9,91,9,31,141,不合格
20180980,56,55,84,3,48,246,不合格
20180981,35,73,71,39,85,303,合格
20180982,27,43,35,22,99,226,不合格
20180983,63,67,0,63,54,247,不合格
20180984,17,58,83,51,87,296,不合格
20180985,8,24,74,32,39,177,不合格
20180986,69,69,24,62,34,258,不合格
20180987,88,62,71,81,44,346,合格
20180988,46,3,27,74,60,210,不合格
20180989,60,14,98,63,10,245,不合格
20180990,70,35,74,27,50,256,不合格
20180991,67,87,71,45,68,338,合格
20180992,67,37,59,79,52,294,不合格
20180993,31,50,80,41,43,245,不合格
20180994,69,58,83,96,96,402,合格
20180995,2,77,80,30,16,205,不合格
20180996,94,83,58,66,81,382,合格
20180997,4,44,35,90,14,187,不合格
20180998,14,20,50,4,63,151,不合格
20180999,64,37,30,64,73,268,不合格
20181000,47,16,16,94,61,234,不合格
20181001,65,40,75,33,1,214,不合格
20181002,12,24,10,13,70,129,不合格
20181003,6,6,90,21,98,221,不合格
20181004,80,4,26,83,28,221,不合格
20181005,48,20,63,28,58,217,不合格
20181006,59,33,90,6,26,214,不合格
20181007,33,32,69,9,70,213,不合格
20181008,82,47,3,94,69,295,不合格
20181009,42,46,2,62,58,210,不合格
20181010,68,34,57,83,34,276,不合格
20181011,43,61,8,14,19,145,不合格
20181012,8,85,0,3,75,171,不合格
20181013,62,1,71,34,86,254,不合格
20181014,10,47,2,4,85,148,不合格
20181015,14,87,62,76,70,309,合格
20181016,43,86,47,81,18,275,不合格
20181017,94,31,29,70,44,268,不合格
20181018,71,43,41,56,94,305,合格
20181019,73,23,94,19,75,284,不合格
20181020,92,52,27,56,68,295,不合格
20181021,2,78,28,61,26,195,不合格
20181022,14,68,6,43,93,224,不合格
20181023,68,52,45,53,15,233,不合格
20181024,3,20,36,33,2,94,不合格
20181025,47,93,87,63,64,354,合格
20181026,46,59,21,81,14,221,不合格
20181027,20,76,32,94,60,282,不合格
20181028,22,98,88,81,53,342,合格
20181029,1,85,93,32,20,231,不合格
20181030,16,59,7,89,25,196,不合格
20181031,57,38,26,87,20,228,不合格
20181032,70,8,13,53,60,204,不合格
20181033,55,77,27,27,81,267,不合格
20181034,24,61,55,67,15,222,不合格
20181035,3,56,51,37,93,240,不合格
20181036,83,18,93,80,68,342,合格
20181037,66,86,34,93,31,310,合格
20181038,70,14,37,83,91,295,不合格
20181039,74,17,15,27,8,141,不合格
20181040,14,40,76,19,42,191,不合格
20181041,29,80,42,22,36,209,不合格
20181042,76,8,32,64,95,275,不合格
20181043,9,60,5,18,65,157,不合格
20181044,75,97,87,42,26,327,合格
20181045,28,46,44,43,18,179,不合格
20181046,40,48,16,16,42,162,不合格
20181047,19,34,30,58,59,200,不合格
20181048,19,66,13,61,99,258,不合格
20181049,37,4,59,59,49,208,不合格
20181050,11,21,40,65,14,151,不合格
20181051,86,54,87,44,88,359,合格
20181052,71,50,73,78,96,368,合格
20181053,68,19,14,58,3,162,不合格
20181054,64,64,53,96,69,346,合格
20181055,89,13,13,3,91,209,不合格
20181056,94,46,53,79,37,309,合格
20181057,50,0,53,69,2,174,不合格
20181058,41,32,43,63,75,254,不合格
20181059,89,11,83,43,64,290,不合格
20181060,40,69,72,49,55,285,不合格
20181061,31,68,24,26,34,183,不合格
20181062,98,76,75,54,33,336,合格
20181063,71,15,2,84,85,257,不合格
20181064,44,60,61,20,59,244,不合格
20181065,25,50,97,19,52,243,不合格
20181066,66,85,17,25,53,246,不合格
20181067,82,33,35,61,55,266,不合格
20181068,64,36,40,58,85,283,不合格
20181069,45,33,60,49,67,254,不合格
20181070,9,86,49,63,25,232,不合格
20181071,85,64,71,89,80,389,合格
20181072,51,24,96,68,74,313,合格
20181073,91,58,84,66,56,355,合格
20181074,23,28,21,40,27,139,不合格
20181075,9,27,33,34,65,168,不合格
20181076,80,72,71,4,79,306,合格
20181077,10,21,78,41,41,191,不合格
20181078,63,74,71,66,14,288,不合格
20181079,64,32,80,31,29,236,不合格
20181080,1,84,35,98,40,258,不合格
20181081,89,35,70,38,45,277,不合格
20181082,63,4,92,36,11,206,不合格
20181083,23,45,25,86,73,252,不合格
20181084,65,10,30,1,26,132,不合格
20181085,23,54,99,23,49,248,不合格
20181086,81,59,66,23,16,245,不合格
20181087,30,57,80,47,71,285,不合格
20181088,51,20,31,88,33,223,不合格
20181089,19,77,10,0,20,126,不合格
20181090,61,60,27,10,8,166,不合格
20181091,8,35,84,23,13,163,不合格
20181092,53,18,91,31,64,257,不合格
20181093,4,47,93,59,98,301,合格
20181094,12,63,34,93,54,256,不合格
20181095,9,90,78,62,78,317,合格
20181096,44,33,83,33,46,239,不合格
20181097,50,95,63,1,60,269,不合格
20181098,29,12,44,49,79,213,不合格
20181099,29,34,8,37,56,164,不合格
20181100,10,39,12,75,87,223,不合格
20181101,5,56,89,91,31,272,不合格
20181102,5,38,56,64,93,256,不合格
20181103,90,90,56,94,84,414,合格
20181104,5,9,36,77,25,152,不合格
20181105,22,68,92,28,5,215,不合格
20181106,42,77,98,91,31,339,合格
20181107,63,18,24,52,21,178,不合格
20181108,12,29,10,89,66,206,不合格
20181109,22,21,15,24,84,166,不合格
20181110,24,68,73,25,30,220,不合格
20181111,97,83,59,66,20,325,合格
20181112,63,9,82,6,11,171,不合格
20181113,45,16,76,74,24,235,不合格
20181114,35,2,42,52,8,139,不合格
20181115,80,38,86,17,31,252,不合格
20181116,42,76,69,64,48,299,不合格
20181117,68,30,17,34,70,219,不合格
20181118,65,59,20,81,95,320,合格
20181119,86,22,97,30,86,321,合格
20181120,10,69,62,24,10,175,不合格
20181121,94,32,87,59,79,351,合格
20181122,88,66,29,35,3,221,不合格
20181123,25,70,13,76,62,246,不合格
20181124,72,7,35,12,66,192,不合格
20181125,47,45,23,74,13,202,不合格
20181126,45,45,29,6,78,203,不合格
20181127,99,90,94,23,54,360,合格
20181128,68,11,1,4,24,108,不合格
20181129,70,93,16,34,10,223,不合格
20181130,4,11,49,48,86,198,不合格
20181131,20,56,59,63,63,261,不合格
20181132,94,83,85,18,7,287,不合格
20181133,46,61,54,51,49,261,不合格
20181134,12,93,21,5,58,189,不合格
20181135,22,86,40,39,12,199,不合格
20181136,9,5,16,27,78,135,不合格
20181137,70,36,27,21,96,250,不合格
20181138,79,47,32,35,44,237,不合格
20181139,72,20,98,60,45,295,不合格
20181140,45,39,55,53,8,200,不合格
20181141,72,36,37,86,35,266,不合格
20181142,4,20,20,80,62,186,不合格
20181143,10,57,19,82,59,227,不合格
20181144,47,85,60,0,82,274,不合格
20181145,98,61,10,61,90,320,合格
20181146,23,68,52,8,89,240,不合格
20181147,34,34,89,9,68,234,不合格
20181148,19,39,93,10,42,203,不合格
20181149,74,57,4,7,57,199,不合格
20181150,89,76,43,73,16,297,不合格
20181151,58,36,48,84,0,226,不合格
20181152,95,60,63,87,57,362,合格
20181153,36,8,17,82,10,153,不合格
20181154,94,80,91,70,16,351,合格
20181155,90,0,39,60,17,206,不合格
20181156,22,58,95,95,99,369,合格
20181157,99,37,57,31,7,231,不合格
20181158,78,39,19,88,16,240,不合格
20181159,90,57,94,94,69,404,合格
20181160,68,33,32,14,28,175,不合格
20181161,95,2,34,56,17,204,不合格
20181162,28,87,43,39,98,295,不合格
20181163,77,63,77,39,63,319,合格
20181164,51,24,4,92,31,202,不合格
20181165,58,17,24,76,23,198,不合格
20181166,3,80,90,22,78,273,不合格
20181167,26,34,48,69,31,208,不合格
20181168,56,57,46,64,40,263,不合格
20181169,35,60,63,75,25,258,不合格
20181170,66,33,17,28,29,173,不合格
20181171,53,18,51,12,99,233,不合格
20181172,50,3,1,1,75,130,不合格
20181173,3,29,74,43,72,221,不合格
20181174,1,96,40,17,63,217,不合格
20181175,88,83,25,4,95,295,不合格
20181176,22,80,81,4,82,269,不合格
20181177,0,73,72,53,52,250,不合格
20181178,69,52,48,59,13,241,不合格
20181179,95,51,67,88,66,367,合格
20181180,89,33,8,2,34,166,不合格
20181181,40,43,31,37,68,219,不合格
20181182,24,13,20,97,43,197,不合格
20181183,95,32,33,65,17,242,不合格
20181184,51,93,66,10,18,238,不合格
20181185,67,32,95,7,45,246,不合格
20181186,39,80,20,86,38,263,不合格
20181187,33,18,96,54,84,285,不合格
20181188,99,11,70,55,54,289,不合格
20181189,16,70,9,76,9,180,不合格
20181190,98,64,53,3,84,302,合格
20181191,55,96,94,53,94,392,合格
20181192,31,6,89,79,53,258,不合格
20181193,82,91,4,63,23,263,不合格
20181194,42,51,67,25,52,237,不合格
20181195,62,36,51,62,32,243,不合格
20181196,47,77,39,74,47,284,不合格
20181197,24,74,9,34,11,152,不合格
20181198,63,93,62,79,4,301,合格
20181199,36,9,53,66,94,258,不合格
20181200,18,19,33,0,38,108,不合格
20181201,73,69,53,60,8,263,不合格
20181202,73,39,86,10,64,272,不合格
20181203,32,63,80,63,8,246,不合格
20181204,82,29,43,8,38,200,不合格
20181205,68,56,75,18,88,305,合格
20181206,25,16,69,13,44,167,不合格
20181207,76,9,67,99,59,310,合格
20181208,3,15,64,64,59,205,不合格
20181209,90,14,93,23,98,318,合格
20181210,56,9,31,68,52,216,不合格
20181211,65,84,54,50,5,258,不合格
20181212,9,65,7,64,0,145,不合格
20181213,41,79,63,6,40,229,不合格
20181214,74,91,23,30,38,256,不合格
20181215,22,53,53,82,87,297,不合格
20181216,88,75,43,36,9,251,不合格
20181217,40,71,72,74,81,338,合格
20181218,8,32,41,69,21,171,不合格
20181219,39,77,40,79,37,272,不合格
20181220,48,80,56,96,69,349,合格
20181221,83,69,72,42,45,311,合格
20181222,53,47,22,68,32,222,不合格
20181223,68,88,46,27,73,302,合格
20181224,41,77,62,29,26,235,不合格
20181225,38,83,69,39,85,314,合格
20181226,10,84,8,36,73,211,不合格
20181227,35,63,3,33,46,180,不合格
20181228,86,83,60,14,61,304,合格
20181229,37,95,21,7,60,220,不合格
20181230,68,51,83,75,67,344,合格
20181231,65,86,98,93,88,430,合格
20181232,54,27,54,81,59,275,不合格
20181233,36,6,85,31,6,164,不合格
20181234,8,0,13,45,76,142,不合格
20181235,44,8,47,30,21,150,不合格
20181236,19,48,37,46,16,166,不合格
20181237,18,95,10,64,81,268,不合格
20181238,14,45,90,50,88,287,不合格
20181239,17,34,36,94,30,211,不合格
20181240,86,29,83,84,29,311,合格
20181241,88,93,41,79,45,346,合格
20181242,74,71,75,13,58,291,不合格
20181243,22,84,14,33,21,174,不合格
20181244,79,31,5,34,59,208,不合格
20181245,0,4,75,66,31,176,不合格
20181246,55,64,11,23,85,238,不合格
20181247,0,32,44,20,26,122,不合格
20181248,93,63,86,35,39,316,合格
20181249,51,56,42,49,9,207,不合格
20181250,82,10,64,78,97,331,合格
20181251,47,17,71,57,31,223,不合格
20181252,79,77,24,84,18,282,不合格
20181253,18,4,87,95,55,259,不合格
20181254,91,77,17,76,35,296,不合格
20181255,63,24,74,59,34,254,不合格
20181256,58,41,43,37,17,196,不合格
20181257,76,95,75,15,50,311,合格
20181258,70,97,31,4,15,217,不合格
20181259,64,21,37,9,2,133,不合格
20181260,53,90,68,12,60,283,不合格
20181261,64,12,22,52,41,191,不合格
20181262,79,38,33,31,25,206,不合格
20181263,88,71,49,60,40,308,合格
20181264,16,10,17,94,62,199,不合格
20181265,70,40,31,76,45,262,不合格
20181266,78,87,35,16,35,251,不合格
20181267,6,67,44,28,77,222,不合格
20181268,47,14,34,88,56,239,不合格
20181269,36,38,99,48,40,261,不合格
20181270,86,67,16,12,10,191,不合格
20181271,69,0,60,31,87,247,不合格
20181272,37,25,25,80,78,245,不合格
20181273,60,5,56,0,87,208,不合格
20181274,77,85,32,62,84,340,合格
20181275,45,80,1,61,88,275,不合格
20181276,26,15,18,23,9,91,不合格
20181277,65,9,51,50,60,235,不合格
20181278,86,38,11,74,30,239,不合格
20181279,69,85,99,71,25,349,合格
20181280,28,20,77,13,67,205,不合格
20181281,14,95,10,14,72,205,不合格
20181282,99,93,92,35,94,413,合格
20181283,91,6,54,16,66,233,不合格
20181284,35,62,49,36,18,200,不合格
20181285,1,64,46,9,21,141,不合格
20181286,44,94,17,10,16,181,不合格
20181287,63,42,98,7,68,278,不合格
20181288,37,23,84,16,48,208,不合格
20181289,77,13,56,39,5,190,不合格
20181290,69,33,67,57,36,262,不合格
20181291,39,4,32,22,19,116,不合格
20181292,73,27,26,26,98,250,不合格
20181293,34,58,4,52,54,202,不合格
20181294,62,52,19,92,85,310,合格
20181295,74,88,6,92,16,276,不合格
20181296,83,17,14,8,6,128,不合格
20181297,29,40,39,65,7,180,不合格
20181298,54,51,77,78,88,348,合格
20181299,27,79,1,48,18,173,不合格
20181300,79,85,71,27,63,325,合格
20181301,10,41,26,63,72,212,不合格
20181302,76,95,97,72,51,391,合格
20181303,97,41,13,66,84,301,合格
20181304,69,73,44,42,79,307,合格
20181305,5,93,21,61,5,185,不合格
20181306,41,91,8,86,71,297,不合格
20181307,23,12,14,72,67,188,不合格
20181308,6,74,79,25,14,198,不合格
20181309,84,97,94,22,38,335,合格
20181310,76,9,51,50,73,259,不合格
20181311,48,35,4,93,42,222,不合格
20181312,65,73,67,6,39,250,不合格
20181313,0,26,75,58,91,250,不合格
20181314,38,77,78,52,51,296,不合格
20181315,76,57,75,50,27,285,不合格
20181316,9,70,65,89,56,289,不合格
20181317,70,65,0,18,96,249,不合格
20181318,30,69,50,37,1,187,不合格
20181319,76,38,95,44,14,267,不合格
20181320,69,47,30,35,93,274,不合格
20181321,72,75,5,56,23,231,不合格
20181322,83,43,5,89,87,307,合格
20181323,50,67,75,38,70,300,合格
20181324,81,58,80,49,50,318,合格
20181325,17,70,32,17,78,214,不合格
20181326,95,88,90,55,27,355,合格
20181327,45,11,10,34,38,138,不合格
20181328,34,72,83,70,55,314,合格
20181329,86,81,76,37,80,360,合格
20181330,69,74,93,5,61,302,合格
20181331,18,30,25,75,35,183,不合格
20181332,74,36,70,74,82,336,合格
20181333,48,59,82,98,94,381,合格
20181334,16,40,32,92,44,224,不合格
20181335,52,97,89,83,15,336,合格
20181336,8,20,9,93,77,207,不合格
20181337,7,94,20,52,42,215,不合格
20181338,75,94,2,88,6,265,不合格
20181339,86,49,51,88,76,350,合格
20181340,98,37,85,79,77,376,合格
20181341,25,74,5,77,41,222,不合格
20181342,30,90,45,22,86,273,不合格
20181343,33,34,75,65,18,225,不合格
20181344,30,88,41,98,69,326,合格
20181345,16,65,3,85,58,227,不合格
20181346,44,51,82,8,62,247,不合格
20181347,33,94,32,86,58,303,合格
20181348,51,11,70,21,6,159,不合格
20181349,90,56,94,86,96,422,合格
20181350,19,60,43,35,52,209,不合格
20181351,96,17,93,61,64,331,合格
20181352,50,60,98,50,33,291,不合格
20181353,10,71,96,74,28,279,不合格
20181354,32,40,92,32,94,290,不合格
20181355,30,10,8,96,90,234,不合格
20181356,52,65,32,29,32,210,不合格
20181357,1,52,10,41,91,195,不合格
20181358,40,99,84,38,13,274,不合格
20181359,51,88,37,91,74,341,合格
20181360,58,33,55,28,67,241,不合格
20181361,76,78,50,96,61,361,合格
20181362,23,92,26,54,90,285,不合格
20181363,91,92,82,15,18,298,不合格
20181364,45,64,22,71,5,207,不合格
20181365,77,87,58,95,86,403,合格
20181366,71,78,26,6,37,218,不合格
20181367,48,76,30,96,4,254,不合格
20181368,26,0,23,60,33,142,不合格
20181369,7,90,42,87,88,314,合格
20181370,75,49,87,63,3,277,不合格
20181371,77,18,59,63,57,274,不合格
20181372,12,6,81,41,73,213,不合格
20181373,36,2,36,59,63,196,不合格
20181374,26,16,67,40,5,154,不合格
20181375,3,85,4,40,27,159,不合格
20181376,80,23,44,55,62,264,不合格
20181377,18,19,20,16,57,130,不合格
20181378,57,23,41,60,65,246,不合格
20181379,39,99,47,42,68,295,不合格
20181380,52,25,41,74,65,257,不合格
20181381,19,95,28,40,11,193,不合格
20181382,86,42,51,27,14,220,不合格
20181383,16,64,1,83,59,223,不合格
20181384,77,91,53,22,74,317,合格
20181385,97,57,3,81,36,274,不合格
20181386,85,36,77,0,8,206,不合格
20181387,11,5,62,1,57,136,不合格
20181388,23,64,20,93,66,266,不合格
20181389,75,7,74,70,80,306,合格
20181390,15,82,10,95,46,248,不合格
20181391,91,99,36,3,98,327,合格
20181392,41,81,76,17,74,289,不合格
20181393,34,98,84,44,33,293,不合格
20181394,33,76,85,80,52,326,合格
20181395,59,72,10,17,63,221,不合格
20181396,2,70,11,76,46,205,不合格
20181397,72,49,62,62,90,335,合格
20181398,95,78,29,71,4,277,不合格
20181399,87,66,22,91,51,317,合格
20181400,47,28,39,10,13,137,不合格
20181401,29,41,16,87,91,264,不合格
20181402,84,86,47,62,47,326,合格
20181403,74,13,35,78,59,259,不合格
20181404,96,5,63,87,93,344,合格
20181405,50,48,40,49,49,236,不合格
20181406,17,62,56,60,42,237,不合格
20181407,9,71,62,98,95,335,合格
20181408,69,76,27,75,82,329,合格
20181409,47,93,83,24,36,283,不合格
20181410,97,14,0,94,17,222,不合格
20181411,38,90,37,65,70,300,合格
20181412,75,30,65,25,54,249,不合格
20181413,52,12,58,29,0,151,不合格
20181414,0,46,66,90,81,283,不合格
20181415,24,77,83,39,29,252,不合格
20181416,93,18,54,76,70,311,合格
20181417,93,98,44,14,69,318,合格
20181418,50,33,24,58,66,231,不合格
20181419,6,75,87,26,37,231,不合格
20181420,57,72,74,49,61,313,合格
20181421,13,65,74,98,10,260,不合格
20181422,53,38,32,94,24,241,不合格
20181423,64,6,46,46,43,205,不合格
20181424,66,0,85,13,21,185,不合格
20181425,77,49,65,60,68,319,合格
20181426,92,41,27,99,2,261,不合格
20181427,97,10,94,26,62,289,不合格
20181428,91,85,55,83,86,400,合格
20181429,49,36,49,56,52,242,不合格
20181430,44,21,97,3,0,165,不合格
20181431,45,87,98,81,3,314,合格
20181432,22,52,95,41,14,224,不合格
20181433,76,81,88,28,16,289,不合格
20181434,55,84,57,89,37,322,合格
20181435,46,1,30,49,73,199,不合格
20181436,59,98,35,5,81,278,不合格
20181437,45,25,46,34,86,236,不合格
20181438,41,53,1,72,31,198,不合格
20181439,13,81,20,70,91,275,不合格
20181440,54,26,51,31,1,163,不合格
20181441,65,63,97,18,68,311,合格
20181442,1,46,96,47,33,223,不合格
20181443,40,71,74,40,86,311,合格
20181444,52,64,13,26,12,167,不合格
20181445,60,27,48,86,17,238,不合格
20181446,82,80,99,85,62,408,合格
20181447,76,11,96,45,78,306,合格
20181448,44,69,54,4,45,216,不合格
20181449,97,3,85,56,99,340,合格
20181450,89,93,69,92,46,389,合格
20181451,34,70,77,32,47,260,不合格
20181452,41,30,27,57,65,220,不合格
20181453,76,17,41,18,55,207,不合格
20181454,45,47,19,18,50,179,不合格
20181455,18,26,79,22,38,183,不合格
20181456,10,20,7,9,38,84,不合格
20181457,78,76,28,65,51,298,不合格
20181458,29,96,24,37,50,236,不合格
20181459,33,80,7,87,80,287,不合格
20181460,19,12,40,67,83,221,不合格
20181461,7,99,42,89,82,319,合格
20181462,1,30,59,29,30,149,不合格
20181463,76,99,65,6,49,295,不合格
20181464,45,78,36,53,11,223,不合格
20181465,9,38,89,9,26,171,不合格
20181466,81,30,54,74,95,334,合格
20181467,83,70,29,94,76,352,合格
20181468,31,3,26,53,82,195,不合格
20181469,6,73,83,59,57,278,不合格
20181470,54,29,89,54,10,236,不合格
20181471,38,18,40,56,31,183,不合格
20181472,6,16,68,56,14,160,不合格
20181473,79,18,74,35,94,300,合格
20181474,42,96,66,69,55,328,合格
20181475,28,54,32,19,99,232,不合格
20181476,38,89,99,74,45,345,合格
20181477,15,58,30,78,33,214,不合格
20181478,46,7,78,54,76,261,不合格
20181479,14,63,65,78,41,261,不合格
20181480,88,76,79,82,91,416,合格
20181481,23,83,93,53,16,268,不合格
20181482,19,22,10,78,36,165,不合格
20181483,81,50,95,1,66,293,不合格
20181484,2,43,14,4,4,67,不合格
20181485,35,6,66,26,25,158,不合格
20181486,57,79,49,51,34,270,不合格
20181487,86,52,72,32,47,289,不合格
20181488,90,91,45,8,9,243,不合格
20181489,39,24,17,83,24,187,不合格
20181490,15,67,85,75,28,270,不合格
20181491,35,42,25,16,47,165,不合格
20181492,68,34,83,43,10,238,不合格
20181493,90,21,24,55,81,271,不合格
20181494,0,9,1,63,69,142,不合格
20181495,67,40,73,64,65,309,合格
20181496,24,16,91,30,13,174,不合格
20181497,95,92,10,77,90,364,合格
20181498,76,27,11,11,88,213,不合格
20181499,75,36,24,99,19,253,不合格
20181500,0,11,11,45,50,117,不合格
20181501,1,73,82,6,14,176,不合格
20181502,26,71,30,94,80,301,合格
20181503,57,68,45,89,76,335,合格
20181504,89,95,22,2,37,245,不合格
20181505,87,12,47,13,4,163,不合格
20181506,21,99,68,45,77,310,合格
20181507,72,86,69,98,82,407,合格
20181508,37,75,89,60,6,267,不合格
20181509,32,87,61,54,59,293,不合格
20181510,65,2,15,90,95,267,不合格
20181511,68,93,55,74,86,376,合格
20181512,71,36,67,97,43,314,合格
20181513,36,56,97,22,84,295,不合格
20181514,71,84,76,81,26,338,合格
20181515,36,74,38,50,75,273,不合格
20181516,85,24,36,46,97,288,不合格
20181517,30,61,24,40,33,188,不合格
20181518,41,42,41,6,80,210,不合格
20181519,68,17,88,0,90,263,不合格
20181520,70,40,36,27,85,258,不合格
20181521,76,44,11,65,76,272,不合格
20181522,37,5,93,6,35,176,不合格
20181523,54,94,47,12,32,239,不合格
20181524,79,50,66,33,56,284,不合格
20181525,8,47,90,15,17,177,不合格
20181526,91,57,62,47,53,310,合格
20181527,79,46,77,40,32,274,不合格
20181528,4,55,25,91,30,205,不合格
20181529,37,78,28,0,78,221,不合格
20181530,89,47,99,34,44,313,合格
20181531,67,31,60,38,68,264,不合格
20181532,78,61,40,30,85,294,不合格
20181533,79,18,63,96,38,294,不合格
20181534,9,77,26,59,26,197,不合格
20181535,69,2,24,26,4,125,不合格
20181536,7,94,92,4,37,234,不合格
20181537,70,29,42,25,96,262,不合格
20181538,27,66,76,70,88,327,合格
20181539,50,32,65,80,99,326,合格
20181540,76,79,46,1,98,300,合格
20181541,86,66,97,31,75,355,合格
20181542,92,60,26,88,93,359,合格
20181543,72,15,19,49,59,214,不合格
20181544,80,99,68,43,78,368,合格
20181545,32,13,94,1,31,171,不合格
20181546,91,76,16,30,70,283,不合格
20181547,42,14,60,96,85,297,不合格
20181548,88,74,87,15,0,264,不合格
20181549,64,47,39,41,14,205,不合格
20181550,20,7,89,5,92,213,不合格
20181551,92,9,83,98,22,304,合格
20181552,66,65,28,90,35,284,不合格
20181553,88,42,63,97,97,387,合格
20181554,9,63,37,34,27,170,不合格
20181555,96,83,69,28,74,350,合格
20181556,21,30,8,9,4,72,不合格
20181557,12,26,18,45,65,166,不合格
20181558,18,32,41,16,2,109,不合格
20181559,77,87,23,22,42,251,不合格
20181560,6,11,43,74,36,170,不合格
20181561,96,12,86,89,56,339,合格
20181562,84,88,1,29,4,206,不合格
20181563,91,53,99,71,57,371,合格
20181564,56,72,23,16,45,212,不合格
20181565,12,43,31,65,47,198,不合格
20181566,90,70,36,0,58,254,不合格
20181567,51,14,57,97,81,300,合格
20181568,25,1,71,87,82,266,不合格
20181569,81,74,44,92,69,360,合格
20181570,68,19,49,72,29,237,不合格
20181571,55,89,42,68,78,332,合格
20181572,62,44,84,27,16,233,不合格
20181573,10,25,72,26,5,138,不合格
20181574,3,21,92,67,71,254,不合格
20181575,10,88,34,89,9,230,不合格
20181576,88,11,90,90,59,338,合格
20181577,68,2,43,40,96,249,不合格
20181578,3,60,73,95,75,306,合格
20181579,90,45,62,91,62,350,合格
20181580,32,66,46,18,14,176,不合格
20181581,67,43,4,89,99,302,合格
20181582,80,33,22,35,74,244,不合格
20181583,17,40,35,32,58,182,不合格
20181584,87,5,12,65,46,215,不合格
20181585,46,66,38,19,89,258,不合格
20181586,43,17,64,55,14,193,不合格
20181587,98,4,28,78,50,258,不合格
20181588,75,29,51,14,61,230,不合格
20181589,83,0,91,42,77,293,不合格
20181590,28,71,63,29,81,272,不合格
20181591,5,37,85,17,55,199,不合格
20181592,23,4,84,0,2,113,不合格
20181593,92,41,59,89,82,363,合格
20181594,14,46,10,13,27,110,不合格
20181595,19,23,64,14,27,147,不合格
20181596,17,55,70,48,97,287,不合格
20181597,26,41,38,97,29,231,不合格
20181598,99,39,66,27,88,319,合格
20181599,48,41,78,90,52,309,合格
20181600,35,67,85,82,18,287,不合格
20181601,74,32,62,79,88,335,合格
20181602,31,78,24,16,91,240,不合格
20181603,90,19,30,3,96,238,不合格
20181604,18,29,47,65,82,241,不合格
20181605,85,12,17,92,96,302,合格
20181606,62,1,64,76,61,264,不合格
20181607,92,96,55,62,61,366,合格
20181608,66,70,98,84,53,371,合格
20181609,43,63,82,66,82,336,合格
20181610,3,40,84,16,87,230,不合格
20181611,65,31,77,28,28,229,不合格
20181612,81,47,72,70,38,308,合格
20181613,78,14,37,58,81,268,不合格
20181614,58,35,30,86,30,239,不合格
20181615,54,50,67,70,2,243,不合格
20181616,76,37,18,37,62,230,不合格
20181617,41,19,89,23,87,259,不合格
20181618,78,87,54,74,61,354,合格
20181619,98,63,28,20,25,234,不合格
20181620,63,2,58,51,66,240,不合格
20181621,10,86,79,49,49,273,不合格
20181622,19,31,27,48,98,223,不合格
20181623,47,33,19,89,31,219,不合格
20181624,2,18,62,35,12,129,不合格
20181625,17,45,60,15,78,215,不合格
20181626,93,60,49,94,99,395,合格
20181627,21,0,48,39,52,160,不合格
20181628,66,37,44,62,1,210,不合格
20181629,57,27,88,23,72,267,不合格
20181630,85,75,50,1,71,282,不合格
20181631,86,63,0,44,33,226,不合格
20181632,90,48,45,89,0,272,不合格
20181633,30,80,51,23,93,277,不合格
20181634,8,37,42,65,82,234,不合格
20181635,72,54,8,83,34,251,不合格
20181636,39,28,32,51,89,239,不合格
20181637,54,71,34,27,92,278,不合格
20181638,55,54,17,36,17,179,不合格
20181639,75,65,73,60,61,334,合格
20181640,24,31,2,59,46,162,不合格
20181641,75,55,47,37,23,237,不合格
20181642,63,66,77,33,20,259,不合格
20181643,34,98,78,53,29,292,不合格
20181644,97,93,9,29,12,240,不合格
20181645,83,6,0,28,90,207,不合格
20181646,22,47,43,50,37,199,不合格
20181647,28,93,64,36,12,233,不合格
20181648,10,1,55,50,88,204,不合格
20181649,32,75,52,56,11,226,不合格
20181650,46,53,86,14,70,269,不合格
20181651,35,14,94,31,51,225,不合格
20181652,8,10,14,93,35,160,不合格
20181653,12,13,37,12,46,120,不合格
20181654,89,57,60,27,62,295,不合格
20181655,87,94,31,31,86,329,合格
20181656,52,68,90,12,95,317,合格
20181657,7,36,49,16,12,120,不合格
20181658,96,17,35,7,1,156,不合格
20181659,15,57,11,24,71,178,不合格
20181660,69,33,5,12,67,186,不合格
20181661,84,37,68,21,4,214,不合格
20181662,11,60,86,6,27,190,不合格
20181663,44,27,67,69,65,272,不合格
20181664,1,7,18,66,8,100,不合格
20181665,84,73,82,55,16,310,合格
20181666,42,1,12,35,2,92,不合格
20181667,87,91,83,17,13,291,不合格
20181668,81,16,18,89,65,269,不合格
20181669,40,94,97,94,51,376,合格
20181670,83,80,25,42,50,280,不合格
20181671,47,63,64,31,14,219,不合格
20181672,15,75,53,53,18,214,不合格
20181673,82,75,8,51,26,242,不合格
20181674,4,48,4,92,19,167,不合格
20181675,61,47,8,83,74,273,不合格
20181676,45,16,28,52,71,212,不合格
20181677,63,84,58,75,87,367,合格
20181678,81,81,44,13,32,251,不合格
20181679,59,70,24,11,75,239,不合格
20181680,58,35,48,1,47,189,不合格
20181681,1,61,75,28,64,229,不合格
20181682,55,2,92,50,84,283,不合格
20181683,2,17,25,70,79,193,不合格
20181684,62,52,63,62,56,295,不合格
20181685,12,28,80,73,64,257,不合格
20181686,48,47,51,93,3,242,不合格
20181687,59,71,65,91,69,355,合格
20181688,57,51,44,62,88,302,合格
20181689,91,3,21,16,23,154,不合格
20181690,38,98,31,10,66,243,不合格
20181691,57,58,27,59,44,245,不合格
20181692,71,85,45,61,90,352,合格
20181693,15,74,79,80,47,295,不合格
20181694,42,8,35,78,64,227,不合格
20181695,25,23,80,73,42,243,不合格
20181696,0,70,75,1,83,229,不合格
20181697,47,99,38,31,68,283,不合格
20181698,69,94,43,71,55,332,合格
20181699,92,47,28,36,7,210,不合格
20181700,8,70,51,87,25,241,不合格
20181701,89,3,27,81,38,238,不合格
20181702,12,1,95,59,5,172,不合格
20181703,41,66,91,8,19,225,不合格
20181704,64,40,67,54,35,260,不合格
20181705,74,89,21,10,46,240,不合格
20181706,14,14,15,60,55,158,不合格
20181707,4,94,8,12,69,187,不合格
20181708,6,82,78,18,14,198,不合格
20181709,11,77,77,18,19,202,不合格
20181710,10,47,2,28,76,163,不合格
20181711,35,21,72,74,90,292,不合格
20181712,30,21,20,60,60,191,不合格
20181713,66,34,4,9,54,167,不合格
20181714,51,37,41,94,26,249,不合格
20181715,75,64,31,89,23,282,不合格
20181716,51,94,66,16,0,227,不合格
20181717,68,79,38,69,24,278,不合格
20181718,37,89,83,93,64,366,合格
20181719,30,44,24,70,91,259,不合格
20181720,31,97,31,80,80,319,合格
20181721,28,38,61,83,28,238,不合格
20181722,94,24,95,0,41,254,不合格
20181723,97,53,74,26,5,255,不合格
20181724,54,71,78,99,36,338,合格
20181725,9,84,86,15,34,228,不合格
20181726,90,14,84,26,15,229,不合格
20181727,94,59,30,5,50,238,不合格
20181728,49,45,32,86,11,223,不合格
20181729,7,63,59,53,6,188,不合格
20181730,87,8,25,4,98,222,不合格
20181731,59,21,82,70,68,300,合格
20181732,52,82,34,24,58,250,不合格
20181733,14,84,37,37,37,209,不合格
20181734,69,94,64,94,58,379,合格
20181735,74,43,51,1,78,247,不合格
20181736,79,69,70,86,40,344,合格
20181737,78,80,89,2,23,272,不合格
20181738,22,80,99,1,57,259,不合格
20181739,97,52,87,92,81,409,合格
20181740,72,7,53,38,23,193,不合格
20181741,38,98,60,8,18,222,不合格
20181742,14,16,12,67,72,181,不合格
20181743,90,71,83,82,90,416,合格
20181744,81,68,80,9,37,275,不合格
20181745,79,8,92,1,57,237,不合格
20181746,14,37,35,89,5,180,不合格
20181747,19,94,19,22,47,201,不合格
20181748,28,76,59,6,50,219,不合格
20181749,75,17,34,34,11,171,不合格
20181750,15,91,35,20,6,167,不合格
20181751,68,82,58,71,61,340,合格
20181752,81,63,49,97,46,336,合格
20181753,0,80,6,45,31,162,不合格
20181754,44,84,79,25,76,308,合格
20181755,8,29,55,68,25,185,不合格
20181756,22,57,81,83,24,267,不合格
20181757,29,21,41,77,5,173,不合格
20181758,0,32,73,32,14,151,不合格
20181759,83,65,97,58,26,329,合格
20181760,0,31,44,87,69,231,不合格
20181761,9,60,9,24,54,156,不合格
20181762,56,52,20,74,52,254,不合格
20181763,54,50,77,91,73,345,合格
20181764,84,47,76,84,89,380,合格
20181765,55,32,25,64,35,211,不合格
20181766,28,90,74,55,84,331,合格
20181767,66,57,29,38,96,286,不合格
20181768,42,17,43,64,31,197,不合格
20181769,7,39,26,65,44,181,不合格
20181770,57,65,24,9,98,253,不合格
20181771,96,20,35,7,4,162,不合格
20181772,42,47,46,16,75,226,不合格
20181773,28,88,91,28,87,322,合格
20181774,62,55,52,32,6,207,不合格
20181775,74,50,79,17,56,276,不合格
20181776,54,25,95,15,98,287,不合格
20181777,95,59,55,20,57,286,不合格
20181778,94,10,64,12,39,219,不合格
20181779,62,4,19,93,92,270,不合格
20181780,53,93,87,34,90,357,合格
20181781,80,36,9,20,93,238,不合格
20181782,29,37,46,60,98,270,不合格
20181783,77,13,24,65,65,244,不合格
20181784,90,51,9,9,47,206,不合格
20181785,38,89,21,50,82,280,不合格
20181786,11,17,31,78,99,236,不合格
20181787,20,9,5,17,83,134,不合格
20181788,18,19,62,81,19,199,不合格
20181789,35,77,7,66,46,231,不合格
20181790,81,98,0,6,12,197,不合格
20181791,79,13,0,19,63,174,不合格
20181792,16,37,6,31,96,186,不合格
20181793,6,81,54,31,19,191,不合格
20181794,49,44,81,33,14,221,不合格
20181795,88,88,77,39,72,364,合格
20181796,86,98,71,68,77,400,合格
20181797,77,58,62,34,78,309,合格
20181798,30,43,55,70,12,210,不合格
20181799,34,76,70,42,40,262,不合格
20181800,35,31,73,48,1,188,不合格
20181801,90,47,60,11,10,218,不合格
20181802,52,21,16,31,69,189,不合格
20181803,49,78,97,73,5,302,合格
20181804,62,18,8,25,95,208,不合格
20181805,24,97,66,98,78,363,合格
20181806,37,47,73,80,69,306,合格
20181807,60,77,29,51,5,222,不合格
20181808,38,67,90,91,22,308,合格
20181809,1,23,35,99,31,189,不合格
20181810,95,98,86,7,93,379,合格
20181811,29,58,52,41,81,261,不合格
20181812,61,20,96,10,2,189,不合格
20181813,60,13,97,73,14,257,不合格
20181814,97,48,26,27,82,280,不合格
20181815,75,52,31,28,38,224,不合格
20181816,50,49,79,39,61,278,不合格
20181817,44,42,22,78,33,219,不合格
20181818,93,71,16,17,29,226,不合格
20181819,88,46,14,25,28,201,不合格
20181820,36,34,28,28,70,196,不合格
20181821,79,53,79,72,11,294,不合格
20181822,19,12,19,71,92,213,不合格
20181823,23,48,93,45,94,303,合格
20181824,94,45,27,53,46,265,不合格
20181825,85,53,65,84,78,365,合格
20181826,68,34,35,1,23,161,不合格
20181827,26,39,37,71,91,264,不合格
20181828,29,37,7,18,34,125,不合格
20181829,79,99,55,29,64,326,合格
20181830,44,96,7,16,4,167,不合格
20181831,56,29,14,67,20,186,不合格
20181832,40,63,70,50,10,233,不合格
20181833,31,39,24,63,72,229,不合格
20181834,19,35,81,58,9,202,不合格
20181835,57,28,21,45,64,215,不合格
20181836,40,81,76,17,34,248,不合格
20181837,30,96,13,30,10,179,不合格
20181838,63,36,86,71,37,293,不合格
20181839,88,96,15,90,92,381,合格
20181840,19,99,42,48,71,279,不合格
20181841,85,46,43,35,45,254,不合格
20181842,54,57,46,39,59,255,不合格
20181843,10,31,12,67,82,202,不合格
20181844,77,45,64,81,97,364,合格
20181845,41,25,48,95,30,239,不合格
20181846,58,16,22,78,22,196,不合格
20181847,61,24,81,20,5,191,不合格
20181848,2,25,75,30,59,191,不合格
20181849,92,22,66,40,31,251,不合格
20181850,11,5,70,11,90,187,不合格
20181851,80,40,99,81,50,350,合格
20181852,92,33,93,84,90,392,合格
20181853,11,21,82,55,81,250,不合格
20181854,69,16,31,60,26,202,不合格
20181855,48,58,90,95,60,351,合格
20181856,73,76,52,16,20,237,不合格
20181857,52,79,67,74,75,347,合格
20181858,27,58,1,29,45,160,不合格
20181859,82,65,55,98,20,320,合格
20181860,53,24,23,67,21,188,不合格
20181861,49,74,91,94,0,308,合格
20181862,99,29,64,58,19,269,不合格
20181863,38,82,40,31,99,290,不合格
20181864,73,74,2,96,31,276,不合格
20181865,57,92,0,53,19,221,不合格
20181866,48,36,14,29,42,169,不合格
20181867,49,69,19,81,33,251,不合格
20181868,65,12,18,28,46,169,不合格
20181869,70,38,92,32,72,304,合格
20181870,3,65,43,11,81,203,不合格
20181871,97,35,31,65,46,274,不合格
20181872,6,15,40,46,10,117,不合格
20181873,77,15,97,91,66,346,合格
20181874,5,52,97,2,57,213,不合格
20181875,69,77,31,15,11,203,不合格
20181876,38,92,11,10,27,178,不合格
20181877,76,17,65,38,41,237,不合格
20181878,46,8,86,27,92,259,不合格
20181879,58,6,87,34,53,238,不合格
20181880,60,56,38,78,68,300,合格
20181881,58,72,79,79,45,333,合格
20181882,28,73,41,29,62,233,不合格
20181883,62,24,60,51,57,254,不合格
20181884,20,46,88,12,67,233,不合格
20181885,81,22,6,75,32,216,不合格
20181886,25,74,5,32,61,197,不合格
20181887,74,98,76,88,62,398,合格
20181888,94,21,46,2,72,235,不合格
20181889,29,32,0,70,19,150,不合格
20181890,90,86,27,45,49,297,不合格
20181891,22,43,87,85,57,294,不合格
20181892,20,95,49,60,31,255,不合格
20181893,64,38,99,76,79,356,合格
20181894,84,32,89,84,7,296,不合格
20181895,75,92,46,14,94,321,合格
20181896,18,91,6,46,57,218,不合格
20181897,35,42,80,17,21,195,不合格
20181898,71,33,30,50,77,261,不合格
20181899,93,48,24,18,7,190,不合格
20181900,53,6,36,55,85,235,不合格
20181901,12,96,13,74,32,227,不合格
20181902,82,39,26,13,54,214,不合格
20181903,58,28,74,27,82,269,不合格
20181904,10,14,33,83,85,225,不合格
20181905,19,60,28,21,75,203,不合格
20181906,99,6,15,96,92,308,合格
20181907,35,35,24,45,73,212,不合格
20181908,99,2,67,36,81,285,不合格
20181909,50,73,42,96,29,290,不合格
20181910,13,99,42,98,8,260,不合格
20181911,48,19,24,17,93,201,不合格
20181912,40,28,32,0,36,136,不合格
20181913,90,89,61,5,83,328,合格
20181914,67,26,30,53,98,274,不合格
20181915,47,20,73,17,17,174,不合格
20181916,43,95,94,71,68,371,合格
20181917,97,2,16,79,27,221,不合格
20181918,80,38,38,68,19,243,不合格
20181919,64,0,93,79,76,312,合格
20181920,18,40,66,52,72,248,不合格
20181921,98,55,72,56,62,343,合格
20181922,69,50,24,29,74,246,不合格
20181923,3,33,20,68,45,169,不合格
20181924,27,64,88,22,66,267,不合格
20181925,6,68,63,51,54,242,不合格
20181926,30,23,29,57,37,176,不合格
20181927,80,99,54,86,44,363,合格
20181928,61,22,82,62,99,326,合格
20181929,36,65,85,7,72,265,不合格
20181930,89,1,31,35,67,223,不合格
20181931,36,44,64,85,8,237,不合格
20181932,1,12,34,27,72,146,不合格
20181933,34,58,67,8,19,186,不合格
20181934,12,12,41,32,41,138,不合格
20181935,50,15,93,4,98,260,不合格
20181936,96,13,69,22,74,274,不合格
20181937,18,43,63,81,82,287,不合格
20181938,81,29,47,69,5,231,不合格
20181939,99,25,90,0,27,241,不合格
20181940,48,69,99,34,0,250,不合格
20181941,92,61,98,5,15,271,不合格
20181942,56,79,35,3,52,225,不合格
20181943,40,33,64,12,29,178,不合格
20181944,78,73,40,39,33,263,不合格
20181945,33,73,44,12,20,182,不合格
20181946,18,97,43,90,12,260,不合格
20181947,3,74,2,79,51,209,不合格
20181948,74,52,51,15,76,268,不合格
20181949,20,77,96,14,10,217,不合格
20181950,81,54,37,9,61,242,不合格
20181951,64,58,47,56,64,289,不合格
20181952,49,68,35,79,54,285,不合格
20181953,8,85,61,58,75,287,不合格
20181954,91,91,86,75,58,401,合格
20181955,87,87,34,13,0,221,不合格
20181956,79,9,5,80,54,227,不合格
20181957,24,84,24,29,11,172,不合格
20181958,42,84,92,33,3,254,不合格
20181959,30,22,21,20,49,142,不合格
20181960,94,27,9,29,22,181,不合格
20181961,6,31,86,49,8,180,不合格
20181962,8,88,33,35,38,202,不合格
20181963,67,50,63,8,61,249,不合格
20181964,68,47,55,50,72,292,不合格
20181965,95,46,75,87,45,348,合格
20181966,81,92,46,84,51,354,合格
20181967,29,34,67,17,3,150,不合格
20181968,48,1,38,74,65,226,不合格
20181969,47,2,39,37,3,128,不合格
20181970,45,64,71,20,39,239,不合格
20181971,81,93,2,15,2,193,不合格
20181972,53,60,5,21,9,148,不合格
20181973,55,11,26,91,40,223,不合格
20181974,14,90,1,56,90,251,不合格
20181975,93,57,36,99,69,354,合格
20181976,5,65,24,75,7,176,不合格
20181977,36,44,78,2,89,249,不合格
20181978,17,38,25,64,46,190,不合格
20181979,46,2,59,5,2,114,不合格
20181980,41,25,83,17,5,171,不合格
20181981,87,93,50,83,47,360,合格
20181982,4,57,3,51,56,171,不合格
20181983,80,24,86,41,59,290,不合格
20181984,32,22,52,7,32,145,不合格
20181985,57,71,76,54,71,329,合格
20181986,12,98,19,29,86,244,不合格
20181987,49,59,3,79,88,278,不合格
20181988,92,29,22,9,72,224,不合格
20181989,44,90,96,38,65,333,合格
20181990,98,60,48,72,59,337,合格
20181991,82,97,93,44,60,376,合格
20181992,66,92,51,42,57,308,合格
20181993,97,88,45,79,35,344,合格
20181994,94,48,33,15,93,283,不合格
20181995,18,32,26,10,99,185,不合格
20181996,36,20,83,38,86,263,不合格
20181997,62,17,39,86,36,240,不合格
20181998,75,5,70,85,15,250,不合格
20181999,15,84,62,15,65,241,不合格
20182000,87,3,21,3,21,135,不合格
20182001,46,3,87,4,89,229,不合格
20182002,64,47,70,23,86,290,不合格
20182003,85,25,53,4,42,209,不合格
20182004,90,2,74,92,74,332,合格
20182005,88,7,24,34,13,166,不合格
20182006,48,96,58,30,44,276,不合格
20182007,33,0,17,1,16,67,不合格
20182008,98,71,45,78,35,327,合格
20182009,52,93,52,37,93,327,合格
20182010,61,23,68,19,66,237,不合格
20182011,12,24,30,61,71,198,不合格
20182012,24,21,46,79,79,249,不合格
20182013,94,27,98,60,18,297,不合格
20182014,40,64,1,7,77,189,不合格
20182015,84,82,32,20,13,231,不合格
20182016,44,46,52,34,95,271,不合格
20182017,91,99,74,99,83,446,合格
20182018,33,39,46,32,57,207,不合格
20182019,37,46,29,53,85,250,不合格
20182020,30,19,25,42,57,173,不合格
20182021,93,98,26,54,72,343,合格
20182022,23,57,45,45,36,206,不合格
20182023,84,39,85,75,27,310,合格
20182024,72,27,29,47,62,237,不合格
20182025,48,87,52,30,12,229,不合格
20182026,95,25,88,0,83,291,不合格
20182027,82,51,98,99,25,355,合格
20182028,52,98,43,73,53,319,合格
20182029,35,78,33,85,22,253,不合格
20182030,34,25,80,89,53,281,不合格
20182031,4,45,80,34,89,252,不合格
20182032,82,53,57,40,48,280,不合格
20182033,84,68,47,15,3,217,不合格
20182034,73,82,9,91,53,308,合格
20182035,58,1,11,6,39,115,不合格
20182036,47,62,38,20,62,229,不合格
20182037,31,62,13,60,41,207,不合格
20182038,92,48,30,1,46,217,不合格
20182039,92,3,6,98,28,227,不合格
20182040,13,99,91,83,8,294,不合格
20182041,21,24,6,78,62,191,不合格
20182042,8,7,50,86,9,160,不合格
20182043,17,18,47,5,58,145,不合格
20182044,39,3,14,3,49,108,不合格
20182045,92,96,70,21,76,355,合格
20182046,79,86,93,95,12,365,合格
20182047,79,74,78,38,66,335,合格
20182048,13,7,15,88,82,205,不合格
20182049,47,32,17,60,15,171,不合格
20182050,21,29,2,54,25,131,不合格
20182051,91,96,73,71,98,429,合格
20182052,21,72,71,5,99,268,不合格
20182053,73,38,3,41,86,241,不合格
20182054,70,99,21,26,27,243,不合格
20182055,56,10,11,59,55,191,不合格
20182056,47,95,57,73,37,309,合格
20182057,52,87,93,34,49,315,合格
20182058,73,72,14,64,80,303,合格
20182059,94,12,9,79,81,275,不合格
20182060,15,0,36,32,93,176,不合格
20182061,59,63,1,1,79,203,不合格
20182062,19,14,78,35,97,243,不合格
20182063,79,2,41,29,14,165,不合格
20182064,18,57,95,88,50,308,合格
20182065,44,40,77,15,88,264,不合格
20182066,53,58,30,97,69,307,合格
20182067,29,20,8,61,11,129,不合格
20182068,94,19,98,12,62,285,不合格
20182069,18,4,17,47,43,129,不合格
20182070,91,10,63,3,53,220,不合格
20182071,0,4,61,87,72,224,不合格
20182072,47,88,81,65,3,284,不合格
20182073,3,54,64,98,71,290,不合格
20182074,27,50,28,85,2,192,不合格
20182075,29,40,41,13,99,222,不合格
20182076,52,65,46,12,20,195,不合格
20182077,23,60,39,4,6,132,不合格
20182078,52,39,7,11,58,167,不合格
20182079,3,22,77,15,15,132,不合格
20182080,11,7,45,96,66,225,不合格
20182081,44,78,65,15,60,262,不合格
20182082,43,43,56,77,15,234,不合格
20182083,71,52,16,68,99,306,合格
20182084,27,83,32,72,68,282,不合格
20182085,18,89,0,35,77,219,不合格
20182086,87,96,0,49,56,288,不合格
20182087,11,57,81,31,84,264,不合格
20182088,19,99,40,35,19,212,不合格
20182089,65,22,56,2,53,198,不合格
20182090,89,53,38,44,47,271,不合格
20182091,34,32,72,2,2,142,不合格
20182092,10,50,12,74,60,206,不合格
20182093,44,73,33,35,57,242,不合格
20182094,70,0,16,14,47,147,不合格
20182095,45,42,15,11,44,157,不合格
20182096,29,61,62,87,9,248,不合格
20182097,41,43,91,59,67,301,合格
20182098,66,22,47,53,74,262,不合格
20182099,88,65,6,10,16,185,不合格
20182100,64,66,79,2,75,286,不合格
20182101,48,41,25,67,78,259,不合格
20182102,51,30,26,54,33,194,不合格
20182103,33,96,86,77,56,348,合格
20182104,36,25,21,73,4,159,不合格
20182105,15,84,26,85,99,309,合格
20182106,96,22,77,27,7,229,不合格
20182107,85,69,7,30,67,258,不合格
20182108,73,25,35,9,8,150,不合格
20182109,33,17,88,21,76,235,不合格
20182110,84,12,72,99,59,326,合格
20182111,61,71,59,88,80,359,合格
20182112,84,69,66,66,59,344,合格
20182113,79,16,97,61,20,273,不合格
20182114,18,98,5,43,35,199,不合格
20182115,41,31,38,90,38,238,不合格
20182116,90,95,81,99,19,384,合格
20182117,35,35,54,8,13,145,不合格
20182118,87,1,58,60,29,235,不合格
20182119,60,7,75,42,87,271,不合格
20182120,73,18,84,38,83,296,不合格
20182121,13,27,84,94,54,272,不合格
20182122,55,52,26,97,83,313,合格
20182123,37,14,95,52,8,206,不合格
20182124,94,47,22,62,17,242,不合格
20182125,99,16,76,39,19,249,不合格
20182126,77,7,29,10,91,214,不合格
20182127,63,46,65,84,23,281,不合格
20182128,47,56,4,76,39,222,不合格
20182129,64,71,95,30,25,285,不合格
20182130,84,6,81,19,71,261,不合格
20182131,22,62,40,69,77,270,不合格
20182132,45,75,6,52,86,264,不合格
20182133,98,44,21,82,19,264,不合格
20182134,19,33,71,22,37,182,不合格
20182135,38,25,56,82,9,210,不合格
20182136,9,60,65,49,16,199,不合格
20182137,90,26,37,46,77,276,不合格
20182138,30,23,80,20,25,178,不合格
20182139,91,82,34,77,18,302,合格
20182140,40,95,4,25,76,240,不合格
20182141,72,62,63,39,58,294,不合格
20182142,7,46,21,74,76,224,不合格
20182143,23,98,73,2,22,218,不合格
20182144,46,4,81,30,70,231,不合格
20182145,0,62,31,67,36,196,不合格
20182146,79,86,80,51,90,386,合格
20182147,74,60,87,9,45,275,不合格
20182148,77,34,18,29,65,223,不合格
20182149,43,8,33,54,23,161,不合格
20182150,10,44,77,58,47,236,不合格
20182151,12,29,86,84,83,294,不合格
20182152,63,88,61,34,30,276,不合格
20182153,84,76,76,31,18,285,不合格
20182154,97,5,64,21,18,205,不合格
20182155,11,54,62,54,47,228,不合格
20182156,67,58,12,65,85,287,不合格
20182157,95,27,22,7,83,234,不合格
20182158,88,1,44,30,28,191,不合格
20182159,7,16,31,84,85,223,不合格
20182160,4,53,16,2,7,82,不合格
20182161,44,9,72,83,50,258,不合格
20182162,57,62,34,83,7,243,不合格
20182163,64,75,35,65,36,275,不合格
20182164,7,99,58,59,59,282,不合格
20182165,38,27,47,30,32,174,不合格
20182166,27,34,36,41,28,166,不合格
20182167,39,71,98,54,64,326,合格
20182168,25,20,81,99,98,323,合格
20182169,70,31,53,95,41,290,不合格
20182170,66,96,44,26,46,278,不合格
20182171,45,88,19,3,5,160,不合格
20182172,58,2,98,70,63,291,不合格
20182173,26,81,29,85,22,243,不合格
20182174,32,40,40,72,91,275,不合格
20182175,60,14,54,12,91,231,不合格
20182176,1,16,5,22,91,135,不合格
20182177,25,63,50,59,42,239,不合格
20182178,33,99,92,77,12,313,合格
20182179,49,97,83,72,18,319,合格
20182180,68,83,26,49,59,285,不合格
20182181,66,30,7,16,4,123,不合格
20182182,51,80,38,55,6,230,不合格
20182183,96,3,38,14,51,202,不合格
20182184,52,48,48,27,21,196,不合格
20182185,34,67,94,48,56,299,不合格
20182186,86,43,4,61,41,235,不合格
20182187,42,32,35,18,64,191,不合格
20182188,76,6,93,17,8,200,不合格
20182189,11,66,92,99,10,278,不合格
20182190,91,1,88,71,63,314,合格
20182191,29,14,58,47,58,206,不合格
20182192,48,12,35,53,37,185,不合格
20182193,76,92,44,78,67,357,合格
20182194,59,47,86,21,39,252,不合格
20182195,31,8,81,89,96,305,合格
20182196,20,99,90,75,84,368,合格
20182197,31,8,21,90,84,234,不合格
20182198,72,37,22,72,97,300,合格
20182199,12,43,63,86,12,216,不合格
20182200,76,83,38,96,52,345,合格
20182201,56,37,14,40,68,215,不合格
20182202,21,37,4,40,25,127,不合格
20182203,5,70,69,24,94,262,不合格
20182204,72,38,10,48,87,255,不合格
20182205,92,74,61,96,60,383,合格
20182206,78,14,51,78,68,289,不合格
20182207,45,72,32,16,83,248,不合格
20182208,9,27,37,99,31,203,不合格
20182209,92,53,64,4,90,303,合格
20182210,69,16,99,51,37,272,不合格
20182211,82,40,67,55,67,311,合格
20182212,46,75,81,19,44,265,不合格
20182213,89,86,17,41,39,272,不合格
20182214,0,60,46,40,50,196,不合格
20182215,3,47,82,7,37,176,不合格
20182216,5,34,62,35,95,231,不合格
20182217,55,65,37,27,95,279,不合格
20182218,89,40,72,88,9,298,不合格
20182219,41,28,41,34,30,174,不合格
20182220,64,93,44,6,49,256,不合格
20182221,62,48,15,19,84,228,不合格
20182222,26,18,13,86,96,239,不合格
20182223,43,25,89,31,16,204,不合格
20182224,86,72,6,0,94,258,不合格
20182225,5,53,75,86,60,279,不合格
20182226,82,21,99,33,56,291,不合格
20182227,77,39,20,5,39,180,不合格
20182228,91,11,47,74,71,294,不合格
20182229,62,54,58,68,82,324,合格
20182230,79,99,34,0,24,236,不合格
20182231,19,58,52,79,62,270,不合格
20182232,60,90,29,84,96,359,合格
20182233,8,8,33,86,75,210,不合格
20182234,17,4,53,70,17,161,不合格
20182235,87,86,43,92,8,316,合格
20182236,3,83,72,55,1,214,不合格
20182237,80,12,41,15,42,190,不合格
20182238,93,0,10,56,54,213,不合格
20182239,47,40,6,90,46,229,不合格
20182240,17,60,98,57,87,319,合格
20182241,9,28,45,9,70,161,不合格
20182242,96,69,25,15,5,210,不合格
20182243,99,70,10,39,14,232,不合格
20182244,30,44,52,56,3,185,不合格
20182245,73,8,59,93,14,247,不合格
20182246,67,76,47,59,46,295,不合格
20182247,69,13,5,98,71,256,不合格
20182248,15,77,36,44,96,268,不合格
20182249,13,69,98,47,64,291,不合格
20182250,11,93,5,35,30,174,不合格
20182251,51,52,82,90,84,359,合格
20182252,95,28,89,14,67,293,不合格
20182253,20,58,34,12,70,194,不合格
20182254,52,90,51,63,67,323,合格
20182255,91,57,51,76,94,369,合格
20182256,27,78,82,76,47,310,合格
20182257,83,2,47,8,54,194,不合格
20182258,88,38,10,89,86,311,合格
20182259,0,96,14,90,20,220,不合格
20182260,17,53,1,80,86,237,不合格
20182261,74,17,71,10,90,262,不合格
20182262,79,31,19,40,29,198,不合格
20182263,20,69,62,73,80,304,合格
20182264,31,27,56,83,89,286,不合格
20182265,19,32,24,50,18,143,不合格
20182266,26,58,25,7,23,139,不合格
20182267,65,96,3,57,49,270,不合格
20182268,13,11,25,3,64,116,不合格
20182269,97,97,6,89,60,349,合格
20182270,80,77,40,70,74,341,合格
20182271,27,9,69,40,17,162,不合格
20182272,90,79,72,35,44,320,合格
20182273,21,94,96,86,0,297,不合格
20182274,44,49,33,70,65,261,不合格
20182275,20,4,85,68,30,207,不合格
20182276,4,66,99,34,18,221,不合格
20182277,18,58,29,88,92,285,不合格
20182278,80,91,96,64,73,404,合格
20182279,58,59,42,65,54,278,不合格
20182280,43,95,53,13,85,289,不合格
20182281,10,92,47,42,86,277,不合格
20182282,87,93,76,15,91,362,合格
20182283,8,12,13,76,93,202,不合格
20182284,15,32,59,18,5,129,不合格
20182285,88,98,91,0,99,376,合格
20182286,71,56,37,91,26,281,不合格
20182287,59,46,28,46,80,259,不合格
20182288,24,18,52,49,7,150,不合格
20182289,87,54,77,18,96,332,合格
20182290,98,85,34,62,19,298,不合格
20182291,36,98,71,9,26,240,不合格
20182292,21,59,86,75,1,242,不合格
20182293,12,99,83,46,69,309,合格
20182294,57,21,83,89,27,277,不合格
20182295,16,23,49,12,94,194,不合格
20182296,41,24,66,84,24,239,不合格
20182297,15,56,95,54,4,224,不合格
20182298,6,0,60,1,52,119,不合格
20182299,98,72,11,7,60,248,不合格
20182300,72,1,80,61,63,277,不合格
20182301,3,95,10,69,47,224,不合格
20182302,30,69,62,49,40,250,不合格
20182303,35,79,12,76,18,220,不合格
20182304,65,83,84,95,5,332,合格
20182305,85,49,18,65,48,265,不合格
20182306,30,69,26,99,18,242,不合格
20182307,6,48,78,66,11,209,不合格
20182308,33,92,99,87,55,366,合格
20182309,60,38,85,39,70,292,不合格
20182310,96,82,16,74,22,290,不合格
20182311,69,60,59,60,82,330,合格
20182312,42,88,54,22,40,246,不合格
20182313,33,34,70,47,90,274,不合格
20182314,69,8,78,11,25,191,不合格
20182315,87,0,90,81,81,339,合格
20182316,87,20,48,4,64,223,不合格
20182317,56,15,73,88,91,323,合格
20182318,79,19,6,32,32,168,不合格
20182319,25,10,77,98,41,251,不合格
20182320,3,14,30,60,5,112,不合格
20182321,10,3,71,77,33,194,不合格
20182322,7,97,65,94,98,361,合格
20182323,40,85,77,23,60,285,不合格
20182324,27,18,96,39,72,252,不合格
20182325,87,78,78,95,16,354,合格
20182326,26,68,17,55,10,176,不合格
20182327,7,98,97,85,49,336,合格
20182328,30,38,3,24,94,189,不合格
20182329,40,96,28,96,86,346,合格
20182330,26,22,35,26,25,134,不合格
20182331,62,99,10,61,78,310,合格
20182332,26,31,86,30,94,267,不合格
20182333,45,97,98,59,28,327,合格
20182334,42,41,11,38,71,203,不合格
20182335,37,20,66,35,58,216,不合格
20182336,54,64,50,78,26,272,不合格
20182337,17,26,48,34,23,148,不合格
20182338,34,34,87,69,18,242,不合格
20182339,15,56,35,51,16,173,不合格
20182340,98,31,46,1,70,246,不合格
20182341,92,33,75,1,67,268,不合格
20182342,58,48,64,12,51,233,不合格
20182343,33,89,36,44,68,270,不合格
20182344,40,43,53,44,22,202,不合格
20182345,55,26,49,40,50,220,不合格
20182346,52,67,63,33,52,267,不合格
20182347,84,65,59,55,80,343,合格
20182348,56,42,44,90,46,278,不合格
20182349,12,91,11,81,82,277,不合格
20182350,17,56,91,65,91,320,合格
20182351,26,95,55,76,90,342,合格
20182352,96,48,14,12,17,187,不合格
20182353,38,72,99,34,52,295,不合格
20182354,78,88,14,97,23,300,合格
20182355,20,78,93,19,6,216,不合格
20182356,99,30,86,98,35,348,合格
20182357,49,65,5,13,55,187,不合格
20182358,69,6,4,53,45,177,不合格
20182359,8,58,34,83,71,254,不合格
20182360,40,32,39,61,32,204,不合格
20182361,97,14,14,52,80,257,不合格
20182362,60,33,58,37,4,192,不合格
20182363,85,65,2,37,33,222,不合格
20182364,64,47,20,19,46,196,不合格
20182365,48,20,64,84,5,221,不合格
20182366,47,4,1,57,61,170,不合格
20182367,91,66,89,12,85,343,合格
20182368,41,3,38,47,46,175,不合格
20182369,28,80,61,71,62,302,合格
20182370,43,94,5,70,41,253,不合格
20182371,79,99,91,62,32,363,合格
20182372,15,22,75,96,47,255,不合格
20182373,30,41,76,92,14,253,不合格
20182374,22,77,84,94,56,333,合格
20182375,64,27,92,86,18,287,不合格
20182376,36,7,28,94,39,204,不合格
20182377,9,7,33,87,61,197,不合格
20182378,11,89,54,30,80,264,不合格
20182379,35,76,77,98,59,345,合格
20182380,93,93,35,19,20,260,不合格
20182381,89,64,89,68,48,358,合格
20182382,32,67,31,69,46,245,不合格
20182383,72,30,30,52,78,262,不合格
20182384,63,20,15,1,91,190,不合格
20182385,42,31,48,60,26,207,不合格
20182386,90,60,22,79,91,342,合格
20182387,66,81,39,38,80,304,合格
20182388,46,7,47,55,46,201,不合格
20182389,24,92,38,14,70,238,不合格
20182390,95,30,35,13,11,184,不合格
20182391,97,60,49,23,57,286,不合格
20182392,31,97,47,9,47,231,不合格
20182393,96,43,98,12,75,324,合格
20182394,14,69,6,23,86,198,不合格
20182395,28,60,67,82,88,325,合格
20182396,71,18,76,61,22,248,不合格
20182397,10,57,63,19,30,179,不合格
20182398,44,77,21,38,52,232,不合格
20182399,54,79,29,81,92,335,合格
20182400,6,65,11,65,47,194,不合格
20182401,26,37,1,29,96,189,不合格
20182402,73,2,22,4,94,195,不合格
20182403,1,67,38,82,33,221,不合格
20182404,86,92,27,4,26,235,不合格
20182405,80,79,2,70,13,244,不合格
20182406,30,96,61,87,15,289,不合格
20182407,48,76,22,7,34,187,不合格
20182408,52,94,29,54,70,299,不合格
20182409,13,11,78,59,59,220,不合格
20182410,37,98,66,23,15,239,不合格
20182411,0,11,68,70,50,199,不合格
20182412,56,54,66,12,79,267,不合格
20182413,4,10,89,46,1,150,不合格
20182414,59,75,62,40,49,285,不合格
20182415,35,74,0,88,25,222,不合格
20182416,63,78,23,26,81,271,不合格
20182417,53,88,22,92,20,275,不合格
20182418,88,92,6,38,81,305,合格
20182419,12,43,69,53,55,232,不合格
20182420,43,53,99,64,89,348,合格
20182421,16,90,52,55,76,289,不合格
20182422,51,54,45,38,75,263,不合格
20182423,94,5,93,84,36,312,合格
20182424,31,33,9,44,87,204,不合格
20182425,14,84,10,52,71,231,不合格
20182426,31,67,69,40,28,235,不合格
20182427,33,66,9,22,66,196,不合格
20182428,6,49,30,57,94,236,不合格
20182429,63,39,62,30,53,247,不合格
20182430,10,81,64,41,19,215,不合格
20182431,58,85,5,55,80,283,不合格
20182432,87,76,47,99,67,376,合格
20182433,12,87,76,9,58,242,不合格
20182434,87,81,30,33,38,269,不合格
20182435,18,2,74,79,68,241,不合格
20182436,60,35,57,35,64,251,不合格
20182437,30,23,32,97,82,264,不合格
20182438,71,70,80,13,34,268,不合格
20182439,46,92,16,97,9,260,不合格
20182440,43,30,41,36,54,204,不合格
20182441,19,89,38,30,13,189,不合格
20182442,8,7,47,2,1,65,不合格
20182443,89,33,18,30,46,216,不合格
20182444,19,51,44,55,28,197,不合格
20182445,55,16,4,24,82,181,不合格
20182446,96,12,25,49,7,189,不合格
20182447,52,80,60,67,70,329,合格
20182448,15,11,5,96,94,221,不合格
20182449,70,31,94,2,80,277,不合格
20182450,30,73,98,99,53,353,合格
20182451,35,19,39,67,73,233,不合格
20182452,94,97,99,0,60,350,合格
20182453,35,85,87,68,80,355,合格
20182454,68,87,14,74,75,318,合格
20182455,84,98,72,96,91,441,合格
20182456,50,24,92,76,91,333,合格
20182457,46,18,73,50,48,235,不合格
20182458,72,37,98,41,92,340,合格
20182459,39,30,26,37,73,205,不合格
20182460,11,67,40,7,6,131,不合格
20182461,85,19,36,98,0,238,不合格
20182462,53,65,74,54,23,269,不合格
20182463,21,12,69,4,30,136,不合格
20182464,67,41,50,93,19,270,不合格
20182465,84,97,64,11,26,282,不合格
20182466,26,57,43,26,67,219,不合格
20182467,75,93,27,79,53,327,合格
20182468,95,75,42,51,95,358,合格
20182469,30,29,64,69,24,216,不合格
20182470,78,61,75,54,45,313,合格
20182471,42,37,87,60,81,307,合格
20182472,28,11,86,73,15,213,不合格
20182473,41,77,11,1,48,178,不合格
20182474,52,88,32,14,79,265,不合格
20182475,73,50,93,48,50,314,合格
20182476,77,69,67,31,73,317,合格
20182477,93,71,23,40,67,294,不合格
20182478,56,62,48,38,54,258,不合格
20182479,87,49,24,54,32,246,不合格
20182480,51,54,15,99,17,236,不合格
20182481,38,31,26,30,11,136,不合格
20182482,39,31,1,85,35,191,不合格
20182483,32,34,20,83,24,193,不合格
20182484,26,24,10,23,72,155,不合格
20182485,60,33,94,67,1,255,不合格
20182486,45,5,62,1,58,171,不合格
20182487,4,59,63,55,59,240,不合格
20182488,59,90,7,54,37,247,不合格
20182489,5,89,43,11,7,155,不合格
20182490,36,73,99,36,15,259,不合格
20182491,63,57,77,67,62,326,合格
20182492,52,17,4,38,39,150,不合格
20182493,68,47,78,99,32,324,合格
20182494,59,58,62,94,52,325,合格
20182495,26,77,71,18,17,209,不合格
20182496,43,1,8,25,49,126,不合格
20182497,56,84,10,60,62,272,不合格
20182498,57,91,54,47,22,271,不合格
20182499,51,73,31,80,83,318,合格
20182500,35,76,76,27,84,298,不合格
20182501,6,68,73,90,14,251,不合格
20182502,62,87,40,60,85,334,合格
20182503,27,99,76,11,55,268,不合格
20182504,14,86,54,45,97,296,不合格
20182505,61,38,20,48,31,198,不合格
20182506,10,52,67,2,35,166,不合格
20182507,48,38,23,75,13,197,不合格
20182508,99,82,49,69,79,378,合格
20182509,45,82,28,24,68,247,不合格
20182510,33,80,29,83,94,319,合格
20182511,10,43,1,43,46,143,不合格
20182512,26,44,86,15,79,250,不合格
20182513,56,31,36,29,90,242,不合格
20182514,45,73,59,65,79,321,合格
20182515,88,13,76,17,69,263,不合格
20182516,75,76,44,48,54,297,不合格
20182517,98,83,94,55,73,403,合格
20182518,71,58,57,0,33,219,不合格
20182519,96,53,1,97,45,292,不合格
20182520,55,75,77,46,55,308,合格
20182521,96,34,51,33,10,224,不合格
20182522,90,64,90,52,90,386,合格
20182523,29,53,14,64,56,216,不合格
20182524,91,50,53,67,96,357,合格
20182525,57,94,8,18,1,178,不合格
20182526,54,48,28,35,84,249,不合格
20182527,80,55,97,1,83,316,合格
20182528,40,8,80,77,29,234,不合格
20182529,42,85,66,7,13,213,不合格
20182530,15,70,17,83,87,272,不合格
20182531,57,83,55,70,30,295,不合格
20182532,30,59,75,40,97,301,合格
20182533,97,48,83,95,66,389,合格
20182534,27,10,23,5,94,159,不合格
20182535,91,52,36,20,90,289,不合格
20182536,86,10,97,3,19,215,不合格
20182537,99,1,47,11,47,205,不合格
20182538,40,46,82,52,72,292,不合格
20182539,15,12,21,99,57,204,不合格
20182540,3,87,90,43,80,303,合格
20182541,47,76,6,31,62,222,不合格
20182542,26,56,25,81,4,192,不合格
20182543,9,46,8,46,9,118,不合格
20182544,36,1,91,70,61,259,不合格
20182545,29,41,94,83,23,270,不合格
20182546,90,7,0,18,66,181,不合格
20182547,56,77,62,43,51,289,不合格
20182548,41,36,73,6,80,236,不合格
20182549,61,91,90,58,82,382,合格
20182550,40,87,73,27,58,285,不合格
20182551,50,53,85,1,90,279,不合格
20182552,30,92,19,10,49,200,不合格
20182553,82,9,70,19,79,259,不合格
20182554,88,93,89,82,32,384,合格
20182555,76,1,74,28,78,257,不合格
20182556,26,87,14,15,97,239,不合格
20182557,89,94,45,16,30,274,不合格
20182558,24,39,47,55,70,235,不合格
20182559,27,82,66,29,86,290,不合格
20182560,6,17,4,84,81,192,不合格
20182561,41,37,25,12,91,206,不合格
20182562,23,25,53,71,26,198,不合格
20182563,34,14,67,74,55,244,不合格
20182564,13,56,35,92,49,245,不合格
20182565,0,28,22,14,53,117,不合格
20182566,21,13,28,7,46,115,不合格
20182567,54,99,44,82,24,303,合格
20182568,69,26,73,24,27,219,不合格
20182569,14,96,55,21,26,212,不合格
20182570,97,58,60,29,59,303,合格
20182571,33,42,90,14,19,198,不合格
20182572,21,42,93,44,53,253,不合格
20182573,96,27,81,87,43,334,合格
20182574,59,98,99,9,8,273,不合格
20182575,92,99,15,71,65,342,合格
20182576,62,1,17,25,92,197,不合格
20182577,9,98,15,49,49,220,不合格
20182578,57,67,7,58,21,210,不合格
20182579,67,50,67,83,17,284,不合格
20182580,54,84,52,87,73,350,合格
20182581,72,30,1,85,15,203,不合格
20182582,48,64,76,85,46,319,合格
20182583,58,86,14,33,54,245,不合格
20182584,17,75,71,14,13,190,不合格
20182585,35,91,54,53,31,264,不合格
20182586,96,73,96,21,17,303,合格
20182587,98,37,42,80,73,330,合格
20182588,0,97,99,2,52,250,不合格
20182589,3,11,40,56,54,164,不合格
20182590,9,62,74,29,25,199,不合格
20182591,71,51,65,94,84,365,合格
20182592,88,17,24,21,11,161,不合格
20182593,58,0,67,71,96,292,不合格
20182594,11,49,70,47,8,185,不合格
20182595,50,0,13,3,11,77,不合格
20182596,7,41,94,7,13,162,不合格
20182597,27,65,3,85,2,182,不合格
20182598,46,66,48,28,97,285,不合格
20182599,70,96,99,60,96,421,合格
20182600,49,65,90,23,31,258,不合格
20182601,95,90,91,80,31,387,合格
20182602,98,60,65,40,74,337,合格
20182603,6,19,17,23,9,74,不合格
20182604,58,19,51,98,32,258,不合格
20182605,60,29,95,63,50,297,不合格
20182606,14,50,67,31,3,165,不合格
20182607,80,37,41,1,3,162,不合格
20182608,76,75,92,1,97,341,合格
20182609,33,31,66,13,59,202,不合格
20182610,13,23,74,6,1,117,不合格
20182611,22,68,21,96,22,229,不合格
20182612,32,75,20,19,28,174,不合格
20182613,81,63,99,48,69,360,合格
20182614,60,69,25,44,4,202,不合格
20182615,4,41,98,19,91,253,不合格
20182616,4,82,7,85,25,203,不合格
20182617,38,32,96,61,80,307,合格
20182618,78,39,88,49,15,269,不合格
20182619,91,76,92,56,27,342,合格
20182620,41,23,91,5,43,203,不合格
20182621,37,10,53,84,82,266,不合格
20182622,19,28,97,49,38,231,不合格
20182623,81,66,99,97,45,388,合格
20182624,90,50,2,87,42,271,不合格
20182625,88,37,33,20,97,275,不合格
20182626,61,13,24,30,10,138,不合格
20182627,0,69,40,24,28,161,不合格
20182628,79,80,12,81,19,271,不合格
20182629,62,61,89,88,49,349,合格
20182630,72,88,54,3,30,247,不合格
20182631,17,19,92,70,70,268,不合格
20182632,53,8,36,51,12,160,不合格
20182633,37,90,13,91,87,318,合格
20182634,73,90,4,7,1,175,不合格
20182635,56,10,77,77,95,315,合格
20182636,37,2,68,15,5,127,不合格
20182637,68,65,44,85,2,264,不合格
20182638,85,15,18,48,7,173,不合格
20182639,53,7,1,40,6,107,不合格
20182640,57,80,98,45,52,332,合格
20182641,97,40,94,29,76,336,合格
20182642,93,5,94,78,86,356,合格
20182643,35,14,27,43,82,201,不合格
20182644,24,98,86,44,93,345,合格
20182645,90,58,36,36,94,314,合格
20182646,80,7,62,34,84,267,不合格
20182647,87,85,12,12,96,292,不合格
20182648,69,5,34,49,32,189,不合格
20182649,9,20,62,20,0,111,不合格
20182650,0,19,44,25,13,101,不合格
20182651,95,51,55,38,72,311,合格
20182652,93,11,44,5,13,166,不合格
20182653,25,13,22,0,74,134,不合格
20182654,85,92,31,53,0,261,不合格
20182655,66,78,21,60,6,231,不合格
20182656,69,89,91,87,91,427,合格
20182657,32,51,28,66,41,218,不合格
20182658,69,98,49,42,58,316,合格
20182659,81,69,28,57,19,254,不合格
20182660,56,1,43,98,55,253,不合格
20182661,3,0,4,99,89,195,不合格
20182662,7,84,82,92,67,332,合格
20182663,92,61,84,85,88,410,合格
20182664,26,68,73,15,84,266,不合格
20182665,57,24,56,96,22,255,不合格
20182666,6,79,89,78,41,293,不合格
20182667,46,58,67,57,84,312,合格
20182668,25,12,13,14,98,162,不合格
20182669,29,79,12,49,2,171,不合格
20182670,60,92,27,86,41,306,合格
20182671,15,14,60,74,3,166,不合格
20182672,41,1,95,6,65,208,不合格
20182673,41,53,70,27,37,228,不合格
20182674,51,89,81,95,59,375,合格
20182675,45,11,72,45,32,205,不合格
20182676,20,87,21,21,46,195,不合格
20182677,97,2,74,89,11,273,不合格
20182678,85,36,19,24,40,204,不合格
20182679,19,71,66,68,21,245,不合格
20182680,55,49,65,73,80,322,合格
20182681,26,22,76,22,13,159,不合格
20182682,24,52,35,71,4,186,不合格
20182683,9,70,56,79,14,228,不合格
20182684,34,53,25,12,96,220,不合格
20182685,56,9,10,57,60,192,不合格
20182686,4,49,63,99,27,242,不合格
20182687,21,98,41,38,69,267,不合格
20182688,98,54,33,53,90,328,合格
20182689,78,75,64,82,37,336,合格
20182690,83,73,44,91,10,301,合格
20182691,25,56,54,67,41,243,不合格
20182692,41,99,18,91,34,283,不合格
20182693,42,97,45,98,49,331,合格
20182694,91,57,2,3,79,232,不合格
20182695,51,36,75,84,11,257,不合格
20182696,90,95,94,50,63,392,合格
20182697,17,37,87,30,90,261,不合格
20182698,7,32,0,54,82,175,不合格
20182699,53,74,75,68,1,271,不合格
20182700,25,93,81,1,59,259,不合格
20182701,13,78,79,83,51,304,合格
20182702,78,10,82,92,34,296,不合格
20182703,0,52,99,78,20,249,不合格
20182704,2,20,51,60,5,138,不合格
20182705,87,31,0,57,85,260,不合格
20182706,18,1,94,53,10,176,不合格
20182707,42,96,97,37,4,276,不合格
20182708,35,12,12,91,38,188,不合格
20182709,44,1,53,14,69,181,不合格
20182710,55,60,96,13,76,300,合格
20182711,40,32,44,21,40,177,不合格
20182712,16,85,43,25,22,191,不合格
20182713,42,17,84,79,31,253,不合格
20182714,20,47,23,46,77,213,不合格
20182715,8,14,27,20,96,165,不合格
20182716,41,49,78,77,64,309,合格
20182717,66,87,4,75,44,276,不合格
20182718,59,35,99,76,48,317,合格
20182719,44,42,28,43,1,158,不合格
20182720,66,25,39,57,77,264,不合格
20182721,22,24,75,57,43,221,不合格
20182722,90,52,17,99,39,297,不合格
20182723,68,6,34,88,69,265,不合格
20182724,32,27,53,24,93,229,不合格
20182725,23,90,95,69,97,374,合格
20182726,91,80,4,88,36,299,不合格
20182727,23,45,50,46,9,173,不合格
20182728,89,31,83,21,40,264,不合格
20182729,66,23,60,83,3,235,不合格
20182730,38,49,64,29,58,238,不合格
20182731,22,1,99,1,32,155,不合格
20182732,17,28,39,92,69,245,不合格
20182733,65,49,51,56,22,243,不合格
20182734,13,36,64,76,30,219,不合格
20182735,37,90,21,43,85,276,不合格
20182736,55,30,19,48,8,160,不合格
20182737,40,48,0,98,94,280,不合格
20182738,68,3,5,18,70,164,不合格
20182739,98,85,28,34,30,275,不合格
20182740,41,30,27,73,2,173,不合格
20182741,15,16,60,32,17,140,不合格
20182742,12,69,28,40,10,159,不合格
20182743,29,98,38,60,17,242,不合格
20182744,41,92,20,66,88,307,合格
20182745,38,42,6,8,43,137,不合格
20182746,30,49,11,63,8,161,不合格
20182747,76,64,48,27,1,216,不合格
20182748,69,23,81,40,24,237,不合格
20182749,76,3,88,9,44,220,不合格
20182750,35,13,83,82,22,235,不合格
20182751,3,26,76,8,26,139,不合格
20182752,64,97,59,5,73,298,不合格
20182753,51,27,80,97,40,295,不合格
20182754,37,74,69,71,76,327,合格
20182755,45,85,28,87,54,299,不合格
20182756,92,70,95,18,45,320,合格
20182757,85,28,54,82,59,308,合格
20182758,62,69,94,2,55,282,不合格
20182759,96,30,41,41,52,260,不合格
20182760,13,70,56,89,88,316,合格
20182761,31,41,42,51,88,253,不合格
20182762,75,61,89,21,88,334,合格
20182763,51,69,24,98,12,254,不合格
20182764,75,89,67,49,53,333,合格
20182765,34,12,22,58,34,160,不合格
20182766,81,82,79,97,1,340,合格
20182767,46,34,5,1,70,156,不合格
20182768,37,93,81,44,61,316,合格
20182769,75,35,23,17,64,214,不合格
20182770,0,99,73,44,54,270,不合格
20182771,66,37,2,60,15,180,不合格
20182772,35,1,69,96,24,225,不合格
20182773,17,49,77,88,0,231,不合格
20182774,22,49,13,26,33,143,不合格
20182775,99,22,99,8,84,312,合格
20182776,68,53,29,58,58,266,不合格
20182777,75,53,44,92,30,294,不合格
20182778,81,95,83,9,84,352,合格
20182779,9,0,46,5,81,141,不合格
20182780,79,55,55,28,61,278,不合格
20182781,73,25,68,5,67,238,不合格
20182782,72,33,45,99,64,313,合格
20182783,77,45,0,1,70,193,不合格
20182784,88,44,23,8,79,242,不合格
20182785,8,27,34,66,24,159,不合格
20182786,28,54,46,4,64,196,不合格
20182787,68,9,75,92,67,311,合格
20182788,20,30,22,99,61,232,不合格
20182789,33,43,9,95,87,267,不合格
20182790,40,30,75,96,65,306,合格
20182791,14,60,60,24,28,186,不合格
20182792,24,71,82,24,97,298,不合格
20182793,48,35,48,22,58,211,不合格
20182794,35,73,12,48,68,236,不合格
20182795,17,82,58,78,9,244,不合格
20182796,49,55,56,79,69,308,合格
20182797,49,88,59,37,20,253,不合格
20182798,43,13,33,81,21,191,不合格
20182799,71,9,59,55,44,238,不合格
20182800,20,10,92,51,73,246,不合格
20182801,7,78,39,95,43,262,不合格
20182802,2,99,16,80,87,284,不合格
20182803,34,51,28,78,26,217,不合格
20182804,45,1,28,10,87,171,不合格
20182805,35,70,88,92,47,332,合格
20182806,56,66,18,74,69,283,不合格
20182807,53,37,93,67,35,285,不合格
20182808,90,19,47,18,60,234,不合格
20182809,1,14,79,6,65,165,不合格
20182810,96,92,21,8,65,282,不合格
20182811,53,88,12,93,90,336,合格
20182812,58,24,52,74,84,292,不合格
20182813,22,71,81,10,42,226,不合格
20182814,85,34,84,71,69,343,合格
20182815,18,25,15,10,85,153,不合格
20182816,73,69,74,66,6,288,不合格
20182817,40,39,11,28,11,129,不合格
20182818,2,23,38,26,14,103,不合格
20182819,28,13,53,74,70,238,不合格
20182820,10,47,78,81,84,300,合格
20182821,49,85,51,46,3,234,不合格
20182822,88,30,31,91,81,321,合格
20182823,26,30,55,54,22,187,不合格
20182824,71,94,52,51,4,272,不合格
20182825,27,73,1,69,29,199,不合格
20182826,70,47,34,65,39,255,不合格
20182827,43,42,10,1,18,114,不合格
20182828,21,4,57,47,72,201,不合格
20182829,38,1,58,52,71,220,不合格
20182830,69,2,71,2,61,205,不合格
20182831,66,1,93,71,74,305,合格
20182832,32,41,52,95,99,319,合格
20182833,0,90,51,77,64,282,不合格
20182834,3,86,98,91,20,298,不合格
20182835,0,69,62,17,38,186,不合格
20182836,32,41,64,99,75,311,合格
20182837,96,76,17,4,29,222,不合格
20182838,45,56,98,46,26,271,不合格
20182839,99,7,62,24,5,197,不合格
20182840,81,63,49,80,77,350,合格
20182841,97,11,28,32,88,256,不合格
20182842,65,81,8,21,76,251,不合格
20182843,24,15,87,41,96,263,不合格
20182844,17,90,66,98,24,295,不合格
20182845,28,3,21,67,62,181,不合格
20182846,86,58,2,4,96,246,不合格
20182847,37,41,1,99,70,248,不合格
20182848,31,11,99,72,37,250,不合格
20182849,88,74,3,45,2,212,不合格
20182850,41,0,14,55,68,178,不合格
20182851,44,35,9,18,28,134,不合格
20182852,33,44,60,52,29,218,不合格
20182853,90,25,62,94,34,305,合格
20182854,90,25,53,16,56,240,不合格
20182855,81,55,23,45,7,211,不合格
20182856,60,63,8,90,51,272,不合格
20182857,43,20,28,56,81,228,不合格
20182858,74,90,46,54,41,305,合格
20182859,28,92,66,94,93,373,合格
20182860,27,78,21,0,2,128,不合格
20182861,50,83,20,2,27,182,不合格
20182862,88,5,41,22,16,172,不合格
20182863,86,68,43,9,92,298,不合格
20182864,10,20,73,32,91,226,不合格
20182865,12,31,21,96,86,246,不合格
20182866,62,17,61,4,60,204,不合格
20182867,8,92,95,95,28,318,合格
20182868,30,41,94,87,50,302,合格
20182869,32,33,48,25,39,177,不合格
20182870,5,52,16,93,67,233,不合格
20182871,30,16,16,63,70,195,不合格
20182872,20,51,97,68,84,320,合格
20182873,64,59,63,57,24,267,不合格
20182874,13,56,35,35,33,172,不合格
20182875,55,30,78,28,92,283,不合格
20182876,82,21,41,44,63,251,不合格
20182877,31,85,13,15,89,233,不合格
20182878,57,2,37,16,33,145,不合格
20182879,19,20,82,64,21,206,不合格
20182880,19,48,35,98,42,242,不合格
20182881,89,1,80,39,36,245,不合格
20182882,32,94,13,39,53,231,不合格
20182883,35,81,71,92,15,294,不合格
20182884,81,34,75,27,54,271,不合格
20182885,5,38,31,88,89,251,不合格
20182886,58,95,58,54,69,334,合格
20182887,19,56,40,75,41,231,不合格
20182888,9,51,6,20,92,178,不合格
20182889,92,68,93,37,87,377,合格
20182890,32,11,22,19,88,172,不合格
20182891,39,8,86,96,53,282,不合格
20182892,14,48,89,42,49,242,不合格
20182893,75,16,21,77,38,227,不合格
20182894,88,0,15,48,91,242,不合格
20182895,19,29,68,72,54,242,不合格
20182896,66,1,29,99,87,282,不合格
20182897,76,5,87,19,50,237,不合格
20182898,23,13,40,95,52,223,不合格
20182899,46,38,62,81,77,304,合格
20182900,5,8,71,71,4,159,不合格
20182901,21,94,60,91,30,296,不合格
20182902,99,64,18,19,12,212,不合格
20182903,17,28,32,87,10,174,不合格
20182904,23,76,5,23,90,217,不合格
20182905,79,55,70,98,41,343,合格
20182906,9,19,49,88,82,247,不合格
20182907,35,23,60,80,91,289,不合格
20182908,91,99,32,77,68,367,合格
20182909,23,40,25,51,81,220,不合格
20182910,38,54,20,95,10,217,不合格
20182911,70,40,65,31,42,248,不合格
20182912,10,37,33,17,68,165,不合格
20182913,6,58,9,5,18,96,不合格
20182914,26,79,25,36,49,215,不合格
20182915,76,9,45,71,84,285,不合格
20182916,60,95,30,18,88,291,不合格
20182917,53,80,95,82,44,354,合格
20182918,49,29,4,20,30,132,不合格
20182919,58,58,44,39,17,216,不合格
20182920,76,70,66,4,49,265,不合格
20182921,52,37,62,77,83,311,合格
20182922,11,56,81,83,15,246,不合格
20182923,72,18,50,49,97,286,不合格
20182924,82,57,21,90,78,328,合格
20182925,79,99,52,77,66,373,合格
20182926,13,44,83,27,7,174,不合格
20182927,30,87,67,22,12,218,不合格
20182928,71,81,83,72,24,331,合格
20182929,28,15,70,68,38,219,不合格
20182930,44,87,9,13,13,166,不合格
20182931,57,5,39,63,89,253,不合格
20182932,85,94,58,25,51,313,合格
20182933,25,28,55,18,56,182,不合格
20182934,13,84,29,32,37,195,不合格
20182935,17,60,45,76,78,276,不合格
20182936,80,36,94,82,97,389,合格
20182937,15,83,35,27,92,252,不合格
20182938,94,87,19,66,45,311,合格
20182939,49,99,16,42,25,231,不合格
20182940,13,32,56,49,44,194,不合格
20182941,8,30,36,24,9,107,不合格
20182942,2,88,23,16,63,192,不合格
20182943,40,47,18,76,95,276,不合格
20182944,83,34,30,60,84,291,不合格
20182945,58,83,92,17,24,274,不合格
20182946,77,93,4,0,61,235,不合格
20182947,30,47,18,79,25,199,不合格
20182948,59,20,8,6,50,143,不合格
20182949,80,66,0,25,5,176,不合格
20182950,16,79,93,56,69,313,合格
20182951,83,27,44,20,25,199,不合格
20182952,88,28,12,40,0,168,不合格
20182953,94,21,87,59,66,327,合格
20182954,72,20,91,89,27,299,不合格
20182955,24,66,24,47,58,219,不合格
20182956,8,56,19,95,14,192,不合格
20182957,54,21,53,16,95,239,不合格
20182958,35,69,68,82,41,295,不合格
20182959,57,94,76,27,80,334,合格
20182960,41,94,19,93,50,297,不合格
20182961,35,98,55,13,22,223,不合格
20182962,78,75,36,42,23,254,不合格
20182963,73,80,80,20,11,264,不合格
20182964,89,38,40,55,38,260,不合格
20182965,52,73,64,99,5,293,不合格
20182966,57,55,57,62,97,328,合格
20182967,38,2,95,67,37,239,不合格
20182968,19,74,69,7,39,208,不合格
20182969,24,90,48,50,80,292,不合格
20182970,93,1,0,44,4,142,不合格
20182971,1,52,47,1,59,160,不合格
20182972,19,85,76,16,45,241,不合格
20182973,51,51,79,53,2,236,不合格
20182974,57,96,7,86,68,314,合格
20182975,1,96,38,54,71,260,不合格
20182976,64,65,94,93,75,391,合格
20182977,10,68,41,70,84,273,不合格
20182978,38,85,14,93,48,278,不合格
20182979,21,98,35,41,93,288,不合格
20182980,62,42,22,39,47,212,不合格
20182981,69,63,47,21,62,262,不合格
20182982,25,34,63,74,17,213,不合格
20182983,24,93,42,67,33,259,不合格
20182984,41,52,92,91,48,324,合格
20182985,21,25,79,21,82,228,不合格
20182986,33,85,60,78,33,289,不合格
20182987,70,84,49,19,86,308,合格
20182988,20,88,99,19,67,293,不合格
20182989,35,61,32,45,91,264,不合格
20182990,1,42,20,32,50,145,不合格
20182991,87,50,54,36,50,277,不合格
20182992,78,69,96,60,74,377,合格
20182993,81,18,17,76,18,210,不合格
20182994,83,62,30,59,86,320,合格
20182995,16,84,80,80,64,324,合格
20182996,66,68,63,86,20,303,合格
20182997,1,49,34,17,63,164,不合格
20182998,12,25,75,11,56,179,不合格
20182999,49,55,6,95,4,209,不合格
20183000,69,17,10,51,31,178,不合格
20183001,9,20,21,64,49,163,不合格
20183002,17,2,34,34,78,165,不合格
20183003,94,67,29,44,63,297,不合格
20183004,0,7,73,74,31,185,不合格
20183005,34,97,44,42,8,225,不合格
20183006,96,9,92,13,78,288,不合格
20183007,24,55,43,75,48,245,不合格
20183008,8,47,46,62,6,169,不合格
20183009,79,13,90,26,26,234,不合格
20183010,28,20,52,94,15,209,不合格
20183011,0,36,99,10,30,175,不合格
20183012,47,12,4,55,22,140,不合格
20183013,37,95,52,0,26,210,不合格
20183014,41,74,41,9,36,201,不合格
20183015,81,11,61,63,38,254,不合格
20183016,97,10,99,33,18,257,不合格
20183017,58,96,76,96,85,411,合格
20183018,52,20,66,90,77,305,合格
20183019,93,29,5,44,41,212,不合格
20183020,29,6,77,83,14,209,不合格
20183021,9,38,45,36,62,190,不合格
20183022,3,70,93,14,34,214,不合格
20183023,66,26,5,23,63,183,不合格
20183024,89,29,87,62,19,286,不合格
20183025,37,48,45,25,15,170,不合格
20183026,85,58,14,34,36,227,不合格
20183027,47,98,9,12,60,226,不合格
20183028,89,87,9,40,71,296,不合格
20183029,63,51,55,78,21,268,不合格
20183030,68,39,78,54,29,268,不合格
20183031,86,27,38,28,31,210,不合格
20183032,43,61,70,29,76,279,不合格
20183033,58,57,43,90,21,269,不合格
20183034,25,17,79,13,65,199,不合格
20183035,48,44,78,40,40,250,不合格
20183036,24,56,68,2,86,236,不合格
20183037,79,44,84,35,31,273,不合格
20183038,13,25,0,11,38,87,不合格
20183039,14,73,41,43,78,249,不合格
20183040,50,8,51,8,34,151,不合格
20183041,38,1,65,99,91,294,不合格
20183042,35,37,22,55,42,191,不合格
20183043,65,33,72,19,79,268,不合格
20183044,47,54,75,41,77,294,不合格
20183045,35,29,37,56,4,161,不合格
20183046,24,1,81,6,50,162,不合格
20183047,95,23,11,51,54,234,不合格
20183048,19,90,70,67,97,343,合格
20183049,12,67,17,66,72,234,不合格
20183050,15,41,90,34,20,200,不合格
20183051,48,92,29,8,19,196,不合格
20183052,31,39,0,21,23,114,不合格
20183053,80,52,2,80,27,241,不合格
20183054,57,8,8,42,88,203,不合格
20183055,89,60,69,23,76,317,合格
20183056,11,1,98,3,15,128,不合格
20183057,61,65,18,65,93,302,合格
20183058,55,15,24,95,21,210,不合格
20183059,71,84,52,59,15,281,不合格
20183060,24,76,53,7,69,229,不合格
20183061,73,49,29,30,86,267,不合格
20183062,57,67,58,91,74,347,合格
20183063,42,33,61,50,3,189,不合格
20183064,51,2,98,38,71,260,不合格
20183065,43,93,70,49,55,310,合格
20183066,65,87,22,32,48,254,不合格
20183067,57,23,9,60,4,153,不合格
20183068,97,74,54,2,38,265,不合格
20183069,28,85,81,63,88,345,合格
20183070,40,14,28,18,26,126,不合格
20183071,32,2,12,96,34,176,不合格
20183072,83,65,53,26,79,306,合格
20183073,33,93,55,40,21,242,不合格
20183074,42,94,38,26,58,258,不合格
20183075,71,91,92,32,46,332,合格
20183076,44,83,21,2,87,237,不合格
20183077,4,27,11,65,43,150,不合格
20183078,60,51,85,60,12,268,不合格
20183079,69,21,21,99,53,263,不合格
20183080,1,66,67,12,34,180,不合格
20183081,87,84,1,72,61,305,合格
20183082,59,8,55,32,29,183,不合格
20183083,1,75,19,96,38,229,不合格
20183084,37,67,38,57,71,270,不合格
20183085,55,29,17,24,10,135,不合格
20183086,0,98,33,8,40,179,不合格
20183087,5,25,70,57,80,237,不合格
20183088,19,97,92,51,70,329,合格
20183089,55,4,77,77,82,295,不合格
20183090,32,58,70,39,38,237,不合格
20183091,90,92,59,99,22,362,合格
20183092,5,33,20,28,23,109,不合格
20183093,50,35,23,0,36,144,不合格
20183094,60,70,16,63,53,262,不合格
20183095,43,88,5,16,27,179,不合格
20183096,76,44,38,40,84,282,不合格
20183097,19,96,13,85,53,266,不合格
20183098,27,77,36,65,86,291,不合格
20183099,52,14,33,48,67,214,不合格
20183100,5,47,4,63,69,188,不合格
20183101,42,83,45,63,49,282,不合格
20183102,98,61,92,72,20,343,合格
20183103,59,76,65,94,3,297,不合格
20183104,80,79,66,23,2,250,不合格
20183105,71,29,84,10,72,266,不合格
20183106,8,57,8,21,74,168,不合格
20183107,86,82,38,81,93,380,合格
20183108,35,59,98,70,45,307,合格
20183109,73,5,61,28,87,254,不合格
20183110,97,65,98,59,84,403,合格
20183111,28,11,20,30,81,170,不合格
20183112,31,64,60,52,82,289,不合格
20183113,27,87,30,30,37,211,不合格
20183114,99,88,55,69,12,323,合格
20183115,93,28,11,83,48,263,不合格
20183116,22,96,74,24,11,227,不合格
20183117,29,34,17,55,24,159,不合格
20183118,85,86,71,56,73,371,合格
20183119,45,97,12,16,86,256,不合格
20183120,79,49,54,57,56,295,不合格
20183121,75,74,63,99,50,361,合格
20183122,22,85,24,33,83,247,不合格
20183123,89,31,20,58,94,292,不合格
20183124,64,31,16,75,27,213,不合格
20183125,77,85,37,15,68,282,不合格
20183126,69,66,55,9,37,236,不合格
20183127,35,38,27,22,3,125,不合格
20183128,27,72,71,66,29,265,不合格
20183129,14,0,82,6,18,120,不合格
20183130,33,71,27,53,53,237,不合格
20183131,74,76,69,68,21,308,合格
20183132,7,91,29,73,31,231,不合格
20183133,86,0,91,41,60,278,不合格
20183134,94,13,85,88,51,331,合格
20183135,50,8,34,60,62,214,不合格
20183136,69,69,68,92,75,373,合格
20183137,39,69,51,64,8,231,不合格
20183138,72,40,65,49,21,247,不合格
20183139,45,8,82,41,88,264,不合格
20183140,66,6,42,27,84,225,不合格
20183141,59,64,12,78,94,307,合格
20183142,75,13,21,82,40,231,不合格
20183143,43,56,3,66,71,239,不合格
20183144,97,37,22,49,36,241,不合格
20183145,45,50,29,99,38,261,不合格
20183146,76,98,16,55,94,339,合格
20183147,60,60,76,68,79,343,合格
20183148,74,85,81,75,59,374,合格
20183149,99,45,40,38,6,228,不合格
20183150,59,86,91,62,12,310,合格
20183151,45,62,34,51,86,278,不合格
20183152,82,26,59,5,86,258,不合格
20183153,10,65,61,76,91,303,合格
20183154,61,9,45,35,92,242,不合格
20183155,5,82,40,27,52,206,不合格
20183156,50,3,54,87,61,255,不合格
20183157,23,77,85,49,95,329,合格
20183158,21,57,91,24,8,201,不合格
20183159,5,9,60,19,97,190,不合格
20183160,24,17,26,41,58,166,不合格
20183161,65,87,73,9,55,289,不合格
20183162,8,5,40,53,89,195,不合格
20183163,62,46,54,51,49,262,不合格
20183164,18,8,64,31,62,183,不合格
20183165,25,96,44,54,84,303,合格
20183166,51,53,84,80,79,347,合格
20183167,32,75,32,74,1,214,不合格
20183168,38,11,42,75,9,175,不合格
20183169,42,3,77,97,99,318,合格
20183170,93,49,47,17,69,275,不合格
20183171,20,87,30,19,95,251,不合格
20183172,29,94,57,79,23,282,不合格
20183173,31,28,67,29,13,168,不合格
20183174,97,58,86,81,41,363,合格
20183175,55,24,53,79,3,214,不合格
20183176,51,17,42,24,2,136,不合格
20183177,77,24,5,81,5,192,不合格
20183178,4,46,9,32,86,177,不合格
20183179,81,66,85,47,71,350,合格
20183180,52,20,63,39,71,245,不合格
20183181,1,18,31,51,80,181,不合格
20183182,82,2,76,77,71,308,合格
20183183,37,24,57,4,25,147,不合格
20183184,43,20,28,93,69,253,不合格
20183185,7,79,6,96,56,244,不合格
20183186,32,1,73,55,16,177,不合格
20183187,12,61,35,4,3,115,不合格
20183188,67,13,26,54,69,229,不合格
20183189,96,80,29,6,22,233,不合格
20183190,19,14,59,33,44,169,不合格
20183191,78,49,58,82,92,359,合格
20183192,80,34,57,74,96,341,合格
20183193,42,78,3,1,72,196,不合格
20183194,93,52,30,31,37,243,不合格
20183195,82,0,90,88,87,347,合格
20183196,12,5,83,74,80,254,不合格
20183197,76,11,63,44,41,235,不合格
20183198,86,57,91,64,50,348,合格
20183199,72,71,57,48,82,330,合格
20183200,96,87,46,40,79,348,合格
20183201,6,44,90,43,39,222,不合格
20183202,73,15,39,74,93,294,不合格
20183203,96,76,8,17,11,208,不合格
20183204,43,81,99,56,40,319,合格
20183205,70,27,19,71,89,276,不合格
20183206,44,12,47,34,53,190,不合格
20183207,19,60,8,20,93,200,不合格
20183208,85,15,77,90,5,272,不合格
20183209,48,20,80,77,83,308,合格
20183210,29,74,16,67,61,247,不合格
20183211,54,49,45,42,49,239,不合格
20183212,31,30,90,78,97,326,合格
20183213,93,49,92,7,19,260,不合格
20183214,38,37,87,80,88,330,合格
20183215,11,28,50,96,11,196,不合格
20183216,11,99,69,25,25,229,不合格
20183217,21,92,72,76,44,305,合格
20183218,65,76,28,32,46,247,不合格
20183219,94,76,78,0,16,264,不合格
20183220,99,2,33,91,35,260,不合格
20183221,55,28,28,33,23,167,不合格
20183222,0,34,48,44,14,140,不合格
20183223,56,20,7,36,9,128,不合格
20183224,25,76,31,94,72,298,不合格
20183225,62,68,91,70,60,351,合格
20183226,73,42,88,65,70,338,合格
20183227,16,22,83,15,20,156,不合格
20183228,4,7,24,32,96,163,不合格
20183229,80,29,24,28,23,184,不合格
20183230,52,71,41,16,45,225,不合格
20183231,80,89,98,21,78,366,合格
20183232,5,57,74,84,97,317,合格
20183233,93,81,13,20,70,277,不合格
20183234,40,56,14,6,5,121,不合格
20183235,99,55,79,8,85,326,合格
20183236,55,79,63,95,58,350,合格
20183237,72,83,74,72,61,362,合格
20183238,18,38,15,97,46,214,不合格
20183239,27,88,85,53,59,312,合格
20183240,96,36,11,67,81,291,不合格
20183241,72,0,83,93,3,251,不合格
20183242,19,52,90,84,81,326,合格
20183243,86,7,26,47,55,221,不合格
20183244,67,63,8,42,79,259,不合格
20183245,46,35,23,24,92,220,不合格
20183246,13,61,84,9,9,176,不合格
20183247,7,97,5,73,61,243,不合格
20183248,24,88,39,21,68,240,不合格
20183249,2,82,83,41,30,238,不合格
20183250,71,94,20,15,12,212,不合格
20183251,63,13,68,5,42,191,不合格
20183252,60,94,74,54,89,371,合格
20183253,53,52,51,86,31,273,不合格
20183254,6,70,59,70,49,254,不合格
20183255,92,0,58,25,49,224,不合格
20183256,5,29,14,90,13,151,不合格
20183257,8,47,35,2,46,138,不合格
20183258,27,79,19,88,76,289,不合格
20183259,37,58,38,70,97,300,合格
20183260,90,77,73,14,58,312,合格
20183261,37,76,2,67,45,227,不合格
20183262,78,46,9,89,31,253,不合格
20183263,75,82,82,3,44,286,不合格
20183264,37,88,86,99,62,372,合格
20183265,53,94,64,45,35,291,不合格
20183266,69,46,33,24,69,241,不合格
20183267,24,27,65,64,73,253,不合格
20183268,59,22,32,75,89,277,不合格
20183269,96,86,4,43,82,311,合格
20183270,10,15,31,13,21,90,不合格
20183271,72,28,45,7,17,169,不合格
20183272,66,11,80,84,95,336,合格
20183273,35,73,9,96,74,287,不合格
20183274,36,44,28,7,69,184,不合格
20183275,13,16,70,48,20,167,不合格
20183276,42,39,13,63,18,175,不合格
20183277,51,64,7,74,45,241,不合格
20183278,66,90,59,73,73,361,合格
20183279,20,98,31,18,20,187,不合格
20183280,12,90,20,38,36,196,不合格
20183281,10,39,95,1,60,205,不合格
20183282,97,4,9,33,59,202,不合格
20183283,54,95,20,22,19,210,不合格
20183284,96,74,57,39,1,267,不合格
20183285,63,36,83,67,46,295,不合格
20183286,2,49,15,33,68,167,不合格
20183287,37,47,27,35,25,171,不合格
20183288,11,92,82,92,76,353,合格
20183289,73,42,35,48,48,246,不合格
20183290,53,76,56,47,87,319,合格
20183291,74,0,34,49,41,198,不合格
20183292,8,11,96,39,21,175,不合格
20183293,40,26,82,54,5,207,不合格
20183294,79,73,15,88,65,320,合格
20183295,58,48,58,4,21,189,不合格
20183296,73,14,77,63,33,260,不合格
20183297,65,74,81,60,41,321,合格
20183298,10,60,53,1,94,218,不合格
20183299,4,29,89,61,18,201,不合格
20183300,47,82,31,91,24,275,不合格
20183301,76,64,70,75,42,327,合格
20183302,69,38,18,2,83,210,不合格
20183303,90,14,42,44,50,240,不合格
20183304,46,59,86,16,74,281,不合格
20183305,43,7,78,15,72,215,不合格
20183306,90,17,58,57,52,274,不合格
20183307,85,8,63,33,5,194,不合格
20183308,60,1,66,24,81,232,不合格
20183309,15,16,82,77,66,256,不合格
20183310,84,3,58,2,61,208,不合格
20183311,10,4,59,28,0,101,不合格
20183312,79,71,70,39,33,292,不合格
20183313,76,34,13,33,73,229,不合格
20183314,88,81,96,43,41,349,合格
20183315,49,22,12,47,30,160,不合格
20183316,94,17,86,53,39,289,不合格
20183317,45,95,90,41,36,307,合格
20183318,9,79,74,18,34,214,不合格
20183319,7,81,56,59,32,235,不合格
20183320,39,79,60,16,29,223,不合格
20183321,55,48,15,60,10,188,不合格
20183322,59,45,14,27,68,213,不合格
20183323,68,91,2,49,16,226,不合格
20183324,10,38,75,52,84,259,不合格
20183325,3,96,49,11,67,226,不合格
20183326,6,58,60,47,23,194,不合格
20183327,26,91,90,8,43,258,不合格
20183328,66,45,71,39,93,314,合格
20183329,35,1,10,66,74,186,不合格
20183330,53,74,94,50,88,359,合格
20183331,33,44,28,81,50,236,不合格
20183332,22,19,39,14,89,183,不合格
20183333,53,46,57,62,93,311,合格
20183334,59,67,26,81,81,314,合格
20183335,85,59,65,97,24,330,合格
20183336,97,70,8,92,40,307,合格
20183337,95,69,34,15,82,295,不合格
20183338,58,62,71,68,0,259,不合格
20183339,67,62,86,43,82,340,合格
20183340,84,8,66,14,67,239,不合格
20183341,24,4,15,41,50,134,不合格
20183342,8,97,63,68,38,274,不合格
20183343,6,54,82,33,32,207,不合格
20183344,94,65,34,85,58,336,合格
20183345,89,84,89,69,84,415,合格
20183346,95,38,66,40,62,301,合格
20183347,20,58,40,72,22,212,不合格
20183348,68,88,13,41,18,228,不合格
20183349,29,73,64,65,79,310,合格
20183350,2,52,77,50,92,273,不合格
20183351,26,38,27,88,73,252,不合格
20183352,33,74,5,15,56,183,不合格
20183353,86,82,27,32,77,304,合格
20183354,79,49,85,65,7,285,不合格
20183355,80,74,21,42,81,298,不合格
20183356,2,73,11,63,83,232,不合格
20183357,14,85,67,1,73,240,不合格
20183358,55,92,18,9,31,205,不合格
20183359,79,93,90,33,63,358,合格
20183360,29,84,96,13,83,305,合格
20183361,74,46,13,14,2,149,不合格
20183362,63,28,30,2,39,162,不合格
20183363,82,61,93,84,1,321,合格
20183364,91,40,19,35,7,192,不合格
20183365,63,43,49,10,14,179,不合格
20183366,95,37,18,48,28,226,不合格
20183367,96,23,86,51,19,275,不合格
20183368,54,25,17,7,86,189,不合格
20183369,13,97,5,68,20,203,不合格
20183370,47,68,83,53,44,295,不合格
20183371,40,85,52,92,48,317,合格
20183372,98,88,65,67,55,373,合格
20183373,87,44,74,75,68,348,合格
20183374,53,68,54,1,80,256,不合格
20183375,66,34,81,51,48,280,不合格
20183376,66,24,76,79,12,257,不合格
20183377,24,22,68,85,92,291,不合格
20183378,92,34,38,15,62,241,不合格
20183379,33,69,85,41,83,311,合格
20183380,84,4,74,24,64,250,不合格
20183381,6,99,23,86,19,233,不合格
20183382,96,4,80,66,91,337,合格
20183383,45,37,93,59,31,265,不合格
20183384,77,46,44,93,87,347,合格
20183385,66,19,53,29,86,253,不合格
20183386,78,95,2,9,88,272,不合格
20183387,40,1,4,73,6,124,不合格
20183388,80,76,94,90,76,416,合格
20183389,9,0,16,56,50,131,不合格
20183390,42,40,64,49,64,259,不合格
20183391,2,6,42,91,15,156,不合格
20183392,13,40,29,71,1,154,不合格
20183393,2,52,67,99,25,245,不合格
20183394,27,20,44,57,42,190,不合格
20183395,82,34,40,32,34,222,不合格
20183396,94,41,74,5,81,295,不合格
20183397,98,66,5,64,81,314,合格
20183398,14,9,61,94,55,233,不合格
20183399,24,75,33,90,58,280,不合格
20183400,47,40,99,98,20,304,合格
20183401,86,74,39,18,21,238,不合格
20183402,64,97,84,79,13,337,合格
20183403,80,84,53,91,56,364,合格
20183404,47,93,78,90,31,339,合格
20183405,46,96,36,72,97,347,合格
20183406,43,46,85,26,82,282,不合格
20183407,27,76,15,75,47,240,不合格
20183408,53,92,38,41,94,318,合格
20183409,38,21,97,82,88,326,合格
20183410,40,99,74,85,31,329,合格
20183411,96,23,56,66,68,309,合格
20183412,32,32,59,55,11,189,不合格
20183413,83,22,92,87,81,365,合格
20183414,15,68,5,54,38,180,不合格
20183415,55,97,97,1,39,289,不合格
20183416,49,3,45,78,7,182,不合格
20183417,28,97,28,76,55,284,不合格
20183418,19,32,79,13,76,219,不合格
20183419,59,42,80,9,46,236,不合格
20183420,63,79,10,10,46,208,不合格
20183421,14,42,5,62,81,204,不合格
20183422,41,46,33,35,29,184,不合格
20183423,25,65,40,72,64,266,不合格
20183424,59,2,22,81,31,195,不合格
20183425,36,65,83,63,27,274,不合格
20183426,24,67,28,12,3,134,不合格
20183427,67,16,20,59,37,199,不合格
20183428,52,69,60,39,54,274,不合格
20183429,30,0,38,89,98,255,不合格
20183430,29,21,52,82,75,259,不合格
20183431,88,27,37,73,70,295,不合格
20183432,6,52,69,75,40,242,不合格
20183433,88,2,45,61,69,265,不合格
20183434,17,60,68,60,50,255,不合格
20183435,58,2,79,93,74,306,合格
20183436,82,47,77,36,33,275,不合格
20183437,59,23,46,47,15,190,不合格
20183438,27,45,4,51,67,194,不合格
20183439,71,64,67,94,13,309,合格
20183440,50,6,95,5,48,204,不合格
20183441,50,5,89,76,1,221,不合格
20183442,54,37,83,52,67,293,不合格
20183443,72,56,96,54,58,336,合格
20183444,7,61,3,45,83,199,不合格
20183445,89,81,93,67,4,334,合格
20183446,18,80,55,63,63,279,不合格
20183447,92,6,84,93,59,334,合格
20183448,24,50,96,57,58,285,不合格
20183449,54,59,90,21,25,249,不合格
20183450,94,11,58,85,38,286,不合格
20183451,19,72,67,60,37,255,不合格
20183452,95,59,79,25,95,353,合格
20183453,2,97,79,86,56,320,合格
20183454,82,57,47,89,43,318,合格
20183455,12,86,81,90,27,296,不合格
20183456,20,89,68,52,73,302,合格
20183457,88,62,68,36,83,337,合格
20183458,46,93,24,67,93,323,合格
20183459,60,55,99,96,96,406,合格
20183460,96,44,94,72,14,320,合格
20183461,13,38,9,81,57,198,不合格
20183462,91,82,21,80,65,339,合格
20183463,33,99,38,77,59,306,合格
20183464,32,6,35,93,16,182,不合格
20183465,46,45,65,44,62,262,不合格
20183466,29,20,47,24,36,156,不合格
20183467,65,2,9,35,50,161,不合格
20183468,85,86,6,42,74,293,不合格
20183469,58,84,33,12,36,223,不合格
20183470,23,17,38,51,76,205,不合格
20183471,41,67,32,45,78,263,不合格
20183472,37,6,79,92,78,292,不合格
20183473,39,19,65,13,50,186,不合格
20183474,16,96,25,24,68,229,不合格
20183475,80,88,77,79,16,340,合格
20183476,63,82,90,66,77,378,合格
20183477,99,64,4,15,57,239,不合格
20183478,0,62,50,19,75,206,不合格
20183479,65,45,34,12,16,172,不合格
20183480,42,82,29,49,12,214,不合格
20183481,73,37,26,0,38,174,不合格
20183482,14,68,39,21,94,236,不合格
20183483,4,58,1,49,92,204,不合格
20183484,98,91,37,25,85,336,合格
20183485,78,82,8,70,61,299,不合格
20183486,40,98,86,76,45,345,合格
20183487,21,91,99,89,62,362,合格
20183488,40,35,23,43,21,162,不合格
20183489,22,38,66,95,41,262,不合格
20183490,62,27,62,92,6,249,不合格
20183491,84,17,44,14,30,189,不合格
20183492,25,14,95,18,60,212,不合格
20183493,87,62,17,47,19,232,不合格
20183494,87,44,0,9,79,219,不合格
20183495,3,98,89,83,47,320,合格
20183496,63,34,63,17,75,252,不合格
20183497,45,67,58,82,76,328,合格
20183498,12,47,33,61,4,157,不合格
20183499,53,75,34,42,94,298,不合格
20183500,22,56,82,45,73,278,不合格
20183501,24,6,80,68,5,183,不合格
20183502,21,31,41,29,1,123,不合格
20183503,7,45,84,49,32,217,不合格
20183504,7,54,65,66,43,235,不合格
20183505,92,25,88,7,94,306,合格
20183506,95,78,79,98,8,358,合格
20183507,86,27,21,72,65,271,不合格
20183508,52,17,43,47,56,215,不合格
20183509,98,43,10,80,84,315,合格
20183510,65,62,51,47,83,308,合格
20183511,54,45,6,42,54,201,不合格
20183512,24,77,45,52,2,200,不合格
20183513,28,49,48,84,21,230,不合格
20183514,33,6,95,94,91,319,合格
20183515,19,6,22,13,4,64,不合格
20183516,26,54,55,10,54,199,不合格
20183517,64,7,53,19,44,187,不合格
20183518,62,14,58,36,81,251,不合格
20183519,97,61,33,53,92,336,合格
20183520,73,93,12,98,72,348,合格
20183521,86,41,4,80,32,243,不合格
20183522,16,4,21,30,15,86,不合格
20183523,67,4,97,35,91,294,不合格
20183524,44,81,38,28,26,217,不合格
20183525,42,17,33,30,35,157,不合格
20183526,37,90,95,9,46,277,不合格
20183527,24,13,94,12,91,234,不合格
20183528,71,36,15,25,24,171,不合格
20183529,70,42,95,29,8,244,不合格
20183530,48,96,21,47,89,301,合格
20183531,40,47,62,71,30,250,不合格
20183532,48,75,44,52,80,299,不合格
20183533,13,4,20,8,44,89,不合格
20183534,94,7,51,38,37,227,不合格
20183535,80,65,36,43,34,258,不合格
20183536,66,39,18,79,92,294,不合格
20183537,91,4,54,95,85,329,合格
20183538,18,19,22,92,45,196,不合格
20183539,53,53,4,21,17,148,不合格
20183540,25,39,41,8,81,194,不合格
20183541,23,1,20,90,57,191,不合格
20183542,50,93,89,84,14,330,合格
20183543,86,18,5,96,88,293,不合格
20183544,2,62,71,4,47,186,不合格
20183545,61,22,37,75,38,233,不合格
20183546,42,83,68,68,89,350,合格
20183547,89,11,34,94,36,264,不合格
20183548,30,58,11,48,37,184,不合格
20183549,62,97,1,8,11,179,不合格
20183550,53,51,87,45,97,333,合格
20183551,96,59,19,11,38,223,不合格
20183552,80,32,68,97,77,354,合格
20183553,82,98,19,16,61,276,不合格
20183554,35,14,21,78,42,190,不合格
20183555,5,76,18,87,0,186,不合格
20183556,99,70,66,16,9,260,不合格
20183557,20,32,43,22,28,145,不合格
20183558,18,91,8,91,95,303,合格
20183559,87,34,95,42,88,346,合格
20183560,16,22,27,68,40,173,不合格
20183561,51,74,33,20,81,259,不合格
20183562,6,3,80,40,78,207,不合格
20183563,37,16,74,36,77,240,不合格
20183564,0,78,76,58,25,237,不合格
20183565,61,48,19,82,65,275,不合格
20183566,28,6,83,67,31,215,不合格
20183567,14,91,17,46,47,215,不合格
20183568,78,57,16,54,96,301,合格
20183569,39,82,45,25,93,284,不合格
20183570,24,70,8,26,78,206,不合格
20183571,77,73,28,50,48,276,不合格
20183572,84,38,68,89,7,286,不合格
20183573,1,36,25,13,50,125,不合格
20183574,23,89,94,43,74,323,合格
20183575,89,89,53,38,47,316,合格
20183576,55,15,34,96,86,286,不合格
20183577,51,72,32,13,65,233,不合格
20183578,28,35,69,32,22,186,不合格
20183579,69,41,18,5,19,152,不合格
20183580,69,97,24,60,96,346,合格
20183581,77,37,89,62,81,346,合格
20183582,64,93,64,47,98,366,合格
20183583,35,17,33,53,79,217,不合格
20183584,9,96,63,0,52,220,不合格
20183585,85,62,52,12,31,242,不合格
20183586,10,61,5,45,18,139,不合格
20183587,49,83,82,6,49,269,不合格
20183588,89,28,10,40,73,240,不合格
20183589,74,50,0,13,11,148,不合格
20183590,18,3,72,21,5,119,不合格
20183591,53,51,63,65,75,307,合格
20183592,9,65,23,46,97,240,不合格
20183593,97,16,36,36,23,208,不合格
20183594,26,61,76,7,24,194,不合格
20183595,77,22,70,89,89,347,合格
20183596,85,81,16,29,5,216,不合格
20183597,37,22,63,25,43,190,不合格
20183598,9,5,15,1,63,93,不合格
20183599,32,89,68,25,81,295,不合格
20183600,93,94,8,85,71,351,合格
20183601,8,12,2,50,59,131,不合格
20183602,94,24,67,60,79,324,合格
20183603,48,33,39,21,90,231,不合格
20183604,43,78,10,51,36,218,不合格
20183605,50,74,7,98,20,249,不合格
20183606,49,30,92,31,72,274,不合格
20183607,17,79,64,70,43,273,不合格
20183608,1,46,81,97,38,263,不合格
20183609,11,3,8,94,55,171,不合格
20183610,91,60,3,50,70,274,不合格
20183611,86,76,15,98,51,326,合格
20183612,67,69,63,90,41,330,合格
20183613,20,18,14,60,75,187,不合格
20183614,5,45,3,25,17,95,不合格
20183615,71,5,7,40,38,161,不合格
20183616,13,54,40,96,37,240,不合格
20183617,24,82,38,67,22,233,不合格
20183618,81,98,36,22,64,301,合格
20183619,3,74,17,88,6,188,不合格
20183620,7,4,50,95,39,195,不合格
20183621,44,58,83,26,97,308,合格
20183622,20,69,9,51,38,187,不合格
20183623,62,25,83,49,58,277,不合格
20183624,26,91,99,79,47,342,合格
20183625,30,95,42,25,2,194,不合格
20183626,26,93,36,96,63,314,合格
20183627,58,79,70,84,21,312,合格
20183628,53,41,24,45,19,182,不合格
20183629,30,60,62,53,86,291,不合格
20183630,1,30,40,86,60,217,不合格
20183631,79,7,99,32,83,300,合格
20183632,82,46,71,57,82,338,合格
20183633,66,21,77,4,16,184,不合格
20183634,9,73,77,1,14,174,不合格
20183635,35,34,61,37,64,231,不合格
20183636,68,56,61,36,13,234,不合格
20183637,80,89,19,86,0,274,不合格
20183638,55,14,41,86,21,217,不合格
20183639,45,41,29,14,74,203,不合格
20183640,90,65,84,89,30,358,合格
20183641,58,72,84,57,33,304,合格
20183642,93,78,98,15,43,327,合格
20183643,65,61,64,69,98,357,合格
20183644,15,14,3,47,13,92,不合格
20183645,86,80,70,77,4,317,合格
20183646,44,65,83,86,88,366,合格
20183647,17,96,24,42,63,242,不合格
20183648,78,94,47,11,61,291,不合格
20183649,28,27,87,37,3,182,不合格
20183650,37,46,82,38,39,242,不合格
20183651,35,58,44,29,79,245,不合格
20183652,67,87,76,96,43,369,合格
20183653,32,31,12,72,70,217,不合格
20183654,69,30,39,70,38,246,不合格
20183655,60,97,31,40,31,259,不合格
20183656,90,23,86,16,85,300,合格
20183657,89,72,41,39,50,291,不合格
20183658,0,43,93,26,38,200,不合格
20183659,35,95,87,93,3,313,合格
20183660,87,0,68,9,78,242,不合格
20183661,84,36,81,93,55,349,合格
20183662,67,64,86,95,21,333,合格
20183663,91,27,40,32,32,222,不合格
20183664,45,65,24,12,30,176,不合格
20183665,21,36,58,91,35,241,不合格
20183666,92,64,62,79,13,310,合格
20183667,39,72,51,58,2,222,不合格
20183668,83,79,88,23,6,279,不合格
20183669,89,37,64,65,40,295,不合格
20183670,23,1,76,98,3,201,不合格
20183671,18,96,90,56,15,275,不合格
20183672,40,90,18,72,16,236,不合格
20183673,1,88,87,83,49,308,合格
20183674,88,64,90,45,7,294,不合格
20183675,28,15,37,68,5,153,不合格
20183676,22,46,71,65,26,230,不合格
20183677,61,64,60,18,91,294,不合格
20183678,13,75,9,9,93,199,不合格
20183679,60,57,30,21,68,236,不合格
20183680,71,16,88,22,89,286,不合格
20183681,96,64,21,33,78,292,不合格
20183682,31,50,67,69,91,308,合格
20183683,89,0,35,42,33,199,不合格
20183684,5,94,59,27,24,209,不合格
20183685,69,98,9,16,21,213,不合格
20183686,25,53,27,8,61,174,不合格
20183687,84,4,19,57,62,226,不合格
20183688,35,82,1,61,12,191,不合格
20183689,61,57,44,59,65,286,不合格
20183690,55,21,90,79,42,287,不合格
20183691,53,88,78,64,58,341,合格
20183692,61,24,57,4,44,190,不合格
20183693,10,98,72,7,99,286,不合格
20183694,58,21,25,88,43,235,不合格
20183695,17,7,77,38,32,171,不合格
20183696,14,19,35,98,46,212,不合格
20183697,84,49,34,31,19,217,不合格
20183698,70,53,61,75,86,345,合格
20183699,54,2,46,31,51,184,不合格
20183700,67,77,41,62,77,324,合格
20183701,33,73,18,88,56,268,不合格
20183702,34,59,29,78,16,216,不合格
20183703,87,39,61,36,48,271,不合格
20183704,40,23,53,4,7,127,不合格
20183705,66,49,98,92,89,394,合格
20183706,50,29,44,22,61,206,不合格
20183707,58,91,44,38,20,251,不合格
20183708,98,13,59,13,52,235,不合格
20183709,25,44,6,90,94,259,不合格
20183710,99,35,57,4,71,266,不合格
20183711,98,27,74,45,17,261,不合格
20183712,25,23,74,19,13,154,不合格
20183713,54,97,2,62,69,284,不合格
20183714,61,45,42,14,91,253,不合格
20183715,95,23,44,72,61,295,不合格
20183716,31,64,50,90,5,240,不合格
20183717,69,15,13,4,13,114,不合格
20183718,7,94,90,75,66,332,合格
20183719,38,72,7,62,72,251,不合格
20183720,26,61,73,92,53,305,合格
20183721,21,49,35,72,30,207,不合格
20183722,4,55,70,72,8,209,不合格
20183723,67,83,90,68,87,395,合格
20183724,26,35,5,56,0,122,不合格
20183725,29,82,80,28,6,225,不合格
20183726,65,16,26,35,73,215,不合格
20183727,24,67,13,32,62,198,不合格
20183728,86,72,20,40,65,283,不合格
20183729,22,57,54,25,33,191,不合格
20183730,2,39,31,66,59,197,不合格
20183731,1,45,17,56,58,177,不合格
20183732,69,49,19,48,68,253,不合格
20183733,1,64,39,32,21,157,不合格
20183734,61,32,33,0,10,136,不合格
20183735,53,66,3,83,20,225,不合格
20183736,10,68,92,47,69,286,不合格
20183737,90,80,41,85,13,309,合格
20183738,34,39,60,24,48,205,不合格
20183739,9,82,82,75,44,292,不合格
20183740,44,54,32,0,60,190,不合格
20183741,15,6,14,85,4,124,不合格
20183742,87,27,77,30,39,260,不合格
20183743,19,88,25,11,36,179,不合格
20183744,6,88,3,9,46,152,不合格
20183745,19,6,52,68,3,148,不合格
20183746,48,50,31,61,63,253,不合格
20183747,92,89,70,57,90,398,合格
20183748,48,60,80,31,49,268,不合格
20183749,65,5,22,38,7,137,不合格
20183750,19,75,78,11,63,246,不合格
20183751,30,6,25,89,45,195,不合格
20183752,62,83,80,71,28,324,合格
20183753,70,41,92,9,20,232,不合格
20183754,55,46,89,2,92,284,不合格
20183755,55,28,54,80,45,262,不合格
20183756,81,21,35,41,71,249,不合格
20183757,48,59,9,39,51,206,不合格
20183758,24,0,98,69,79,270,不合格
20183759,23,18,1,60,68,170,不合格
20183760,53,61,18,28,98,258,不合格
20183761,90,94,4,32,20,240,不合格
20183762,15,63,24,13,65,180,不合格
20183763,95,43,44,71,8,261,不合格
20183764,14,85,3,15,56,173,不合格
20183765,14,63,3,19,33,132,不合格
20183766,37,32,4,45,9,127,不合格
20183767,97,10,83,94,0,284,不合格
20183768,65,70,80,25,5,245,不合格
20183769,76,71,29,74,69,319,合格
20183770,45,46,28,98,13,230,不合格
20183771,60,8,36,28,85,217,不合格
20183772,48,53,72,77,89,339,合格
20183773,23,49,91,9,43,215,不合格
20183774,2,66,90,24,75,257,不合格
20183775,30,97,96,95,11,329,合格
20183776,98,11,68,14,86,277,不合格
20183777,3,25,29,31,20,108,不合格
20183778,31,63,98,88,26,306,合格
20183779,34,42,86,95,33,290,不合格
20183780,25,3,27,25,14,94,不合格
20183781,83,10,44,45,49,231,不合格
20183782,13,60,98,64,82,317,合格
20183783,35,62,27,24,36,184,不合格
20183784,88,46,11,13,45,203,不合格
20183785,97,0,54,17,19,187,不合格
20183786,76,63,46,96,51,332,合格
20183787,91,79,78,64,67,379,合格
20183788,98,23,64,56,70,311,合格
20183789,16,98,48,8,89,259,不合格
20183790,78,88,99,70,66,401,合格
20183791,14,35,46,92,62,249,不合格
20183792,87,28,28,37,86,266,不合格
20183793,75,15,77,22,15,204,不合格
20183794,82,16,70,82,82,332,合格
20183795,95,81,37,72,24,309,合格
20183796,95,20,95,44,4,258,不合格
20183797,30,25,66,58,31,210,不合格
20183798,36,51,52,10,66,215,不合格
20183799,23,9,65,61,91,249,不合格
20183800,0,7,66,14,28,115,不合格
20183801,27,52,76,30,17,202,不合格
20183802,10,72,23,7,19,131,不合格
20183803,29,94,67,86,49,325,合格
20183804,60,64,59,45,26,254,不合格
20183805,9,57,66,11,43,186,不合格
20183806,11,26,83,85,12,217,不合格
20183807,80,91,59,79,24,333,合格
20183808,2,75,59,26,0,162,不合格
20183809,39,18,79,41,45,222,不合格
20183810,52,86,42,71,93,344,合格
20183811,74,93,6,89,92,354,合格
20183812,48,13,82,48,16,207,不合格
20183813,60,31,83,5,56,235,不合格
20183814,90,86,17,80,70,343,合格
20183815,57,29,94,12,0,192,不合格
20183816,25,31,37,69,51,213,不合格
20183817,9,6,40,68,25,148,不合格
20183818,54,52,44,3,21,174,不合格
20183819,35,1,94,6,25,161,不合格
20183820,27,50,13,31,27,148,不合格
20183821,86,84,15,19,36,240,不合格
20183822,10,98,59,42,92,301,合格
20183823,50,56,99,75,94,374,合格
20183824,48,15,63,5,97,228,不合格
20183825,70,54,10,48,48,230,不合格
20183826,53,72,36,70,29,260,不合格
20183827,47,58,44,33,75,257,不合格
20183828,23,95,24,14,77,233,不合格
20183829,64,5,82,89,51,291,不合格
20183830,22,94,54,51,61,282,不合格
20183831,1,22,88,20,82,213,不合格
20183832,28,31,10,60,89,218,不合格
20183833,66,3,9,94,55,227,不合格
20183834,74,94,68,63,61,360,合格
20183835,35,99,81,14,81,310,合格
20183836,12,42,67,46,79,246,不合格
20183837,50,74,49,17,28,218,不合格
20183838,89,49,58,23,44,263,不合格
20183839,1,43,28,70,8,150,不合格
20183840,55,87,6,9,22,179,不合格
20183841,54,75,55,79,32,295,不合格
20183842,77,99,47,49,51,323,合格
20183843,34,7,30,59,32,162,不合格
20183844,76,51,60,60,93,340,合格
20183845,77,97,71,33,90,368,合格
20183846,74,25,44,48,53,244,不合格
20183847,82,26,25,89,76,298,不合格
20183848,60,68,21,79,82,310,合格
20183849,62,19,44,98,63,286,不合格
20183850,57,15,85,19,93,269,不合格
20183851,78,35,66,55,11,245,不合格
20183852,81,17,9,7,21,135,不合格
20183853,32,52,39,97,17,237,不合格
20183854,74,18,55,26,69,242,不合格
20183855,31,79,10,23,84,227,不合格
20183856,0,74,29,80,2,185,不合格
20183857,43,37,70,48,85,283,不合格
20183858,45,79,93,15,9,241,不合格
20183859,10,83,15,81,96,285,不合格
20183860,89,36,40,89,27,281,不合格
20183861,30,6,16,30,71,153,不合格
20183862,72,11,73,89,89,334,合格
20183863,17,46,50,11,99,223,不合格
20183864,90,47,84,25,97,343,合格
20183865,17,37,3,20,19,96,不合格
20183866,83,98,83,48,86,398,合格
20183867,38,7,42,3,72,162,不合格
20183868,45,46,38,0,70,199,不合格
20183869,90,42,17,0,61,210,不合格
20183870,98,75,57,65,90,385,合格
20183871,5,56,56,83,35,235,不合格
20183872,3,65,6,33,34,141,不合格
20183873,14,55,62,36,7,174,不合格
20183874,1,93,86,63,52,295,不合格
20183875,31,13,71,50,44,209,不合格
20183876,88,68,42,11,47,256,不合格
20183877,6,72,95,53,57,283,不合格
20183878,78,94,39,96,37,344,合格
20183879,74,39,9,30,90,242,不合格
20183880,45,47,40,82,12,226,不合格
20183881,63,55,81,81,82,362,合格
20183882,88,86,78,32,0,284,不合格
20183883,90,21,43,34,29,217,不合格
20183884,22,88,79,43,10,242,不合格
20183885,78,88,69,77,71,383,合格
20183886,67,79,43,6,31,226,不合格
20183887,55,85,96,42,31,309,合格
20183888,74,77,52,32,39,274,不合格
20183889,40,89,68,84,82,363,合格
20183890,84,5,58,70,57,274,不合格
20183891,62,25,80,2,44,213,不合格
20183892,13,29,31,15,14,102,不合格
20183893,30,57,77,45,0,209,不合格
20183894,12,81,45,76,97,311,合格
20183895,33,45,31,63,23,195,不合格
20183896,67,4,27,89,88,275,不合格
20183897,55,33,19,62,71,240,不合格
20183898,45,10,71,57,67,250,不合格
20183899,38,70,48,72,34,262,不合格
20183900,43,70,70,47,40,270,不合格
20183901,22,38,91,66,57,274,不合格
20183902,12,4,87,24,74,201,不合格
20183903,39,56,60,24,35,214,不合格
20183904,99,83,19,30,2,233,不合格
20183905,79,0,17,33,43,172,不合格
20183906,98,85,51,42,66,342,合格
20183907,93,29,48,84,78,332,合格
20183908,43,74,78,18,27,240,不合格
20183909,7,52,16,31,80,186,不合格
20183910,6,66,84,10,95,261,不合格
20183911,87,14,66,37,85,289,不合格
20183912,90,76,90,62,42,360,合格
20183913,3,82,51,35,58,229,不合格
20183914,80,85,94,15,43,317,合格
20183915,17,96,28,91,57,289,不合格
20183916,59,3,59,15,80,216,不合格
20183917,72,60,71,6,23,232,不合格
20183918,17,43,20,71,76,227,不合格
20183919,90,58,28,99,83,358,合格
20183920,69,65,59,48,60,301,合格
20183921,47,86,21,96,30,280,不合格
20183922,13,74,23,44,2,156,不合格
20183923,67,13,42,88,8,218,不合格
20183924,90,19,35,94,45,283,不合格
20183925,49,47,37,4,65,202,不合格
20183926,27,24,38,12,24,125,不合格
20183927,76,97,26,56,74,329,合格
20183928,7,86,46,30,88,257,不合格
20183929,37,85,88,77,93,380,合格
20183930,53,58,7,80,60,258,不合格
20183931,58,53,53,10,1,175,不合格
20183932,39,45,5,3,2,94,不合格
20183933,36,67,49,94,83,329,合格
20183934,0,49,7,96,31,183,不合格
20183935,8,5,87,14,39,153,不合格
20183936,78,15,75,2,32,202,不合格
20183937,67,94,70,48,49,328,合格
20183938,67,6,54,4,83,214,不合格
20183939,67,79,78,43,35,302,合格
20183940,6,54,51,86,3,200,不合格
20183941,31,26,24,84,20,185,不合格
20183942,24,79,76,75,89,343,合格
20183943,68,93,23,4,66,254,不合格
20183944,5,88,75,60,63,291,不合格
20183945,66,85,37,64,72,324,合格
20183946,64,79,54,2,4,203,不合格
20183947,15,97,24,4,24,164,不合格
20183948,41,32,96,0,96,265,不合格
20183949,66,20,49,92,86,313,合格
20183950,5,67,57,83,69,281,不合格
20183951,76,31,74,95,26,302,合格
20183952,36,72,85,99,40,332,合格
20183953,56,33,70,53,97,309,合格
20183954,3,78,39,6,67,193,不合格
20183955,42,38,33,36,35,184,不合格
20183956,96,79,8,2,93,278,不合格
20183957,37,10,95,77,11,230,不合格
20183958,15,43,31,68,14,171,不合格
20183959,59,53,49,7,92,260,不合格
20183960,18,69,88,21,86,282,不合格
20183961,11,72,94,42,30,249,不合格
20183962,82,42,58,97,60,339,合格
20183963,12,49,24,2,13,100,不合格
20183964,0,57,94,47,41,239,不合格
20183965,77,38,0,12,94,221,不合格
20183966,35,74,34,48,14,205,不合格
20183967,91,30,83,58,84,346,合格
20183968,30,87,94,91,4,306,合格
20183969,95,41,31,55,34,256,不合格
20183970,13,23,53,16,27,132,不合格
20183971,35,45,60,81,48,269,不合格
20183972,67,79,16,90,48,300,合格
20183973,92,79,54,57,89,371,合格
20183974,37,73,53,97,11,271,不合格
20183975,13,45,34,5,96,193,不合格
20183976,46,73,83,47,66,315,合格
20183977,28,98,29,39,62,256,不合格
20183978,71,66,68,24,95,324,合格
20183979,70,1,54,72,43,240,不合格
20183980,73,48,36,69,81,307,合格
20183981,12,4,15,36,67,134,不合格
20183982,37,85,88,64,95,369,合格
20183983,47,99,66,75,51,338,合格
20183984,30,51,18,84,69,252,不合格
20183985,48,97,64,33,40,282,不合格
20183986,23,34,14,58,60,189,不合格
20183987,44,34,98,28,30,234,不合格
20183988,73,93,80,52,95,393,合格
20183989,43,67,98,19,58,285,不合格
20183990,3,70,79,54,13,219,不合格
20183991,67,36,46,41,59,249,不合格
20183992,21,33,96,92,53,295,不合格
20183993,49,73,68,16,17,223,不合格
20183994,4,29,90,3,0,126,不合格
20183995,13,80,56,83,94,326,合格
20183996,3,58,24,13,36,134,不合格
20183997,74,16,9,69,56,224,不合格
20183998,56,11,92,11,80,250,不合格
20183999,92,95,25,78,66,356,合格
20184000,26,26,10,58,17,137,不合格
20184001,29,19,35,7,8,98,不合格
20184002,77,68,37,10,48,240,不合格
20184003,16,94,33,13,18,174,不合格
20184004,31,50,69,57,64,271,不合格
20184005,82,56,65,21,12,236,不合格
20184006,32,81,94,63,40,310,合格
20184007,17,89,85,3,81,275,不合格
20184008,42,69,35,38,42,226,不合格
20184009,57,28,52,0,67,204,不合格
20184010,50,42,24,67,33,216,不合格
20184011,71,22,56,6,67,222,不合格
20184012,7,98,15,57,85,262,不合格
20184013,58,9,94,91,61,313,合格
20184014,20,69,64,11,13,177,不合格
20184015,28,35,81,83,60,287,不合格
20184016,98,13,60,81,22,274,不合格
20184017,98,49,43,49,14,253,不合格
20184018,1,62,35,10,30,138,不合格
20184019,28,98,12,49,41,228,不合格
20184020,48,4,89,94,77,312,合格
20184021,37,89,52,26,50,254,不合格
20184022,29,31,10,59,35,164,不合格
20184023,56,89,89,11,82,327,合格
20184024,12,6,69,18,91,196,不合格
20184025,37,79,1,33,65,215,不合格
20184026,22,88,64,72,17,263,不合格
20184027,11,10,10,80,48,159,不合格
20184028,1,49,53,61,54,218,不合格
20184029,19,27,58,52,86,242,不合格
20184030,16,67,15,59,23,180,不合格
20184031,17,23,94,32,75,241,不合格
20184032,10,66,54,13,62,205,不合格
20184033,30,93,30,45,47,245,不合格
20184034,85,7,23,78,49,242,不合格
20184035,86,66,76,83,57,368,合格
20184036,47,76,46,83,75,327,合格
20184037,43,60,15,55,84,257,不合格
20184038,55,22,90,16,67,250,不合格
20184039,30,41,4,66,83,224,不合格
20184040,37,8,94,1,5,145,不合格
20184041,28,25,88,72,33,246,不合格
20184042,51,92,8,93,3,247,不合格
20184043,26,7,57,56,94,240,不合格
20184044,52,43,40,38,54,227,不合格
20184045,31,53,51,54,62,251,不合格
20184046,13,27,58,94,3,195,不合格
20184047,24,27,45,32,50,178,不合格
20184048,94,39,94,28,33,288,不合格
20184049,16,87,26,67,94,290,不合格
20184050,5,16,46,45,8,120,不合格
20184051,94,23,71,77,71,336,合格
20184052,87,93,27,75,92,374,合格
20184053,31,40,37,85,82,275,不合格
20184054,94,92,36,8,8,238,不合格
20184055,42,64,29,23,34,192,不合格
20184056,94,42,65,63,1,265,不合格
20184057,20,77,42,60,80,279,不合格
20184058,77,12,27,66,30,212,不合格
20184059,79,6,66,45,64,260,不合格
20184060,53,28,42,7,40,170,不合格
20184061,44,10,14,81,57,206,不合格
20184062,11,14,5,41,28,99,不合格
20184063,97,2,56,0,65,220,不合格
20184064,50,58,24,92,17,241,不合格
20184065,65,52,18,38,42,215,不合格
20184066,62,97,38,75,13,285,不合格
20184067,24,29,75,44,30,202,不合格
20184068,65,18,10,89,92,274,不合格
20184069,22,31,39,22,31,145,不合格
20184070,83,61,99,42,67,352,合格
20184071,40,27,28,60,57,212,不合格
20184072,66,13,3,43,12,137,不合格
20184073,93,84,43,69,28,317,合格
20184074,37,54,59,86,96,332,合格
20184075,0,62,82,80,29,253,不合格
20184076,54,79,89,93,72,387,合格
20184077,66,54,2,16,75,213,不合格
20184078,10,64,48,48,76,246,不合格
20184079,6,7,4,37,38,92,不合格
20184080,46,25,83,3,14,171,不合格
20184081,52,55,51,10,5,173,不合格
20184082,17,0,28,73,39,157,不合格
20184083,34,59,66,2,87,248,不合格
20184084,13,78,84,35,92,302,合格
20184085,26,4,76,16,33,155,不合格
20184086,68,80,72,80,76,376,合格
20184087,52,82,1,7,66,208,不合格
20184088,52,37,15,41,41,186,不合格
20184089,31,34,72,49,95,281,不合格
20184090,17,45,79,61,23,225,不合格
20184091,31,12,48,8,61,160,不合格
20184092,11,26,24,58,1,120,不合格
20184093,46,81,17,97,30,271,不合格
20184094,82,84,22,52,48,288,不合格
20184095,70,68,74,5,83,300,合格
20184096,83,4,25,6,86,204,不合格
20184097,99,34,21,91,12,257,不合格
20184098,2,64,38,24,76,204,不合格
20184099,49,29,29,16,65,188,不合格
20184100,20,40,99,1,37,197,不合格
20184101,35,8,95,81,19,238,不合格
20184102,36,57,3,30,56,182,不合格
20184103,89,16,43,94,52,294,不合格
20184104,30,49,52,78,89,298,不合格
20184105,43,46,27,65,66,247,不合格
20184106,27,22,84,87,92,312,合格
20184107,80,6,82,30,9,207,不合格
20184108,77,32,78,66,50,303,合格
20184109,39,54,78,57,38,266,不合格
20184110,90,46,39,94,25,294,不合格
20184111,1,94,22,13,1,131,不合格
20184112,41,89,43,8,69,250,不合格
20184113,55,96,59,17,99,326,合格
20184114,50,76,64,27,69,286,不合格
20184115,20,93,75,50,63,301,合格
20184116,48,35,45,16,36,180,不合格
20184117,12,10,90,18,82,212,不合格
20184118,91,55,13,80,84,323,合格
20184119,13,36,56,67,7,179,不合格
20184120,79,64,64,45,72,324,合格
20184121,81,8,29,80,71,269,不合格
20184122,77,15,48,83,98,321,合格
20184123,40,38,8,98,15,199,不合格
20184124,95,41,43,97,65,341,合格
20184125,31,74,47,97,55,304,合格
20184126,20,75,9,60,34,198,不合格
20184127,70,49,11,67,3,200,不合格
20184128,43,75,55,90,99,362,合格
20184129,9,26,3,65,10,113,不合格
20184130,71,26,21,69,66,253,不合格
20184131,2,63,32,47,52,196,不合格
20184132,16,4,53,44,68,185,不合格
20184133,77,72,85,96,82,412,合格
20184134,16,25,32,40,61,174,不合格
20184135,83,61,75,1,72,292,不合格
20184136,51,10,70,2,40,173,不合格
20184137,14,71,48,30,31,194,不合格
20184138,43,35,4,3,90,175,不合格
20184139,91,71,12,72,58,304,合格
20184140,70,11,39,18,2,140,不合格
20184141,93,54,15,71,76,309,合格
20184142,13,7,54,32,12,118,不合格
20184143,37,23,33,78,55,226,不合格
20184144,6,45,26,9,62,148,不合格
20184145,62,14,39,29,17,161,不合格
20184146,4,23,58,48,14,147,不合格
20184147,62,24,21,81,25,213,不合格
20184148,4,22,23,68,75,192,不合格
20184149,43,79,56,75,72,325,合格
20184150,31,28,72,12,0,143,不合格
20184151,14,41,30,42,17,144,不合格
20184152,31,95,98,72,83,379,合格
20184153,77,41,2,13,38,171,不合格
20184154,98,87,16,88,81,370,合格
20184155,32,13,45,96,45,231,不合格
20184156,47,20,33,77,98,275,不合格
20184157,18,39,80,31,58,226,不合格
20184158,33,82,1,61,53,230,不合格
20184159,2,80,20,17,49,168,不合格
20184160,3,28,74,42,46,193,不合格
20184161,49,59,27,81,72,288,不合格
20184162,11,32,17,70,60,190,不合格
20184163,12,82,53,13,22,182,不合格
20184164,72,29,15,93,65,274,不合格
20184165,60,94,79,2,67,302,合格
20184166,37,6,40,4,31,118,不合格
20184167,92,79,37,93,70,371,合格
20184168,59,3,59,55,5,181,不合格
20184169,35,84,65,56,99,339,合格
20184170,95,36,77,9,30,247,不合格
20184171,67,54,81,10,13,225,不合格
20184172,87,11,24,59,47,228,不合格
20184173,7,93,35,32,63,230,不合格
20184174,30,21,6,40,20,117,不合格
20184175,6,88,2,57,10,163,不合格
20184176,18,6,23,11,3,61,不合格
20184177,81,6,17,60,61,225,不合格
20184178,32,37,56,2,72,199,不合格
20184179,38,88,98,25,66,315,合格
20184180,10,92,41,25,65,233,不合格
20184181,34,67,25,27,96,249,不合格
20184182,82,5,29,95,39,250,不合格
20184183,76,93,41,49,27,286,不合格
20184184,88,90,32,74,41,325,合格
20184185,14,60,3,55,69,201,不合格
20184186,44,11,35,36,86,212,不合格
20184187,90,87,80,95,59,411,合格
20184188,33,54,63,26,26,202,不合格
20184189,53,51,5,18,52,179,不合格
20184190,14,15,4,66,53,152,不合格
20184191,96,66,47,42,2,253,不合格
20184192,55,12,75,58,69,269,不合格
20184193,20,75,84,19,34,232,不合格
20184194,16,86,54,60,6,222,不合格
20184195,60,19,15,38,67,199,不合格
20184196,99,93,48,73,9,322,合格
20184197,53,44,27,18,48,190,不合格
20184198,55,86,1,94,85,321,合格
20184199,26,95,23,19,38,201,不合格
20184200,29,48,17,58,92,244,不合格
20184201,63,38,78,44,13,236,不合格
20184202,97,36,95,81,97,406,合格
20184203,63,88,86,52,92,381,合格
20184204,36,59,99,96,83,373,合格
20184205,87,55,39,48,14,243,不合格
20184206,83,16,82,46,94,321,合格
20184207,77,22,64,58,65,286,不合格
20184208,36,46,71,57,40,250,不合格
20184209,4,58,62,68,89,281,不合格
20184210,17,18,39,49,13,136,不合格
20184211,32,47,64,28,62,233,不合格
20184212,54,93,70,6,40,263,不合格
20184213,56,62,30,87,83,318,合格
20184214,83,63,40,89,63,338,合格
20184215,20,81,56,71,70,298,不合格
20184216,19,90,40,8,36,193,不合格
20184217,78,0,29,68,72,247,不合格
20184218,32,6,79,65,15,197,不合格
20184219,45,58,10,65,45,223,不合格
20184220,43,75,47,31,86,282,不合格
20184221,16,9,75,39,51,190,不合格
20184222,50,60,54,70,13,247,不合格
20184223,1,95,47,85,66,294,不合格
20184224,71,76,22,51,70,290,不合格
20184225,74,40,19,54,31,218,不合格
20184226,64,62,11,83,46,266,不合格
20184227,96,82,82,23,52,335,合格
20184228,94,64,36,70,44,308,合格
20184229,36,47,44,52,38,217,不合格
20184230,8,35,16,27,0,86,不合格
20184231,13,69,39,71,58,250,不合格
20184232,67,49,0,24,64,204,不合格
20184233,51,38,18,79,85,271,不合格
20184234,25,69,62,92,41,289,不合格
20184235,76,92,91,63,97,419,合格
20184236,27,80,14,90,34,245,不合格
20184237,31,18,93,11,36,189,不合格
20184238,99,42,85,96,76,398,合格
20184239,26,36,82,63,85,292,不合格
20184240,34,74,87,86,85,366,合格
20184241,38,60,45,77,47,267,不合格
20184242,24,41,24,50,61,200,不合格
20184243,28,51,90,35,66,270,不合格
20184244,70,2,18,29,62,181,不合格
20184245,96,71,88,50,48,353,合格
20184246,53,50,82,43,70,298,不合格
20184247,52,1,98,87,79,317,合格
20184248,37,71,45,49,70,272,不合格
20184249,7,31,5,25,9,77,不合格
20184250,33,18,88,25,83,247,不合格
20184251,30,19,20,48,76,193,不合格
20184252,73,67,36,48,87,311,合格
20184253,62,72,32,41,87,294,不合格
20184254,44,8,1,19,84,156,不合格
20184255,99,31,71,65,64,330,合格
20184256,9,70,46,52,35,212,不合格
20184257,26,83,62,60,45,276,不合格
20184258,42,46,45,96,44,273,不合格
20184259,33,9,2,23,54,121,不合格
20184260,62,57,78,57,31,285,不合格
20184261,22,44,33,67,27,193,不合格
20184262,55,33,22,95,76,281,不合格
20184263,65,12,57,17,44,195,不合格
20184264,20,87,60,66,15,248,不合格
20184265,76,81,92,44,73,366,合格
20184266,93,28,54,97,17,289,不合格
20184267,98,3,56,22,71,250,不合格
20184268,23,54,97,72,91,337,合格
20184269,44,38,21,42,93,238,不合格
20184270,74,27,17,81,68,267,不合格
20184271,64,58,42,79,21,264,不合格
20184272,70,76,42,95,74,357,合格
20184273,3,19,32,7,75,136,不合格
20184274,41,62,88,82,72,345,合格
20184275,75,98,35,38,34,280,不合格
20184276,26,32,45,47,66,216,不合格
20184277,6,48,6,20,93,173,不合格
20184278,9,63,92,90,84,338,合格
20184279,15,1,9,16,94,135,不合格
20184280,20,62,62,14,13,171,不合格
20184281,15,7,25,71,57,175,不合格
20184282,84,70,68,86,33,341,合格
20184283,37,49,23,14,11,134,不合格
20184284,41,49,78,69,19,256,不合格
20184285,23,67,13,80,57,240,不合格
20184286,10,53,82,50,17,212,不合格
20184287,69,60,34,72,23,258,不合格
20184288,94,85,82,4,61,326,合格
20184289,33,31,95,56,10,225,不合格
20184290,21,35,21,19,71,167,不合格
20184291,67,93,30,79,48,317,合格
20184292,4,12,45,2,48,111,不合格
20184293,80,50,20,28,1,179,不合格
20184294,95,21,38,2,72,228,不合格
20184295,74,68,18,39,89,288,不合格
20184296,96,89,29,29,73,316,合格
20184297,64,98,80,15,62,319,合格
20184298,25,7,46,13,17,108,不合格
20184299,89,63,35,84,19,290,不合格
20184300,91,36,57,37,85,306,合格
20184301,64,14,72,60,37,247,不合格
20184302,11,7,18,33,51,120,不合格
20184303,50,34,68,3,45,200,不合格
20184304,34,84,86,23,90,317,合格
20184305,99,86,27,29,42,283,不合格
20184306,22,44,0,40,25,131,不合格
20184307,78,12,27,56,91,264,不合格
20184308,38,98,77,33,86,332,合格
20184309,50,37,17,63,17,184,不合格
20184310,88,72,46,89,62,357,合格
20184311,45,44,75,86,43,293,不合格
20184312,64,96,36,80,62,338,合格
20184313,17,91,64,4,40,216,不合格
20184314,38,36,72,6,30,182,不合格
20184315,82,96,90,25,69,362,合格
20184316,28,91,95,75,86,375,合格
20184317,78,12,56,67,11,224,不合格
20184318,33,47,96,91,35,302,合格
20184319,88,56,8,1,11,164,不合格
20184320,85,47,10,39,42,223,不合格
20184321,98,98,54,47,91,388,合格
20184322,79,11,42,22,18,172,不合格
20184323,75,34,21,89,74,293,不合格
20184324,17,15,48,60,28,168,不合格
20184325,29,44,45,59,39,216,不合格
20184326,26,69,21,76,87,279,不合格
20184327,3,1,50,55,91,200,不合格
20184328,57,14,39,49,53,212,不合格
20184329,5,85,32,56,44,222,不合格
20184330,81,41,64,48,72,306,合格
20184331,85,42,36,74,49,286,不合格
20184332,46,53,85,0,80,264,不合格
20184333,69,74,32,68,77,320,合格
20184334,3,22,40,2,67,134,不合格
20184335,91,28,66,20,94,299,不合格
20184336,24,70,92,58,27,271,不合格
20184337,87,38,74,20,99,318,合格
20184338,67,49,48,87,4,255,不合格
20184339,89,9,7,62,18,185,不合格
20184340,50,51,67,60,17,245,不合格
20184341,56,68,13,81,49,267,不合格
20184342,79,55,77,4,15,230,不合格
20184343,45,26,22,41,28,162,不合格
20184344,38,36,18,32,90,214,不合格
20184345,93,71,66,88,19,337,合格
20184346,95,3,51,18,3,170,不合格
20184347,52,60,68,34,94,308,合格
20184348,41,64,47,96,94,342,合格
20184349,48,28,94,99,62,331,合格
20184350,90,9,64,9,74,246,不合格
20184351,43,86,65,74,66,334,合格
20184352,31,5,22,90,72,220,不合格
20184353,43,38,45,24,51,201,不合格
20184354,94,67,13,9,74,257,不合格
20184355,88,47,48,7,69,259,不合格
20184356,82,72,58,49,58,319,合格
20184357,31,28,26,28,30,143,不合格
20184358,75,81,76,21,21,274,不合格
20184359,28,33,80,49,31,221,不合格
20184360,80,68,30,4,32,214,不合格
20184361,30,57,97,99,10,293,不合格
20184362,92,84,85,84,0,345,合格
20184363,73,95,0,23,29,220,不合格
20184364,53,93,71,68,3,288,不合格
20184365,75,3,44,31,59,212,不合格
20184366,35,47,28,89,87,286,不合格
20184367,80,27,81,17,85,290,不合格
20184368,17,62,34,70,31,214,不合格
20184369,98,43,95,31,30,297,不合格
20184370,0,80,48,34,75,237,不合格
20184371,97,43,33,25,36,234,不合格
20184372,28,11,15,66,87,207,不合格
20184373,14,92,83,45,97,331,合格
20184374,88,97,0,84,16,285,不合格
20184375,33,19,94,45,5,196,不合格
20184376,33,21,12,61,77,204,不合格
20184377,84,78,6,17,49,234,不合格
20184378,82,53,57,87,13,292,不合格
20184379,9,74,15,26,17,141,不合格
20184380,82,37,3,12,31,165,不合格
20184381,64,3,19,17,16,119,不合格
20184382,28,87,78,3,78,274,不合格
20184383,46,72,1,77,36,232,不合格
20184384,51,3,81,12,36,183,不合格
20184385,15,84,55,97,0,251,不合格
20184386,24,83,29,73,97,306,合格
20184387,77,45,42,6,98,268,不合格
20184388,5,48,67,27,69,216,不合格
20184389,50,61,56,48,55,270,不合格
20184390,1,24,62,35,11,133,不合格
20184391,70,89,79,15,42,295,不合格
20184392,1,16,47,7,54,125,不合格
20184393,3,15,14,18,1,51,不合格
20184394,53,29,1,9,3,95,不合格
20184395,79,15,53,18,27,192,不合格
20184396,18,97,16,66,83,280,不合格
20184397,39,6,85,24,95,249,不合格
20184398,29,19,66,4,3,121,不合格
20184399,55,34,12,99,26,226,不合格
20184400,57,10,70,41,23,201,不合格
20184401,13,80,72,31,7,203,不合格
20184402,84,89,78,83,99,433,合格
20184403,4,59,69,31,86,249,不合格
20184404,18,34,82,25,81,240,不合格
20184405,91,28,18,78,10,225,不合格
20184406,29,91,32,95,26,273,不合格
20184407,50,95,45,50,2,242,不合格
20184408,66,32,50,6,85,239,不合格
20184409,30,37,33,32,73,205,不合格
20184410,43,58,10,79,10,200,不合格
20184411,3,24,37,28,71,163,不合格
20184412,84,16,25,13,37,175,不合格
20184413,67,83,15,3,90,258,不合格
20184414,3,9,91,26,4,133,不合格
20184415,92,61,34,65,71,323,合格
20184416,17,86,75,74,87,339,合格
20184417,44,62,38,16,71,231,不合格
20184418,26,86,96,65,24,297,不合格
20184419,90,99,51,90,9,339,合格
20184420,45,69,18,90,86,308,合格
20184421,16,21,36,32,0,105,不合格
20184422,43,26,26,12,21,128,不合格
20184423,86,33,73,94,26,312,合格
20184424,34,99,37,29,48,247,不合格
20184425,46,51,98,93,99,387,合格
20184426,86,70,68,22,93,339,合格
20184427,54,51,59,23,96,283,不合格
20184428,69,7,62,55,97,290,不合格
20184429,51,1,89,55,36,232,不合格
20184430,88,86,68,82,2,326,合格
20184431,22,41,88,96,83,330,合格
20184432,91,33,39,10,97,270,不合格
20184433,17,75,58,72,51,273,不合格
20184434,11,0,47,45,40,143,不合格
20184435,83,98,47,58,55,341,合格
20184436,51,69,31,29,17,197,不合格
20184437,50,49,31,76,30,236,不合格
20184438,30,79,66,99,52,326,合格
20184439,32,72,73,49,87,313,合格
20184440,25,35,57,67,68,252,不合格
20184441,57,84,1,93,13,248,不合格
20184442,13,30,11,50,34,138,不合格
20184443,97,12,25,93,81,308,合格
20184444,46,67,74,78,81,346,合格
20184445,96,85,39,1,51,272,不合格
20184446,93,51,87,42,67,340,合格
20184447,1,14,20,55,46,136,不合格
20184448,34,19,93,8,52,206,不合格
20184449,19,57,1,34,41,152,不合格
20184450,70,84,45,35,27,261,不合格
20184451,98,18,41,8,47,212,不合格
20184452,21,56,17,41,19,154,不合格
20184453,28,13,51,6,91,189,不合格
20184454,96,22,68,30,46,262,不合格
20184455,51,65,52,50,6,224,不合格
20184456,31,40,10,51,13,145,不合格
20184457,46,25,37,75,29,212,不合格
20184458,55,30,37,5,41,168,不合格
20184459,37,16,1,94,54,202,不合格
20184460,20,19,56,24,79,198,不合格
20184461,86,53,29,82,85,335,合格
20184462,94,6,65,28,97,290,不合格
20184463,6,31,50,5,29,121,不合格
20184464,34,63,26,56,7,186,不合格
20184465,49,71,65,97,7,289,不合格
20184466,85,30,99,82,73,369,合格
20184467,45,11,25,43,50,174,不合格
20184468,24,51,65,98,14,252,不合格
20184469,70,60,19,14,28,191,不合格
20184470,96,0,88,77,68,329,合格
20184471,94,88,35,39,64,320,合格
20184472,99,37,2,37,14,189,不合格
20184473,71,30,12,7,67,187,不合格
20184474,2,54,72,97,44,269,不合格
20184475,67,44,90,43,70,314,合格
20184476,66,33,28,61,84,272,不合格
20184477,15,22,11,19,8,75,不合格
20184478,83,8,11,84,6,192,不合格
20184479,14,3,94,92,36,239,不合格
20184480,82,32,4,62,84,264,不合格
20184481,94,53,37,88,99,371,合格
20184482,22,48,66,2,34,172,不合格
20184483,94,57,34,79,24,288,不合格
20184484,62,25,45,99,76,307,合格
20184485,41,57,98,80,42,318,合格
20184486,38,91,52,10,79,270,不合格
20184487,91,99,3,22,66,281,不合格
20184488,60,54,73,82,78,347,合格
20184489,6,18,70,95,69,258,不合格
20184490,64,57,21,2,28,172,不合格
20184491,47,28,88,47,94,304,合格
20184492,46,87,0,64,9,206,不合格
20184493,25,6,99,77,49,256,不合格
20184494,28,97,33,38,36,232,不合格
20184495,91,19,54,25,73,262,不合格
20184496,3,32,63,16,27,141,不合格
20184497,8,63,27,31,96,225,不合格
20184498,65,83,48,28,39,263,不合格
20184499,51,48,38,72,91,300,合格
20184500,50,91,32,45,79,297,不合格
20184501,66,33,4,57,24,184,不合格
20184502,73,65,4,56,6,204,不合格
20184503,21,2,71,9,76,179,不合格
20184504,88,71,24,65,28,276,不合格
20184505,68,4,3,39,8,122,不合格
20184506,19,90,76,9,58,252,不合格
20184507,13,2,31,19,15,80,不合格
20184508,55,35,3,11,5,109,不合格
20184509,72,79,87,74,47,359,合格
20184510,89,58,52,98,4,301,合格
20184511,66,31,46,22,81,246,不合格
20184512,30,95,62,38,48,273,不合格
20184513,73,55,17,43,19,207,不合格
20184514,71,0,11,52,81,215,不合格
20184515,82,67,58,99,95,401,合格
20184516,11,77,42,56,11,197,不合格
20184517,87,31,22,59,22,221,不合格
20184518,3,77,51,24,37,192,不合格
20184519,60,43,22,28,70,223,不合格
20184520,96,45,78,72,58,349,合格
20184521,29,75,48,66,61,279,不合格
20184522,52,84,41,44,54,275,不合格
20184523,1,31,39,15,11,97,不合格
20184524,32,75,15,6,64,192,不合格
20184525,77,22,34,85,33,251,不合格
20184526,56,94,82,62,92,386,合格
20184527,93,67,67,18,62,307,合格
20184528,43,48,88,63,50,292,不合格
20184529,47,12,27,78,78,242,不合格
20184530,42,18,52,59,38,209,不合格
20184531,76,86,85,30,57,334,合格
20184532,85,85,22,34,97,323,合格
20184533,49,38,17,69,54,227,不合格
20184534,76,62,98,33,98,367,合格
20184535,19,90,90,11,72,282,不合格
20184536,35,38,47,8,94,222,不合格
20184537,53,20,40,36,76,225,不合格
20184538,46,86,64,59,7,262,不合格
20184539,45,69,96,40,22,272,不合格
20184540,66,43,48,6,76,239,不合格
20184541,27,68,72,88,46,301,合格
20184542,43,86,92,72,13,306,合格
20184543,92,94,29,2,54,271,不合格
20184544,61,46,9,75,88,279,不合格
20184545,47,54,21,22,3,147,不合格
20184546,80,25,68,83,34,290,不合格
20184547,28,34,95,35,96,288,不合格
20184548,48,7,38,41,45,179,不合格
20184549,61,97,36,76,75,345,合格
20184550,90,17,77,11,84,279,不合格
20184551,39,48,62,87,87,323,合格
20184552,58,94,98,10,91,351,合格
20184553,30,72,60,69,79,310,合格
20184554,93,77,14,17,53,254,不合格
20184555,62,35,6,32,96,231,不合格
20184556,51,5,12,59,59,186,不合格
20184557,42,53,19,88,74,276,不合格
20184558,47,13,13,73,35,181,不合格
20184559,79,34,7,63,28,211,不合格
20184560,28,31,65,36,3,163,不合格
20184561,16,40,84,25,4,169,不合格
20184562,1,54,92,72,64,283,不合格
20184563,74,89,40,16,0,219,不合格
20184564,74,44,69,66,69,322,合格
20184565,44,89,89,82,78,382,合格
20184566,71,88,83,57,43,342,合格
20184567,93,61,15,94,80,343,合格
20184568,74,74,1,5,84,238,不合格
20184569,80,0,89,4,92,265,不合格
20184570,17,61,93,63,77,311,合格
20184571,41,3,2,12,86,144,不合格
20184572,1,78,10,48,29,166,不合格
20184573,84,6,37,75,30,232,不合格
20184574,99,73,18,91,98,379,合格
20184575,45,75,61,36,51,268,不合格
20184576,36,88,71,44,92,331,合格
20184577,18,63,86,89,56,312,合格
20184578,48,46,14,73,39,220,不合格
20184579,91,37,99,43,9,279,不合格
20184580,7,24,93,51,72,247,不合格
20184581,77,92,25,16,30,240,不合格
20184582,55,52,70,27,60,264,不合格
20184583,80,56,22,46,87,291,不合格
20184584,79,58,64,45,78,324,合格
20184585,4,92,95,33,14,238,不合格
20184586,32,10,67,66,78,253,不合格
20184587,59,26,60,31,4,180,不合格
20184588,90,35,9,37,55,226,不合格
20184589,41,88,31,8,23,191,不合格
20184590,73,0,24,68,62,227,不合格
20184591,22,33,72,58,88,273,不合格
20184592,21,93,61,47,77,299,不合格
20184593,92,55,37,6,5,195,不合格
20184594,51,91,9,47,76,274,不合格
20184595,87,57,80,23,37,284,不合格
20184596,64,54,73,27,55,273,不合格
20184597,1,84,41,3,20,149,不合格
20184598,44,63,24,69,16,216,不合格
20184599,3,87,19,36,24,169,不合格
20184600,29,31,0,70,17,147,不合格
20184601,5,42,11,49,27,134,不合格
20184602,87,84,63,34,74,342,合格
20184603,44,30,54,3,32,163,不合格
20184604,9,85,8,8,41,151,不合格
20184605,16,27,5,3,33,84,不合格
20184606,71,89,36,29,27,252,不合格
20184607,47,96,50,27,99,319,合格
20184608,57,89,58,24,55,283,不合格
20184609,11,78,14,50,29,182,不合格
20184610,79,55,21,86,92,333,合格
20184611,64,60,68,86,13,291,不合格
20184612,18,49,12,41,50,170,不合格
20184613,57,74,68,52,52,303,合格
20184614,19,73,77,56,49,274,不合格
20184615,12,53,81,55,68,269,不合格
20184616,71,93,23,54,31,272,不合格
20184617,28,42,57,84,50,261,不合格
20184618,51,78,26,3,26,184,不合格
20184619,1,80,57,39,95,272,不合格
20184620,37,75,6,35,49,202,不合格
20184621,18,83,47,49,73,270,不合格
20184622,63,55,23,64,86,291,不合格
20184623,36,37,68,94,55,290,不合格
20184624,42,85,53,43,30,253,不合格
20184625,67,6,61,11,69,214,不合格
20184626,30,97,67,48,41,283,不合格
20184627,21,50,99,91,59,320,合格
20184628,46,92,25,61,29,253,不合格
20184629,5,91,4,8,0,108,不合格
20184630,62,51,11,1,94,219,不合格
20184631,33,44,45,23,40,185,不合格
20184632,67,0,72,91,22,252,不合格
20184633,91,31,15,88,0,225,不合格
20184634,66,42,15,54,26,203,不合格
20184635,67,1,37,94,49,248,不合格
20184636,98,58,71,65,74,366,合格
20184637,24,83,65,74,40,286,不合格
20184638,75,76,54,72,44,321,合格
20184639,45,16,58,59,15,193,不合格
20184640,21,29,29,70,72,221,不合格
20184641,31,11,95,90,71,298,不合格
20184642,14,11,87,28,54,194,不合格
20184643,1,74,6,52,55,188,不合格
20184644,2,24,21,95,7,149,不合格
20184645,21,69,2,12,80,184,不合格
20184646,79,94,6,71,66,316,合格
20184647,12,93,46,10,20,181,不合格
20184648,11,49,66,34,5,165,不合格
20184649,62,22,21,21,0,126,不合格
20184650,15,53,27,58,52,205,不合格
20184651,94,64,98,41,24,321,合格
20184652,50,15,23,12,4,104,不合格
20184653,42,92,0,12,9,155,不合格
20184654,4,41,93,31,30,199,不合格
20184655,27,73,38,64,46,248,不合格
20184656,66,1,70,57,34,228,不合格
20184657,85,14,75,58,95,327,合格
20184658,95,26,2,15,70,208,不合格
20184659,42,39,52,63,45,241,不合格
20184660,73,9,95,78,37,292,不合格
20184661,38,34,7,74,79,232,不合格
20184662,52,41,97,95,9,294,不合格
20184663,61,21,4,41,2,129,不合格
20184664,2,98,41,13,10,164,不合格
20184665,67,9,42,65,92,275,不合格
20184666,33,35,76,72,42,258,不合格
20184667,39,34,17,52,46,188,不合格
20184668,59,18,60,30,6,173,不合格
20184669,7,85,23,18,20,153,不合格
20184670,45,47,38,19,3,152,不合格
20184671,47,28,16,69,22,182,不合格
20184672,54,94,7,43,20,218,不合格
20184673,0,86,19,78,32,215,不合格
20184674,63,72,28,11,83,257,不合格
20184675,60,90,22,77,27,276,不合格
20184676,19,46,57,72,46,240,不合格
20184677,36,1,77,64,30,208,不合格
20184678,20,14,60,18,26,138,不合格
20184679,56,58,43,51,47,255,不合格
20184680,84,12,78,11,49,234,不合格
20184681,44,15,11,67,94,231,不合格
20184682,43,33,49,74,35,234,不合格
20184683,49,2,17,94,69,231,不合格
20184684,72,55,98,34,91,350,合格
20184685,57,79,20,12,42,210,不合格
20184686,41,20,29,74,21,185,不合格
20184687,65,48,70,14,53,250,不合格
20184688,28,56,8,33,6,131,不合格
20184689,75,72,40,26,81,294,不合格
20184690,7,90,96,60,9,262,不合格
20184691,25,17,93,28,6,169,不合格
20184692,67,55,86,46,29,283,不合格
20184693,30,78,41,74,91,314,合格
20184694,24,71,83,99,96,373,合格
20184695,35,0,72,61,49,217,不合格
20184696,26,8,74,93,60,261,不合格
20184697,92,21,76,31,11,231,不合格
20184698,54,53,64,95,5,271,不合格
20184699,68,35,28,94,71,296,不合格
20184700,65,17,81,53,20,236,不合格
20184701,16,96,61,22,24,219,不合格
20184702,55,52,36,92,3,238,不合格
20184703,73,57,70,84,69,353,合格
20184704,62,18,51,0,41,172,不合格
20184705,96,92,72,5,88,353,合格
20184706,62,34,88,7,63,254,不合格
20184707,47,39,19,6,48,159,不合格
20184708,88,57,68,4,20,237,不合格
20184709,3,23,0,95,35,156,不合格
20184710,62,29,45,30,64,230,不合格
20184711,1,88,90,76,34,289,不合格
20184712,37,33,95,58,8,231,不合格
20184713,0,36,33,3,87,159,不合格
20184714,71,49,60,47,10,237,不合格
20184715,33,80,20,67,26,226,不合格
20184716,17,21,74,37,72,221,不合格
20184717,71,96,98,47,3,315,合格
20184718,11,42,15,99,79,246,不合格
20184719,78,17,84,13,78,270,不合格
20184720,40,16,13,35,73,177,不合格
20184721,45,32,44,82,63,266,不合格
20184722,75,59,96,89,45,364,合格
20184723,86,87,17,80,77,347,合格
20184724,26,28,40,40,99,233,不合格
20184725,18,12,56,15,5,106,不合格
20184726,34,59,20,64,60,237,不合格
20184727,40,69,34,47,57,247,不合格
20184728,39,6,15,92,96,248,不合格
20184729,83,59,99,26,54,321,合格
20184730,51,10,73,87,2,223,不合格
20184731,40,96,82,83,42,343,合格
20184732,2,93,64,94,8,261,不合格
20184733,97,37,83,81,92,390,合格
20184734,90,36,74,76,63,339,合格
20184735,83,25,90,8,62,268,不合格
20184736,88,28,51,72,31,270,不合格
20184737,77,1,54,51,76,259,不合格
20184738,37,90,71,46,64,308,合格
20184739,72,12,78,97,60,319,合格
20184740,8,35,29,18,42,132,不合格
20184741,9,27,15,49,7,107,不合格
20184742,52,53,18,69,8,200,不合格
20184743,82,97,25,14,4,222,不合格
20184744,34,5,26,40,60,165,不合格
20184745,22,50,66,74,84,296,不合格
20184746,53,77,9,55,46,240,不合格
20184747,68,75,4,24,87,258,不合格
20184748,87,95,31,35,31,279,不合格
20184749,91,48,28,42,30,239,不合格
20184750,37,46,3,62,4,152,不合格
20184751,4,28,96,96,47,271,不合格
20184752,33,52,79,55,31,250,不合格
20184753,98,80,79,44,0,301,合格
20184754,70,10,72,48,33,233,不合格
20184755,26,48,37,64,70,245,不合格
20184756,65,37,30,11,16,159,不合格
20184757,70,86,52,57,94,359,合格
20184758,25,70,17,63,34,209,不合格
20184759,33,30,46,54,82,245,不合格
20184760,2,49,96,87,0,234,不合格
20184761,81,28,58,6,42,215,不合格
20184762,9,47,92,90,40,278,不合格
20184763,13,6,64,41,51,175,不合格
20184764,7,2,10,34,85,138,不合格
20184765,59,83,17,80,5,244,不合格
20184766,33,55,83,91,43,305,合格
20184767,29,25,6,72,52,184,不合格
20184768,42,0,15,81,42,180,不合格
20184769,94,41,88,16,61,300,合格
20184770,51,94,76,88,42,351,合格
20184771,68,78,97,91,44,378,合格
20184772,97,37,51,82,0,267,不合格
20184773,6,10,43,17,10,86,不合格
20184774,21,91,65,13,13,203,不合格
20184775,61,65,57,50,57,290,不合格
20184776,22,50,65,12,39,188,不合格
20184777,90,31,51,33,38,243,不合格
20184778,88,93,44,82,68,375,合格
20184779,40,1,85,12,14,152,不合格
20184780,41,3,74,18,98,234,不合格
20184781,31,59,30,54,60,234,不合格
20184782,42,20,4,39,42,147,不合格
20184783,84,6,12,86,2,190,不合格
20184784,72,56,1,78,0,207,不合格
20184785,81,18,31,41,28,199,不合格
20184786,53,1,18,54,81,207,不合格
20184787,50,96,10,45,33,234,不合格
20184788,81,2,28,2,81,194,不合格
20184789,98,10,6,94,97,305,合格
20184790,87,54,51,79,37,308,合格
20184791,45,9,68,96,60,278,不合格
20184792,62,95,71,52,18,298,不合格
20184793,41,93,49,32,30,245,不合格
20184794,91,99,24,92,60,366,合格
20184795,71,42,21,98,33,265,不合格
20184796,17,94,15,89,10,225,不合格
20184797,28,2,27,92,46,195,不合格
20184798,31,32,96,97,61,317,合格
20184799,81,87,49,49,11,277,不合格
20184800,46,9,87,23,13,178,不合格
20184801,3,5,26,20,43,97,不合格
20184802,79,88,50,11,75,303,合格
20184803,38,27,57,98,70,290,不合格
20184804,87,55,12,63,51,268,不合格
20184805,91,66,2,51,63,273,不合格
20184806,36,96,6,19,0,157,不合格
20184807,74,3,51,95,35,258,不合格
20184808,13,0,19,73,93,198,不合格
20184809,49,96,83,86,46,360,合格
20184810,35,34,92,19,43,223,不合格
20184811,45,94,82,88,16,325,合格
20184812,75,90,21,70,66,322,合格
20184813,61,12,66,63,70,272,不合格
20184814,30,85,80,9,86,290,不合格
20184815,85,55,69,90,7,306,合格
20184816,41,67,70,25,55,258,不合格
20184817,48,2,41,7,6,104,不合格
20184818,38,1,19,69,63,190,不合格
20184819,70,95,51,68,66,350,合格
20184820,67,65,53,88,43,316,合格
20184821,60,48,85,99,42,334,合格
20184822,58,2,13,71,83,227,不合格
20184823,74,96,90,74,76,410,合格
20184824,35,32,91,64,55,277,不合格
20184825,55,58,58,39,65,275,不合格
20184826,30,91,8,59,65,253,不合格
20184827,81,60,71,3,99,314,合格
20184828,30,68,10,26,57,191,不合格
20184829,19,44,83,82,56,284,不合格
20184830,51,30,32,32,56,201,不合格
20184831,56,46,55,19,76,252,不合格
20184832,19,18,47,29,7,120,不合格
20184833,59,0,75,53,94,281,不合格
20184834,93,16,48,53,25,235,不合格
20184835,77,40,73,94,48,332,合格
20184836,14,44,55,30,30,173,不合格
20184837,80,2,66,20,30,198,不合格
20184838,58,26,97,41,22,244,不合格
20184839,3,85,57,78,29,252,不合格
20184840,95,14,79,75,80,343,合格
20184841,80,6,23,56,26,191,不合格
20184842,91,49,18,20,90,268,不合格
20184843,46,60,6,47,94,253,不合格
20184844,33,84,35,8,94,254,不合格
20184845,75,26,62,15,6,184,不合格
20184846,38,22,33,43,50,186,不合格
20184847,92,50,96,72,95,405,合格
20184848,21,11,51,7,68,158,不合格
20184849,77,63,5,94,16,255,不合格
20184850,14,70,93,81,68,326,合格
20184851,28,26,63,19,62,198,不合格
20184852,72,66,78,93,73,382,合格
20184853,56,46,46,51,85,284,不合格
20184854,10,51,33,41,70,205,不合格
20184855,34,21,77,54,78,264,不合格
20184856,88,17,87,80,30,302,合格
20184857,36,99,91,6,86,318,合格
20184858,78,21,74,32,45,250,不合格
20184859,33,90,46,60,50,279,不合格
20184860,68,35,74,49,43,269,不合格
20184861,38,60,71,55,57,281,不合格
20184862,18,30,53,42,75,218,不合格
20184863,93,36,46,27,8,210,不合格
20184864,62,5,92,92,26,277,不合格
20184865,45,58,95,71,65,334,合格
20184866,28,40,36,44,54,202,不合格
20184867,2,43,69,88,69,271,不合格
20184868,87,74,69,92,73,395,合格
20184869,98,80,47,37,39,301,合格
20184870,75,25,6,45,6,157,不合格
20184871,39,58,6,97,7,207,不合格
20184872,85,9,77,16,90,277,不合格
20184873,58,17,6,92,8,181,不合格
20184874,65,4,35,51,18,173,不合格
20184875,82,29,28,28,2,169,不合格
20184876,7,78,14,22,83,204,不合格
20184877,55,6,77,84,94,316,合格
20184878,30,99,75,70,69,343,合格
20184879,13,57,84,95,93,342,合格
20184880,82,2,15,68,71,238,不合格
20184881,84,45,70,77,0,276,不合格
20184882,37,77,86,87,10,297,不合格
20184883,70,22,60,36,68,256,不合格
20184884,11,67,41,28,78,225,不合格
20184885,49,67,59,12,92,279,不合格
20184886,29,17,80,60,40,226,不合格
20184887,21,68,70,90,42,291,不合格
20184888,5,65,11,34,15,130,不合格
20184889,28,79,60,49,6,222,不合格
20184890,38,1,78,49,72,238,不合格
20184891,8,10,28,85,13,144,不合格
20184892,84,74,63,3,26,250,不合格
20184893,76,29,59,26,68,258,不合格
20184894,7,26,32,14,23,102,不合格
20184895,6,41,22,1,8,78,不合格
20184896,86,49,10,34,40,219,不合格
20184897,77,82,6,80,55,300,合格
20184898,73,23,7,87,62,252,不合格
20184899,27,56,24,57,43,207,不合格
20184900,63,9,79,99,74,324,合格
20184901,48,95,49,6,2,200,不合格
20184902,57,49,53,41,30,230,不合格
20184903,7,84,47,50,51,239,不合格
20184904,23,22,46,29,53,173,不合格
20184905,5,72,12,19,3,111,不合格
20184906,23,70,56,7,71,227,不合格
20184907,38,28,53,9,81,209,不合格
20184908,91,49,80,82,78,380,合格
20184909,72,6,14,58,74,224,不合格
20184910,2,51,95,37,26,211,不合格
20184911,81,36,60,55,45,277,不合格
20184912,24,82,4,38,27,175,不合格
20184913,59,96,17,20,0,192,不合格
20184914,27,31,10,51,6,125,不合格
20184915,94,0,35,58,87,274,不合格
20184916,1,17,75,90,29,212,不合格
20184917,45,5,44,20,68,182,不合格
20184918,83,29,87,65,15,279,不合格
20184919,96,34,28,38,48,244,不合格
20184920,86,99,97,38,32,352,合格
20184921,29,36,41,76,42,224,不合格
20184922,53,13,13,96,34,209,不合格
20184923,73,30,40,17,45,205,不合格
20184924,33,52,95,46,53,279,不合格
20184925,1,42,91,96,38,268,不合格
20184926,32,0,5,64,43,144,不合格
20184927,77,7,52,94,85,315,合格
20184928,17,51,49,94,67,278,不合格
20184929,91,57,42,11,74,275,不合格
20184930,82,49,22,51,16,220,不合格
20184931,5,77,79,9,8,178,不合格
20184932,57,66,72,16,14,225,不合格
20184933,71,12,42,7,63,195,不合格
20184934,74,65,59,69,43,310,合格
20184935,18,87,19,10,15,149,不合格
20184936,35,11,45,45,57,193,不合格
20184937,53,60,90,35,92,330,合格
20184938,58,96,63,50,34,301,合格
20184939,63,89,83,54,63,352,合格
20184940,89,44,50,39,70,292,不合格
20184941,62,73,90,85,32,342,合格
20184942,46,15,17,79,85,242,不合格
20184943,96,61,5,71,26,259,不合格
20184944,66,41,90,18,88,303,合格
20184945,54,32,31,92,47,256,不合格
20184946,95,83,83,22,95,378,合格
20184947,75,22,95,1,43,236,不合格
20184948,7,90,64,34,63,258,不合格
20184949,19,36,98,46,87,286,不合格
20184950,82,8,37,23,2,152,不合格
20184951,63,74,63,29,64,293,不合格
20184952,39,70,88,66,27,290,不合格
20184953,68,60,51,31,2,212,不合格
20184954,26,2,66,77,73,244,不合格
20184955,17,81,58,50,45,251,不合格
20184956,20,87,53,16,44,220,不合格
20184957,39,82,0,99,96,316,合格
20184958,21,30,76,21,66,214,不合格
20184959,28,52,70,74,13,237,不合格
20184960,20,66,40,16,92,234,不合格
20184961,68,85,58,63,35,309,合格
20184962,13,75,39,73,6,206,不合格
20184963,53,50,35,62,26,226,不合格
20184964,78,31,99,23,49,280,不合格
20184965,1,52,33,47,71,204,不合格
20184966,13,76,65,73,35,262,不合格
20184967,62,7,25,34,67,195,不合格
20184968,64,98,43,60,0,265,不合格
20184969,24,87,52,32,25,220,不合格
20184970,68,90,56,23,27,264,不合格
20184971,23,46,24,38,62,193,不合格
20184972,57,53,41,1,3,155,不合格
20184973,81,81,11,81,43,297,不合格
20184974,95,9,64,81,47,296,不合格
20184975,95,24,11,49,92,271,不合格
20184976,37,10,63,37,43,190,不合格
20184977,82,67,77,79,40,345,合格
20184978,53,44,49,79,5,230,不合格
20184979,1,29,66,39,36,171,不合格
20184980,70,70,90,90,27,347,合格
20184981,38,58,42,16,58,212,不合格
20184982,25,66,20,10,86,207,不合格
20184983,62,97,64,53,70,346,合格
20184984,76,58,97,3,3,237,不合格
20184985,29,33,45,4,67,178,不合格
20184986,4,96,39,83,58,280,不合格
20184987,14,61,39,41,19,174,不合格
20184988,42,48,96,77,78,341,合格
20184989,84,26,83,12,39,244,不合格
20184990,45,57,36,53,74,265,不合格
20184991,97,57,49,36,68,307,合格
20184992,8,55,45,86,71,265,不合格
20184993,39,59,80,96,5,279,不合格
20184994,23,52,76,66,94,311,合格
20184995,43,87,82,36,47,295,不合格
20184996,58,45,53,5,87,248,不合格
20184997,30,10,84,89,56,269,不合格
20184998,3,35,88,32,37,195,不合格
20184999,50,10,27,34,1,122,不合格
20185000,41,66,88,36,74,305,合格
20185001,14,56,11,81,27,189,不合格
20185002,87,43,18,58,81,287,不合格
20185003,4,69,17,3,15,108,不合格
20185004,83,58,93,68,63,365,合格
20185005,71,32,95,31,74,303,合格
20185006,57,43,45,94,46,285,不合格
20185007,36,49,54,93,74,306,合格
20185008,32,23,96,37,34,222,不合格
20185009,45,3,63,0,73,184,不合格
20185010,28,38,71,21,22,180,不合格
20185011,8,41,39,96,81,265,不合格
20185012,80,63,75,87,52,357,合格
20185013,35,65,62,6,32,200,不合格
20185014,69,90,46,56,75,336,合格
20185015,20,80,38,33,18,189,不合格
20185016,58,60,92,91,8,309,合格
20185017,62,93,78,71,60,364,合格
20185018,9,67,88,73,29,266,不合格
20185019,94,60,98,80,8,340,合格
20185020,58,84,83,88,73,386,合格
20185021,94,82,83,55,82,396,合格
20185022,32,80,62,49,23,246,不合格
20185023,38,68,18,30,4,158,不合格
20185024,63,25,4,39,47,178,不合格
20185025,95,39,90,87,17,328,合格
20185026,52,92,72,79,31,326,合格
20185027,40,78,89,24,98,329,合格
20185028,76,64,17,8,66,231,不合格
20185029,47,37,98,57,88,327,合格
20185030,38,48,92,39,25,242,不合格
20185031,3,95,21,64,37,220,不合格
20185032,3,9,38,33,66,149,不合格
20185033,49,20,95,67,14,245,不合格
20185034,30,64,6,52,41,193,不合格
20185035,0,98,47,64,63,272,不合格
20185036,59,86,48,43,63,299,不合格
20185037,67,13,47,84,53,264,不合格
20185038,38,75,67,98,32,310,合格
20185039,87,9,26,89,57,268,不合格
20185040,34,83,39,65,93,314,合格
20185041,96,82,30,80,91,379,合格
20185042,30,10,37,43,77,197,不合格
20185043,21,19,13,2,27,82,不合格
20185044,2,58,0,8,66,134,不合格
20185045,96,68,42,81,48,335,合格
20185046,55,24,86,41,14,220,不合格
20185047,37,77,92,61,85,352,合格
20185048,67,91,21,5,24,208,不合格
20185049,5,7,93,94,57,256,不合格
20185050,55,22,72,4,61,214,不合格
20185051,4,33,24,25,34,120,不合格
20185052,29,18,45,11,74,177,不合格
20185053,41,97,98,38,21,295,不合格
20185054,60,82,14,47,93,296,不合格
20185055,4,7,18,97,90,216,不合格
20185056,15,55,34,90,61,255,不合格
20185057,64,11,82,84,85,326,合格
20185058,13,95,58,16,82,264,不合格
20185059,54,90,29,71,2,246,不合格
20185060,75,30,31,42,51,229,不合格
20185061,66,73,26,19,10,194,不合格
20185062,33,22,70,29,13,167,不合格
20185063,19,34,90,65,26,234,不合格
20185064,85,6,24,43,63,221,不合格
20185065,99,29,65,4,56,253,不合格
20185066,48,76,76,60,78,338,合格
20185067,4,34,8,32,64,142,不合格
20185068,9,90,70,27,74,270,不合格
20185069,79,93,21,15,93,301,合格
20185070,17,39,49,20,63,188,不合格
20185071,98,40,45,79,9,271,不合格
20185072,35,4,52,33,76,200,不合格
20185073,23,88,3,97,44,255,不合格
20185074,65,39,40,76,34,254,不合格
20185075,87,55,39,75,10,266,不合格
20185076,4,34,27,56,8,129,不合格
20185077,98,78,33,14,33,256,不合格
20185078,28,55,6,47,46,182,不合格
20185079,55,21,77,41,88,282,不合格
20185080,70,75,17,94,26,282,不合格
20185081,34,12,29,69,55,199,不合格
20185082,94,74,34,12,39,253,不合格
20185083,3,63,76,9,85,236,不合格
20185084,72,35,36,80,31,254,不合格
20185085,48,33,11,55,75,222,不合格
20185086,77,15,89,71,72,324,合格
20185087,39,31,69,46,35,220,不合格
20185088,52,20,93,73,6,244,不合格
20185089,60,94,62,82,90,388,合格
20185090,16,22,14,94,99,245,不合格
20185091,42,29,17,94,22,204,不合格
20185092,47,99,91,33,6,276,不合格
20185093,32,31,43,88,36,230,不合格
20185094,93,6,26,83,80,288,不合格
20185095,49,18,17,36,77,197,不合格
20185096,7,40,2,74,22,145,不合格
20185097,70,48,34,45,24,221,不合格
20185098,51,36,90,88,78,343,合格
20185099,68,11,2,87,52,220,不合格
20185100,36,96,71,24,17,244,不合格
20185101,22,89,88,34,17,250,不合格
20185102,51,14,81,29,76,251,不合格
20185103,60,62,43,29,28,222,不合格
20185104,42,25,23,8,93,191,不合格
20185105,26,6,48,47,22,149,不合格
20185106,87,92,59,14,47,299,不合格
20185107,97,66,12,3,58,236,不合格
20185108,3,1,58,90,87,239,不合格
20185109,1,83,84,18,17,203,不合格
20185110,39,76,75,83,85,358,合格
20185111,46,64,21,88,46,265,不合格
20185112,22,20,66,39,15,162,不合格
20185113,54,18,53,64,15,204,不合格
20185114,73,76,98,7,39,293,不合格
20185115,45,1,70,76,46,238,不合格
20185116,30,62,38,68,22,220,不合格
20185117,39,79,68,82,95,363,合格
20185118,40,20,89,58,11,218,不合格
20185119,67,42,55,2,68,234,不合格
20185120,88,70,33,20,35,246,不合格
20185121,86,43,68,45,63,305,合格
20185122,62,48,60,3,63,236,不合格
20185123,35,59,30,6,61,191,不合格
20185124,4,37,29,17,98,185,不合格
20185125,20,80,27,94,64,285,不合格
20185126,74,4,27,69,65,239,不合格
20185127,11,65,81,24,86,267,不合格
20185128,53,55,78,57,80,323,合格
20185129,38,38,80,87,45,288,不合格
20185130,69,16,0,88,99,272,不合格
20185131,16,69,36,95,32,248,不合格
20185132,33,15,59,34,74,215,不合格
20185133,59,33,7,94,34,227,不合格
20185134,35,98,50,22,27,232,不合格
20185135,7,4,67,45,91,214,不合格
20185136,74,3,41,3,90,211,不合格
20185137,39,58,37,99,91,324,合格
20185138,46,11,21,7,51,136,不合格
20185139,48,68,60,19,11,206,不合格
20185140,72,52,87,36,67,314,合格
20185141,50,69,89,63,67,338,合格
20185142,40,44,16,17,49,166,不合格
20185143,92,1,99,73,90,355,合格
20185144,62,11,26,87,28,214,不合格
20185145,30,14,10,36,44,134,不合格
20185146,64,61,98,86,59,368,合格
20185147,49,68,87,66,15,285,不合格
20185148,73,42,97,44,39,295,不合格
20185149,66,87,24,66,14,257,不合格
20185150,92,24,98,48,25,287,不合格
20185151,96,95,81,20,88,380,合格
20185152,12,60,90,76,91,329,合格
20185153,98,30,69,37,29,263,不合格
20185154,67,1,29,3,19,119,不合格
20185155,36,59,24,29,33,181,不合格
20185156,23,48,77,4,65,217,不合格
20185157,16,98,26,2,25,167,不合格
20185158,49,24,83,77,25,258,不合格
20185159,69,14,71,8,83,245,不合格
20185160,95,63,37,86,66,347,合格
20185161,83,36,74,36,4,233,不合格
20185162,96,0,69,54,43,262,不合格
20185163,10,36,78,0,30,154,不合格
20185164,15,74,5,59,81,234,不合格
20185165,26,80,89,7,20,222,不合格
20185166,11,82,68,33,31,225,不合格
20185167,33,48,71,81,11,244,不合格
20185168,4,35,90,82,35,246,不合格
20185169,27,54,17,59,4,161,不合格
20185170,66,67,5,32,51,221,不合格
20185171,95,46,66,89,45,341,合格
20185172,57,59,75,73,17,281,不合格
20185173,49,32,1,30,86,198,不合格
20185174,91,71,11,46,35,254,不合格
20185175,81,46,73,37,5,242,不合格
20185176,79,55,55,29,0,218,不合格
20185177,27,30,11,43,46,157,不合格
20185178,65,4,4,18,93,184,不合格
20185179,51,23,68,5,70,217,不合格
20185180,96,52,90,9,25,272,不合格
20185181,35,86,24,22,46,213,不合格
20185182,29,58,85,2,68,242,不合格
20185183,4,94,32,26,40,196,不合格
20185184,17,72,83,74,91,337,合格
20185185,54,76,12,38,11,191,不合格
20185186,68,2,94,62,59,285,不合格
20185187,24,98,90,74,14,300,合格
20185188,7,70,12,9,75,173,不合格
20185189,27,58,61,17,66,229,不合格
20185190,0,26,30,81,9,146,不合格
20185191,63,6,77,68,84,298,不合格
20185192,69,27,31,77,8,212,不合格
20185193,15,28,70,19,37,169,不合格
20185194,78,32,60,10,35,215,不合格
20185195,61,76,42,93,12,284,不合格
20185196,66,75,87,58,28,314,合格
20185197,15,38,57,49,26,185,不合格
20185198,88,78,90,42,83,381,合格
20185199,94,18,21,11,59,203,不合格
20185200,37,74,6,17,19,153,不合格
20185201,13,88,57,61,5,224,不合格
20185202,45,38,56,98,91,328,合格
20185203,77,16,63,10,34,200,不合格
20185204,98,95,92,41,62,388,合格
20185205,63,2,66,53,68,252,不合格
20185206,93,93,71,37,2,296,不合格
20185207,13,69,59,17,5,163,不合格
20185208,98,91,83,77,68,417,合格
20185209,88,16,40,61,24,229,不合格
20185210,88,88,44,4,83,307,合格
20185211,43,58,94,67,43,305,合格
20185212,96,22,25,65,26,234,不合格
20185213,67,65,52,19,48,251,不合格
20185214,89,74,68,15,95,341,合格
20185215,15,37,82,92,24,250,不合格
20185216,62,27,7,24,32,152,不合格
20185217,79,17,48,89,78,311,合格
20185218,5,72,55,31,17,180,不合格
20185219,62,53,7,61,53,236,不合格
20185220,70,57,60,85,5,277,不合格
20185221,32,39,32,78,70,251,不合格
20185222,25,53,44,4,86,212,不合格
20185223,86,23,65,83,20,277,不合格
20185224,95,9,44,85,91,324,合格
20185225,23,57,15,33,86,214,不合格
20185226,21,53,95,23,68,260,不合格
20185227,17,18,52,34,16,137,不合格
20185228,90,73,71,34,9,277,不合格
20185229,14,73,93,35,12,227,不合格
20185230,53,30,68,20,29,200,不合格
20185231,55,53,12,72,58,250,不合格
20185232,76,92,35,5,3,211,不合格
20185233,50,94,31,69,56,300,合格
20185234,8,8,61,80,93,250,不合格
20185235,19,78,61,83,65,306,合格
20185236,47,33,98,24,27,229,不合格
20185237,11,39,27,6,13,96,不合格
20185238,2,0,8,64,23,97,不合格
20185239,23,30,38,64,96,251,不合格
20185240,94,0,3,98,86,281,不合格
20185241,9,77,16,85,18,205,不合格
20185242,42,2,58,46,37,185,不合格
20185243,97,65,48,81,89,380,合格
20185244,99,5,16,66,79,265,不合格
20185245,37,60,51,43,42,233,不合格
20185246,2,78,91,92,24,287,不合格
20185247,32,54,84,4,54,228,不合格
20185248,4,94,40,83,75,296,不合格
20185249,94,98,53,45,14,304,合格
20185250,19,0,94,20,43,176,不合格
20185251,15,76,60,6,95,252,不合格
20185252,42,56,12,16,31,157,不合格
20185253,81,36,88,51,58,314,合格
20185254,72,85,89,43,58,347,合格
20185255,62,74,44,90,54,324,合格
20185256,27,2,6,74,57,166,不合格
20185257,40,60,13,4,18,135,不合格
20185258,71,83,56,42,2,254,不合格
20185259,77,53,0,96,79,305,合格
20185260,67,19,59,71,49,265,不合格
20185261,34,11,38,49,85,217,不合格
20185262,90,61,74,60,95,380,合格
20185263,88,98,92,54,74,406,合格
20185264,73,40,69,64,47,293,不合格
20185265,89,90,13,44,72,308,合格
20185266,32,64,46,37,11,190,不合格
20185267,65,7,54,54,34,214,不合格
20185268,13,9,69,70,36,197,不合格
20185269,56,37,81,67,2,243,不合格
20185270,36,53,42,21,56,208,不合格
20185271,1,33,44,27,37,142,不合格
20185272,93,68,52,97,25,335,合格
20185273,65,11,66,89,66,297,不合格
20185274,16,8,0,45,90,159,不合格
20185275,93,87,69,61,49,359,合格
20185276,69,55,85,60,22,291,不合格
20185277,56,35,14,65,88,258,不合格
20185278,17,89,3,40,11,160,不合格
20185279,36,57,89,1,90,273,不合格
20185280,11,20,69,52,35,187,不合格
20185281,50,21,65,19,9,164,不合格
20185282,63,62,58,62,21,266,不合格
20185283,3,44,4,30,76,157,不合格
20185284,68,87,95,45,84,379,合格
20185285,25,28,66,92,61,272,不合格
20185286,15,40,5,76,87,223,不合格
20185287,38,49,49,97,65,298,不合格
20185288,25,19,77,92,77,290,不合格
20185289,7,61,77,96,15,256,不合格
20185290,94,23,2,60,60,239,不合格
20185291,26,80,56,0,13,175,不合格
20185292,94,57,59,7,43,260,不合格
20185293,87,63,14,65,30,259,不合格
20185294,75,64,16,19,31,205,不合格
20185295,60,74,4,32,50,220,不合格
20185296,63,80,22,80,16,261,不合格
20185297,88,99,35,35,26,283,不合格
20185298,42,36,8,75,36,197,不合格
20185299,2,81,47,17,15,162,不合格
20185300,39,41,73,43,42,238,不合格
20185301,76,67,86,93,51,373,合格
20185302,96,43,23,53,63,278,不合格
20185303,70,85,10,99,32,296,不合格
20185304,74,2,45,69,11,201,不合格
20185305,80,48,20,87,83,318,合格
20185306,12,4,11,4,67,98,不合格
20185307,84,84,72,56,51,347,合格
20185308,48,93,68,9,18,236,不合格
20185309,29,98,67,0,19,213,不合格
20185310,85,48,64,47,4,248,不合格
20185311,85,89,47,17,8,246,不合格
20185312,74,62,5,23,74,238,不合格
20185313,39,2,81,78,61,261,不合格
20185314,21,48,83,24,2,178,不合格
20185315,42,38,65,49,60,254,不合格
20185316,52,84,18,56,37,247,不合格
20185317,81,67,95,15,82,340,合格
20185318,12,0,25,27,98,162,不合格
20185319,18,74,78,78,64,312,合格
20185320,20,37,72,37,12,178,不合格
20185321,13,21,65,38,18,155,不合格
20185322,50,48,5,94,81,278,不合格
20185323,5,68,90,12,62,237,不合格
20185324,22,81,45,82,69,299,不合格
20185325,19,96,96,78,88,377,合格
20185326,78,22,39,92,86,317,合格
20185327,74,48,66,96,93,377,合格
20185328,77,69,6,82,94,328,合格
20185329,43,7,99,4,91,244,不合格
20185330,85,5,44,56,80,270,不合格
20185331,86,77,5,39,73,280,不合格
20185332,50,49,9,0,98,206,不合格
20185333,15,57,96,98,3,269,不合格
20185334,35,42,51,47,56,231,不合格
20185335,7,7,0,77,57,148,不合格
20185336,52,33,71,43,80,279,不合格
20185337,40,56,10,24,51,181,不合格
20185338,39,66,68,70,82,325,合格
20185339,81,85,62,79,74,381,合格
20185340,8,28,17,82,81,216,不合格
20185341,79,86,94,93,74,426,合格
20185342,50,89,71,92,61,363,合格
20185343,66,32,57,40,30,225,不合格
20185344,11,71,85,37,51,255,不合格
20185345,31,19,38,64,93,245,不合格
20185346,0,29,38,66,7,140,不合格
20185347,98,13,71,19,53,254,不合格
20185348,9,78,16,99,48,250,不合格
20185349,9,3,18,66,63,159,不合格
20185350,36,65,27,35,43,206,不合格
20185351,34,35,81,14,44,208,不合格
20185352,88,98,45,89,87,407,合格
20185353,7,7,40,53,66,173,不合格
20185354,42,37,83,7,23,192,不合格
20185355,13,14,42,19,29,117,不合格
20185356,16,58,92,93,80,339,合格
20185357,21,26,12,49,47,155,不合格
20185358,0,17,45,63,10,135,不合格
20185359,1,15,8,9,60,93,不合格
20185360,23,75,55,62,56,271,不合格
20185361,53,61,88,51,39,292,不合格
20185362,12,21,20,25,72,150,不合格
20185363,21,94,31,32,32,210,不合格
20185364,14,30,89,30,53,216,不合格
20185365,57,19,97,6,58,237,不合格
20185366,67,78,47,47,90,329,合格
20185367,76,42,33,99,57,307,合格
20185368,70,21,82,43,38,254,不合格
20185369,79,20,85,54,15,253,不合格
20185370,17,37,62,98,86,300,合格
20185371,5,50,95,30,21,201,不合格
20185372,26,61,56,51,2,196,不合格
20185373,46,60,24,55,17,202,不合格
20185374,87,18,49,26,4,184,不合格
20185375,80,39,86,11,82,298,不合格
20185376,34,6,90,91,54,275,不合格
20185377,10,41,48,75,27,201,不合格
20185378,71,19,99,76,67,332,合格
20185379,0,59,89,54,72,274,不合格
20185380,32,4,68,39,81,224,不合格
20185381,56,27,84,17,84,268,不合格
20185382,44,76,31,84,83,318,合格
20185383,70,72,15,15,61,233,不合格
20185384,90,49,45,0,47,231,不合格
20185385,38,80,43,47,54,262,不合格
20185386,34,45,0,96,91,266,不合格
20185387,87,86,99,48,15,335,合格
20185388,96,40,81,35,62,314,合格
20185389,66,18,77,76,57,294,不合格
20185390,38,6,33,78,86,241,不合格
20185391,35,16,25,79,89,244,不合格
20185392,22,72,29,86,79,288,不合格
20185393,61,89,59,68,15,292,不合格
20185394,42,17,83,17,86,245,不合格
20185395,22,58,49,95,59,283,不合格
20185396,79,83,93,6,51,312,合格
20185397,17,99,27,24,93,260,不合格
20185398,43,0,0,38,91,172,不合格
20185399,20,93,77,68,94,352,合格
20185400,95,15,28,66,7,211,不合格
20185401,39,5,86,67,38,235,不合格
20185402,1,31,48,53,68,201,不合格
20185403,33,67,84,75,35,294,不合格
20185404,8,55,23,70,81,237,不合格
20185405,58,1,44,87,78,268,不合格
20185406,25,90,90,44,2,251,不合格
20185407,47,25,42,97,54,265,不合格
20185408,68,90,93,35,69,355,合格
20185409,67,22,90,62,68,309,合格
20185410,85,55,48,70,64,322,合格
20185411,14,12,82,27,10,145,不合格
20185412,21,34,56,88,43,242,不合格
20185413,2,22,61,80,80,245,不合格
20185414,83,7,21,66,0,177,不合格
20185415,79,92,10,87,53,321,合格
20185416,7,75,20,35,45,182,不合格
20185417,43,68,46,13,53,223,不合格
20185418,51,31,4,14,13,113,不合格
20185419,35,64,19,58,47,223,不合格
20185420,47,71,66,9,84,277,不合格
20185421,47,57,67,60,38,269,不合格
20185422,2,45,70,57,18,192,不合格
20185423,92,70,35,72,17,286,不合格
20185424,74,58,10,69,30,241,不合格
20185425,8,82,67,12,71,240,不合格
20185426,65,32,89,62,62,310,合格
20185427,13,93,92,45,96,339,合格
20185428,77,2,56,40,65,240,不合格
20185429,84,25,76,94,96,375,合格
20185430,11,93,1,46,3,154,不合格
20185431,36,54,33,83,95,301,合格
20185432,59,56,19,98,40,272,不合格
20185433,87,97,12,49,85,330,合格
20185434,80,63,66,82,8,299,不合格
20185435,37,26,34,78,54,229,不合格
20185436,18,4,80,7,77,186,不合格
20185437,76,24,23,84,57,264,不合格
20185438,96,78,87,45,34,340,合格
20185439,77,35,15,60,15,202,不合格
20185440,58,22,10,30,44,164,不合格
20185441,33,20,65,19,27,164,不合格
20185442,20,25,35,80,91,251,不合格
20185443,56,26,39,29,29,179,不合格
20185444,53,25,92,5,33,208,不合格
20185445,97,70,75,95,71,408,合格
20185446,94,91,15,84,84,368,合格
20185447,9,65,81,23,32,210,不合格
20185448,65,35,29,0,27,156,不合格
20185449,24,69,76,67,29,265,不合格
20185450,9,27,89,61,38,224,不合格
20185451,78,91,10,84,87,350,合格
20185452,16,54,58,76,16,220,不合格
20185453,5,28,14,75,40,162,不合格
20185454,38,61,23,44,52,218,不合格
20185455,64,60,0,82,33,239,不合格
20185456,81,49,15,2,94,241,不合格
20185457,27,50,41,51,23,192,不合格
20185458,64,33,59,84,23,263,不合格
20185459,8,5,55,75,81,224,不合格
20185460,6,98,84,56,26,270,不合格
20185461,43,58,87,67,6,261,不合格
20185462,33,34,58,44,31,200,不合格
20185463,89,49,69,59,81,347,合格
20185464,75,84,57,22,77,315,合格
20185465,25,50,78,48,92,293,不合格
20185466,89,0,51,78,92,310,合格
20185467,98,63,11,15,94,281,不合格
20185468,44,24,70,70,70,278,不合格
20185469,35,13,10,21,68,147,不合格
20185470,10,3,85,93,2,193,不合格
20185471,66,44,95,15,58,278,不合格
20185472,19,18,57,52,44,190,不合格
20185473,76,26,76,68,40,286,不合格
20185474,50,46,7,86,23,212,不合格
20185475,80,41,15,28,9,173,不合格
20185476,86,83,61,58,67,355,合格
20185477,39,60,73,41,98,311,合格
20185478,18,1,27,92,16,154,不合格
20185479,39,91,29,14,6,179,不合格
20185480,0,26,72,35,9,142,不合格
20185481,12,41,83,47,86,269,不合格
20185482,39,93,30,53,70,285,不合格
20185483,88,67,65,69,64,353,合格
20185484,70,39,79,18,73,279,不合格
20185485,58,71,37,86,10,262,不合格
20185486,63,8,11,48,66,196,不合格
20185487,67,57,70,16,93,303,合格
20185488,10,66,90,53,38,257,不合格
20185489,88,27,23,27,37,202,不合格
20185490,67,5,65,28,11,176,不合格
20185491,51,10,12,92,32,197,不合格
20185492,34,80,40,98,65,317,合格
20185493,40,22,79,72,71,284,不合格
20185494,78,14,56,35,94,277,不合格
20185495,45,37,48,74,81,285,不合格
20185496,40,35,4,76,25,180,不合格
20185497,4,30,71,39,87,231,不合格
20185498,17,4,3,15,67,106,不合格
20185499,24,1,45,39,60,169,不合格
20185500,31,94,91,43,39,298,不合格
