ID,国語,数学,英語,理科,社会,合計,判定
20190001,14,65,67,72,85,303,合格
20190002,53,40,5,9,48,155,不合格
20190003,60,58,28,53,47,246,不合格
20190004,29,89,73,41,91,323,合格
20190005,97,14,40,42,90,283,不合格
20190006,6,24,54,50,89,223,不合格
20190007,92,53,95,98,84,422,合格
20190008,51,96,31,84,2,264,不合格
20190009,21,81,40,44,5,191,不合格
20190010,75,51,52,72,64,314,合格
20190011,58,52,32,24,77,243,不合格
20190012,52,99,11,78,29,269,不合格
20190013,63,46,28,40,46,223,不合格
20190014,23,57,30,85,17,212,不合格
20190015,42,63,67,3,49,224,不合格
20190016,79,80,16,17,47,239,不合格
20190017,41,5,16,4,77,143,不合格
20190018,28,59,8,87,53,235,不合格
20190019,66,32,94,99,38,329,合格
20190020,95,17,18,60,21,211,不合格
20190021,0,15,70,25,8,118,不合格
20190022,91,81,82,2,13,269,不合格
20190023,90,12,74,83,66,325,合格
20190024,99,45,65,65,95,369,合格
20190025,2,83,90,12,98,285,不合格
20190026,93,52,47,90,97,379,合格
20190027,35,46,88,58,3,230,不合格
20190028,65,95,93,13,88,354,合格
20190029,45,28,39,54,29,195,不合格
20190030,25,82,49,98,34,288,不合格
20190031,6,74,94,5,50,229,不合格
20190032,2,2,56,17,11,88,不合格
20190033,24,50,72,35,4,185,不合格
20190034,97,94,24,82,65,362,合格
20190035,82,15,4,43,19,163,不合格
20190036,69,56,98,18,36,277,不合格
20190037,57,69,26,9,98,259,不合格
20190038,47,63,94,19,90,313,合格
20190039,98,2,56,8,84,248,不合格
20190040,89,60,13,30,62,254,不合格
20190041,99,23,27,26,58,233,不合格
20190042,61,54,34,70,78,297,不合格
20190043,99,54,85,38,58,334,合格
20190044,77,32,45,42,8,204,不合格
20190045,49,22,91,55,92,309,合格
20190046,43,23,31,72,69,238,不合格
20190047,56,79,50,79,70,334,合格
20190048,30,32,33,19,44,158,不合格
20190049,10,12,19,10,15,66,不合格
20190050,87,52,39,29,42,249,不合格
20190051,70,59,9,16,23,177,不合格
20190052,28,60,89,49,75,301,合格
20190053,27,46,14,88,88,263,不合格
20190054,73,87,88,26,7,281,不合格
20190055,2,30,65,25,16,138,不合格
20190056,85,94,59,65,2,305,合格
20190057,28,77,65,11,29,210,不合格
20190058,26,70,84,30,55,265,不合格
20190059,44,38,49,8,14,153,不合格
20190060,88,11,43,3,81,226,不合格
20190061,14,52,42,11,16,135,不合格
20190062,47,91,22,39,60,259,不合格
20190063,53,99,65,71,90,378,合格
20190064,87,91,16,85,49,328,合格
20190065,85,71,4,88,76,324,合格
20190066,74,87,19,91,42,313,合格
20190067,68,49,89,73,4,283,不合格
20190068,6,16,85,0,18,125,不合格
20190069,85,70,46,43,41,285,不合格
20190070,44,64,0,8,24,140,不合格
20190071,81,1,98,72,68,320,合格
20190072,4,10,48,4,42,108,不合格
20190073,78,52,15,47,54,246,不合格
20190074,68,69,88,22,80,327,合格
20190075,86,47,91,49,0,273,不合格
20190076,36,74,12,2,21,145,不合格
20190077,78,52,65,79,45,319,合格
20190078,83,27,96,53,14,273,不合格
20190079,44,24,92,48,70,278,不合格
20190080,5,16,57,72,69,219,不合格
20190081,38,20,72,8,29,167,不合格
20190082,28,42,9,92,8,179,不合格
20190083,35,55,16,35,5,146,不合格
20190084,26,83,28,11,97,245,不合格
20190085,16,90,21,53,20,200,不合格
20190086,24,81,82,48,23,258,不合格
20190087,28,12,29,2,24,95,不合格
20190088,10,71,88,3,86,258,不合格
20190089,93,45,69,44,43,294,不合格
20190090,13,35,3,75,46,172,不合格
20190091,33,11,55,86,23,208,不合格
20190092,69,86,97,42,46,340,合格
20190093,80,69,37,65,47,298,不合格
20190094,13,61,59,90,80,303,合格
20190095,79,96,73,29,43,320,合格
20190096,37,29,44,72,21,203,不合格
20190097,78,4,3,71,15,171,不合格
20190098,10,19,4,15,71,119,不合格
20190099,19,10,7,27,45,108,不合格
20190100,68,31,47,29,42,217,不合格
20190101,14,15,48,63,41,181,不合格
20190102,59,46,44,19,11,179,不合格
20190103,70,62,75,15,51,273,不合格
20190104,19,7,47,64,32,169,不合格
20190105,59,18,96,62,23,258,不合格
20190106,44,63,68,13,91,279,不合格
20190107,77,72,93,72,2,316,合格
20190108,63,16,87,51,54,271,不合格
20190109,11,27,20,47,23,128,不合格
20190110,78,25,97,52,16,268,不合格
20190111,61,26,70,90,60,307,合格
20190112,32,90,88,45,69,324,合格
20190113,33,87,66,46,85,317,合格
20190114,7,39,58,49,30,183,不合格
20190115,22,23,67,70,49,231,不合格
20190116,97,33,7,65,82,284,不合格
20190117,72,61,63,64,86,346,合格
20190118,53,61,36,84,17,251,不合格
20190119,68,95,25,98,14,300,合格
20190120,57,8,63,1,76,205,不合格
20190121,57,67,93,19,30,266,不合格
20190122,7,6,62,6,96,177,不合格
20190123,74,87,70,20,54,305,合格
20190124,36,83,44,53,37,253,不合格
20190125,50,35,70,24,14,193,不合格
20190126,84,70,12,91,47,304,合格
20190127,86,70,69,96,9,330,合格
20190128,95,26,81,76,7,285,不合格
20190129,86,1,62,81,8,238,不合格
20190130,20,39,47,10,75,191,不合格
20190131,46,58,6,20,67,197,不合格
20190132,30,12,65,57,69,233,不合格
20190133,11,14,31,78,42,176,不合格
20190134,71,31,45,45,18,210,不合格
20190135,49,40,28,66,31,214,不合格
20190136,57,78,51,39,6,231,不合格
20190137,57,43,12,28,25,165,不合格
20190138,22,59,84,33,21,219,不合格
20190139,33,67,41,86,41,268,不合格
20190140,56,0,20,91,38,205,不合格
20190141,37,0,19,54,62,172,不合格
20190142,58,31,46,5,84,224,不合格
20190143,47,6,57,46,37,193,不合格
20190144,35,65,29,70,7,206,不合格
20190145,5,42,98,31,18,194,不合格
20190146,24,79,95,23,24,245,不合格
20190147,87,22,22,26,80,237,不合格
20190148,94,71,75,94,30,364,合格
20190149,29,37,40,84,98,288,不合格
20190150,96,84,23,80,68,351,合格
20190151,39,75,77,28,90,309,合格
20190152,98,46,59,10,62,275,不合格
20190153,19,45,25,59,27,175,不合格
20190154,88,10,14,13,26,151,不合格
20190155,57,47,50,42,97,293,不合格
20190156,43,0,89,84,0,216,不合格
20190157,48,41,29,20,36,174,不合格
20190158,92,27,74,32,65,290,不合格
20190159,17,56,95,21,80,269,不合格
20190160,74,58,40,24,73,269,不合格
20190161,30,76,42,60,68,276,不合格
20190162,70,79,58,53,71,331,合格
20190163,23,25,82,61,37,228,不合格
20190164,21,51,65,23,91,251,不合格
20190165,40,42,82,9,30,203,不合格
20190166,27,40,95,31,86,279,不合格
20190167,9,81,31,5,43,169,不合格
20190168,61,37,66,45,23,232,不合格
20190169,37,37,13,49,20,156,不合格
20190170,69,75,81,91,5,321,合格
20190171,84,83,19,8,9,203,不合格
20190172,50,40,88,67,18,263,不合格
20190173,39,32,77,6,41,195,不合格
20190174,52,90,20,84,45,291,不合格
20190175,43,44,17,70,87,261,不合格
20190176,70,85,84,30,46,315,合格
20190177,13,48,7,34,51,153,不合格
20190178,32,8,12,24,88,164,不合格
20190179,88,13,83,7,3,194,不合格
20190180,75,76,15,42,27,235,不合格
20190181,47,73,35,19,22,196,不合格
20190182,37,13,54,64,17,185,不合格
20190183,38,82,34,28,42,224,不合格
20190184,12,56,56,34,63,221,不合格
20190185,66,60,29,22,64,241,不合格
20190186,22,84,33,67,54,260,不合格
20190187,36,96,66,65,58,321,合格
20190188,76,2,63,38,37,216,不合格
20190189,21,22,86,4,21,154,不合格
20190190,68,60,71,31,93,323,合格
20190191,33,19,88,68,73,281,不合格
20190192,83,12,83,50,54,282,不合格
20190193,89,0,69,69,60,287,不合格
20190194,19,11,71,65,60,226,不合格
20190195,45,72,13,91,6,227,不合格
20190196,78,32,7,38,95,250,不合格
20190197,83,64,39,81,78,345,合格
20190198,13,81,79,82,84,339,合格
20190199,88,38,31,11,39,207,不合格
20190200,88,4,67,59,95,313,合格
20190201,65,63,26,13,32,199,不合格
20190202,79,19,95,86,40,319,合格
20190203,95,58,65,7,30,255,不合格
20190204,2,55,16,63,56,192,不合格
20190205,61,15,83,70,12,241,不合格
20190206,76,18,41,12,55,202,不合格
20190207,41,20,86,7,17,171,不合格
20190208,16,17,5,26,34,98,不合格
20190209,99,8,57,48,61,273,不合格
20190210,78,97,48,80,9,312,合格
20190211,74,6,57,45,67,249,不合格
20190212,8,91,78,26,15,218,不合格
20190213,76,73,25,21,92,287,不合格
20190214,78,42,2,48,89,259,不合格
20190215,81,97,50,52,95,375,合格
20190216,39,57,43,35,61,235,不合格
20190217,56,78,9,18,80,241,不合格
20190218,17,50,3,58,16,144,不合格
20190219,8,78,79,34,57,256,不合格
20190220,38,4,71,16,67,196,不合格
20190221,84,29,7,26,50,196,不合格
20190222,87,77,25,44,18,251,不合格
20190223,75,87,69,10,5,246,不合格
20190224,84,46,29,51,58,268,不合格
20190225,76,0,85,73,52,286,不合格
20190226,80,73,22,70,0,245,不合格
20190227,76,86,99,42,91,394,合格
20190228,61,29,82,65,34,271,不合格
20190229,19,13,85,47,57,221,不合格
20190230,22,50,92,85,37,286,不合格
20190231,20,48,87,38,97,290,不合格
20190232,94,57,5,84,18,258,不合格
20190233,22,83,80,11,87,283,不合格
20190234,68,63,96,9,91,327,合格
20190235,28,35,78,51,27,219,不合格
20190236,18,48,21,37,79,203,不合格
20190237,33,72,19,4,10,138,不合格
20190238,82,28,58,39,62,269,不合格
20190239,33,8,85,87,34,247,不合格
20190240,8,43,98,2,59,210,不合格
20190241,3,18,7,80,31,139,不合格
20190242,13,50,28,70,96,257,不合格
20190243,32,33,96,81,63,305,合格
20190244,2,70,44,42,66,224,不合格
20190245,24,5,14,17,30,90,不合格
20190246,34,17,63,35,14,163,不合格
20190247,27,55,68,69,4,223,不合格
20190248,42,75,23,84,89,313,合格
20190249,20,70,16,12,63,181,不合格
20190250,35,74,59,63,52,283,不合格
20190251,98,36,56,48,73,311,合格
20190252,50,15,93,6,58,222,不合格
20190253,22,3,49,60,67,201,不合格
20190254,18,87,37,75,81,298,不合格
20190255,14,94,62,20,80,270,不合格
20190256,17,68,90,69,74,318,合格
20190257,79,21,86,37,33,256,不合格
20190258,80,10,11,64,58,223,不合格
20190259,39,21,46,79,9,194,不合格
20190260,75,5,73,33,75,261,不合格
20190261,69,23,87,40,76,295,不合格
20190262,66,55,67,94,65,347,合格
20190263,59,62,74,27,8,230,不合格
20190264,30,41,27,79,77,254,不合格
20190265,21,58,34,61,78,252,不合格
20190266,51,18,37,63,43,212,不合格
20190267,65,78,62,6,87,298,不合格
20190268,99,43,0,44,8,194,不合格
20190269,1,72,77,22,30,202,不合格
20190270,90,40,31,85,55,301,合格
20190271,13,57,18,53,8,149,不合格
20190272,54,93,26,45,50,268,不合格
20190273,18,9,54,44,91,216,不合格
20190274,57,58,24,90,22,251,不合格
20190275,53,80,89,50,63,335,合格
20190276,21,28,8,34,54,145,不合格
20190277,86,64,50,67,59,326,合格
20190278,9,79,53,20,4,165,不合格
20190279,19,49,43,42,97,250,不合格
20190280,71,49,50,85,15,270,不合格
20190281,0,86,13,0,92,191,不合格
20190282,30,31,26,77,17,181,不合格
20190283,0,81,4,60,11,156,不合格
20190284,33,68,45,91,66,303,合格
20190285,3,6,60,20,44,133,不合格
20190286,88,81,23,53,66,311,合格
20190287,1,49,24,56,74,204,不合格
20190288,79,90,16,43,92,320,合格
20190289,84,72,44,14,95,309,合格
20190290,39,96,92,74,81,382,合格
20190291,71,57,84,86,32,330,合格
20190292,78,99,19,41,82,319,合格
20190293,38,91,74,9,96,308,合格
20190294,19,76,41,51,64,251,不合格
20190295,98,79,35,98,71,381,合格
20190296,54,52,67,6,15,194,不合格
20190297,50,49,25,64,74,262,不合格
20190298,94,85,34,35,38,286,不合格
20190299,77,31,2,88,19,217,不合格
20190300,35,64,60,55,86,300,合格
20190301,19,67,13,13,63,175,不合格
20190302,52,50,89,62,61,314,合格
20190303,74,86,68,30,13,271,不合格
20190304,22,10,94,90,31,247,不合格
20190305,98,53,92,33,47,323,合格
20190306,81,39,52,84,37,293,不合格
20190307,77,36,58,88,92,351,合格
20190308,47,39,49,77,24,236,不合格
20190309,39,0,84,46,39,208,不合格
20190310,15,40,78,23,82,238,不合格
20190311,30,5,0,29,50,114,不合格
20190312,91,85,37,8,42,263,不合格
20190313,37,44,69,51,45,246,不合格
20190314,17,27,61,34,16,155,不合格
20190315,37,91,5,47,24,204,不合格
20190316,91,20,85,37,88,321,合格
20190317,36,51,15,52,5,159,不合格
20190318,9,84,59,25,12,189,不合格
20190319,50,28,92,88,95,353,合格
20190320,61,33,56,12,72,234,不合格
20190321,29,56,42,99,1,227,不合格
20190322,99,89,90,80,50,408,合格
20190323,83,86,26,29,63,287,不合格
20190324,48,94,35,77,98,352,合格
20190325,95,90,62,39,45,331,合格
20190326,38,20,55,46,10,169,不合格
20190327,0,75,33,42,75,225,不合格
20190328,0,69,63,30,37,199,不合格
20190329,1,41,26,13,83,164,不合格
20190330,81,28,0,73,44,226,不合格
20190331,1,78,13,30,85,207,不合格
20190332,92,52,22,90,38,294,不合格
20190333,25,99,99,69,53,345,合格
20190334,22,86,87,8,54,257,不合格
20190335,40,69,51,89,75,324,合格
20190336,54,44,89,9,29,225,不合格
20190337,34,6,90,99,98,327,合格
20190338,18,95,14,92,47,266,不合格
20190339,5,38,39,60,17,159,不合格
20190340,76,73,70,83,68,370,合格
20190341,67,41,86,27,74,295,不合格
20190342,47,81,18,25,58,229,不合格
20190343,79,79,98,14,41,311,合格
20190344,94,61,56,54,33,298,不合格
20190345,81,69,36,66,85,337,合格
20190346,47,39,54,13,12,165,不合格
20190347,19,68,32,82,28,229,不合格
20190348,73,82,81,50,4,290,不合格
20190349,3,42,11,16,51,123,不合格
20190350,75,47,37,51,54,264,不合格
20190351,2,28,19,29,51,129,不合格
20190352,87,78,15,98,99,377,合格
20190353,29,85,86,53,70,323,合格
20190354,26,13,27,95,27,188,不合格
20190355,9,6,70,73,0,158,不合格
20190356,65,14,15,76,84,254,不合格
20190357,46,71,53,59,65,294,不合格
20190358,23,50,39,4,17,133,不合格
20190359,12,20,54,23,40,149,不合格
20190360,52,54,10,60,78,254,不合格
20190361,23,14,88,97,84,306,合格
20190362,56,3,64,30,8,161,不合格
20190363,38,25,35,96,65,259,不合格
20190364,64,38,66,22,66,256,不合格
20190365,49,74,87,12,92,314,合格
20190366,2,84,89,61,83,319,合格
20190367,74,62,53,23,68,280,不合格
20190368,30,67,68,99,7,271,不合格
20190369,39,75,27,73,92,306,合格
20190370,18,61,31,23,6,139,不合格
20190371,99,7,23,26,72,227,不合格
20190372,43,81,48,91,27,290,不合格
20190373,55,43,68,2,29,197,不合格
20190374,55,69,96,66,15,301,合格
20190375,59,16,80,90,95,340,合格
20190376,55,59,24,25,63,226,不合格
20190377,91,63,66,65,85,370,合格
20190378,19,10,96,44,91,260,不合格
20190379,96,42,29,81,57,305,合格
20190380,6,15,50,13,79,163,不合格
20190381,28,54,82,65,86,315,合格
20190382,8,75,12,87,1,183,不合格
20190383,77,44,98,57,94,370,合格
20190384,46,5,78,44,41,214,不合格
20190385,85,17,24,22,38,186,不合格
20190386,34,98,41,13,76,262,不合格
20190387,82,72,2,16,0,172,不合格
20190388,1,22,71,66,81,241,不合格
20190389,56,0,21,75,8,160,不合格
20190390,42,12,40,47,10,151,不合格
20190391,75,1,80,91,47,294,不合格
20190392,78,80,13,33,61,265,不合格
20190393,37,39,15,68,75,234,不合格
20190394,88,93,53,90,88,412,合格
20190395,99,45,63,46,42,295,不合格
20190396,43,41,58,84,3,229,不合格
20190397,11,13,14,86,20,144,不合格
20190398,13,99,22,10,8,152,不合格
20190399,99,95,8,79,98,379,合格
20190400,33,12,17,44,4,110,不合格
20190401,27,43,15,35,66,186,不合格
20190402,12,11,9,81,53,166,不合格
20190403,81,15,49,53,61,259,不合格
20190404,67,69,14,45,25,220,不合格
20190405,75,59,5,46,17,202,不合格
20190406,49,80,37,13,89,268,不合格
20190407,17,67,26,7,77,194,不合格
20190408,56,49,96,21,10,232,不合格
20190409,28,41,16,33,92,210,不合格
20190410,45,33,55,58,65,256,不合格
20190411,68,62,3,35,4,172,不合格
20190412,57,62,2,42,98,261,不合格
20190413,26,79,19,88,0,212,不合格
20190414,42,95,73,93,83,386,合格
20190415,69,25,57,77,11,239,不合格
20190416,68,98,23,73,12,274,不合格
20190417,26,40,43,5,98,212,不合格
20190418,30,53,24,10,54,171,不合格
20190419,95,11,92,11,59,268,不合格
20190420,19,5,28,54,82,188,不合格
20190421,19,62,77,11,16,185,不合格
20190422,66,58,30,24,20,198,不合格
20190423,92,49,14,0,44,199,不合格
20190424,53,34,69,9,46,211,不合格
20190425,52,26,52,22,53,205,不合格
20190426,28,61,12,24,23,148,不合格
20190427,85,76,79,9,89,338,合格
20190428,12,85,15,92,40,244,不合格
20190429,12,13,13,87,88,213,不合格
20190430,37,59,18,42,22,178,不合格
20190431,57,28,1,93,15,194,不合格
20190432,49,56,16,98,34,253,不合格
20190433,45,56,98,57,42,298,不合格
20190434,51,38,69,37,98,293,不合格
20190435,76,38,59,50,38,261,不合格
20190436,71,2,6,19,74,172,不合格
20190437,97,66,24,88,93,368,合格
20190438,8,26,42,8,5,89,不合格
20190439,91,52,4,23,23,193,不合格
20190440,4,69,82,40,11,206,不合格
20190441,46,40,37,94,56,273,不合格
20190442,59,2,75,14,56,206,不合格
20190443,11,16,81,30,48,186,不合格
20190444,94,29,51,48,35,257,不合格
20190445,35,26,67,98,49,275,不合格
20190446,81,73,88,20,75,337,合格
20190447,92,67,11,35,77,282,不合格
20190448,63,11,76,94,11,255,不合格
20190449,47,52,31,76,65,271,不合格
20190450,54,59,5,58,61,237,不合格
20190451,45,32,79,1,80,237,不合格
20190452,0,77,32,73,20,202,不合格
20190453,96,70,79,87,27,359,合格
20190454,71,70,27,1,0,169,不合格
20190455,32,85,98,61,31,307,合格
20190456,71,96,55,0,62,284,不合格
20190457,30,25,83,42,37,217,不合格
20190458,41,72,72,27,37,249,不合格
20190459,96,86,92,68,74,416,合格
20190460,40,78,15,44,59,236,不合格
20190461,73,17,8,7,7,112,不合格
20190462,88,87,16,51,52,294,不合格
20190463,90,46,71,8,25,240,不合格
20190464,1,87,87,56,70,301,合格
20190465,42,82,49,2,59,234,不合格
20190466,66,98,37,59,43,303,合格
20190467,59,53,44,81,19,256,不合格
20190468,37,82,94,68,2,283,不合格
20190469,75,54,68,84,56,337,合格
20190470,57,26,16,62,13,174,不合格
20190471,59,59,85,83,64,350,合格
20190472,79,6,2,82,39,208,不合格
20190473,44,19,90,80,88,321,合格
20190474,38,73,99,90,27,327,合格
20190475,10,71,54,48,47,230,不合格
20190476,85,9,70,51,47,262,不合格
20190477,61,30,11,32,55,189,不合格
20190478,11,24,62,83,6,186,不合格
20190479,97,6,0,20,63,186,不合格
20190480,25,6,81,27,79,218,不合格
20190481,1,41,84,51,96,273,不合格
20190482,17,88,68,88,38,299,不合格
20190483,63,37,39,34,90,263,不合格
20190484,25,45,80,69,72,291,不合格
20190485,57,55,10,98,0,220,不合格
20190486,24,21,71,71,59,246,不合格
20190487,10,0,39,41,95,185,不合格
20190488,10,82,26,3,78,199,不合格
20190489,36,48,51,5,99,239,不合格
20190490,45,0,24,73,45,187,不合格
20190491,54,75,34,13,35,211,不合格
20190492,30,87,75,90,79,361,合格
20190493,53,5,68,52,28,206,不合格
20190494,60,68,17,21,61,227,不合格
20190495,95,24,47,14,88,268,不合格
20190496,52,61,29,10,40,192,不合格
20190497,12,82,9,90,62,255,不合格
20190498,11,38,35,10,92,186,不合格
20190499,28,82,32,24,13,179,不合格
20190500,87,9,12,66,87,261,不合格
20190501,52,74,36,26,30,218,不合格
20190502,28,17,22,45,35,147,不合格
20190503,72,53,53,23,90,291,不合格
20190504,94,56,74,86,59,369,合格
20190505,99,29,76,93,5,302,合格
20190506,80,72,58,17,1,228,不合格
20190507,67,90,17,58,36,268,不合格
20190508,67,66,67,35,49,284,不合格
20190509,22,94,51,28,23,218,不合格
20190510,56,93,16,34,53,252,不合格
20190511,82,6,15,98,83,284,不合格
20190512,13,20,30,30,26,119,不合格
20190513,14,58,61,15,4,152,不合格
20190514,50,46,24,27,96,243,不合格
20190515,72,64,36,14,9,195,不合格
20190516,20,59,84,47,17,227,不合格
20190517,26,62,33,96,29,246,不合格
20190518,50,81,85,76,48,340,合格
20190519,4,96,74,38,8,220,不合格
20190520,29,68,89,87,75,348,合格
20190521,70,59,20,29,71,249,不合格
20190522,72,91,34,44,21,262,不合格
20190523,14,71,45,4,7,141,不合格
20190524,37,65,19,69,0,190,不合格
20190525,49,69,81,15,59,273,不合格
20190526,85,85,40,1,10,221,不合格
20190527,52,90,84,60,12,298,不合格
20190528,39,25,80,34,92,270,不合格
20190529,48,53,91,88,89,369,合格
20190530,81,28,27,44,74,254,不合格
20190531,52,99,93,61,64,369,合格
20190532,63,91,36,69,55,314,合格
20190533,27,13,3,89,14,146,不合格
20190534,46,12,57,83,88,286,不合格
20190535,2,18,80,46,43,189,不合格
20190536,21,49,28,81,5,184,不合格
20190537,99,49,24,35,79,286,不合格
20190538,71,91,10,23,85,280,不合格
20190539,91,0,14,88,71,264,不合格
20190540,56,59,63,24,11,213,不合格
20190541,73,38,11,72,27,221,不合格
20190542,87,96,93,21,59,356,合格
20190543,44,43,19,26,14,146,不合格
20190544,47,73,16,36,80,252,不合格
20190545,96,86,50,9,25,266,不合格
20190546,80,67,27,81,93,348,合格
20190547,41,90,90,99,7,327,合格
20190548,4,12,50,26,26,118,不合格
20190549,19,43,91,53,86,292,不合格
20190550,31,38,75,4,0,148,不合格
20190551,17,97,44,30,5,193,不合格
20190552,85,84,47,3,52,271,不合格
20190553,54,39,16,59,77,245,不合格
20190554,35,39,5,85,0,164,不合格
20190555,52,37,91,59,26,265,不合格
20190556,11,50,88,64,19,232,不合格
20190557,40,94,89,61,96,380,合格
20190558,6,81,63,64,2,216,不合格
20190559,84,54,96,39,97,370,合格
20190560,18,30,93,22,79,242,不合格
20190561,24,92,69,9,22,216,不合格
20190562,62,3,72,45,68,250,不合格
20190563,8,42,38,59,88,235,不合格
20190564,55,94,8,6,10,173,不合格
20190565,14,74,69,4,35,196,不合格
20190566,37,48,48,65,79,277,不合格
20190567,99,9,3,27,52,190,不合格
20190568,49,11,39,39,7,145,不合格
20190569,30,54,44,66,88,282,不合格
20190570,21,52,24,53,43,193,不合格
20190571,41,99,47,28,13,228,不合格
20190572,7,10,51,4,39,111,不合格
20190573,36,58,28,33,63,218,不合格
20190574,78,36,78,15,77,284,不合格
20190575,83,69,58,95,84,389,合格
20190576,57,28,0,10,69,164,不合格
20190577,39,76,40,58,21,234,不合格
20190578,11,70,41,48,52,222,不合格
20190579,64,31,63,8,95,261,不合格
20190580,75,31,34,54,20,214,不合格
20190581,26,42,4,81,92,245,不合格
20190582,56,40,35,18,75,224,不合格
20190583,37,20,15,31,47,150,不合格
20190584,2,81,2,88,6,179,不合格
20190585,83,13,82,63,63,304,合格
20190586,29,60,12,88,38,227,不合格
20190587,70,59,25,93,71,318,合格
20190588,95,71,32,53,32,283,不合格
20190589,65,78,70,5,12,230,不合格
20190590,30,47,58,82,86,303,合格
20190591,32,1,24,66,49,172,不合格
20190592,32,22,8,26,8,96,不合格
20190593,72,68,73,84,7,304,合格
20190594,11,56,29,97,6,199,不合格
20190595,14,46,98,97,9,264,不合格
20190596,74,49,90,61,29,303,合格
20190597,48,35,35,46,27,191,不合格
20190598,26,82,79,49,28,264,不合格
20190599,11,39,58,38,41,187,不合格
20190600,85,2,49,3,77,216,不合格
20190601,73,24,69,25,51,242,不合格
20190602,98,62,24,95,52,331,合格
20190603,97,11,75,18,63,264,不合格
20190604,75,51,2,7,81,216,不合格
20190605,67,78,5,1,17,168,不合格
20190606,88,55,18,17,79,257,不合格
20190607,3,45,23,18,11,100,不合格
20190608,54,23,94,53,45,269,不合格
20190609,18,86,33,37,58,232,不合格
20190610,2,74,60,38,13,187,不合格
20190611,66,82,20,36,88,292,不合格
20190612,23,9,46,17,68,163,不合格
20190613,59,87,95,87,53,381,合格
20190614,98,57,26,47,79,307,合格
20190615,74,22,50,86,8,240,不合格
20190616,95,86,60,18,29,288,不合格
20190617,0,69,41,28,83,221,不合格
20190618,55,89,27,80,31,282,不合格
20190619,66,14,4,97,65,246,不合格
20190620,59,55,84,63,88,349,合格
20190621,27,90,20,63,78,278,不合格
20190622,79,75,86,33,89,362,合格
20190623,76,20,95,95,5,291,不合格
20190624,46,84,41,20,90,281,不合格
20190625,9,34,45,0,7,95,不合格
20190626,96,72,61,90,72,391,合格
20190627,99,57,92,40,5,293,不合格
20190628,39,56,93,72,66,326,合格
20190629,9,48,22,61,30,170,不合格
20190630,73,97,74,77,87,408,合格
20190631,43,42,40,97,78,300,合格
20190632,32,84,50,68,54,288,不合格
20190633,28,34,81,22,71,236,不合格
20190634,74,53,10,92,72,301,合格
20190635,59,5,87,48,82,281,不合格
20190636,11,80,7,29,57,184,不合格
20190637,71,92,52,80,92,387,合格
20190638,65,70,30,32,74,271,不合格
20190639,77,80,39,73,97,366,合格
20190640,20,51,47,20,20,158,不合格
20190641,90,33,88,99,16,326,合格
20190642,48,63,1,54,38,204,不合格
20190643,79,27,70,65,70,311,合格
20190644,40,41,13,36,47,177,不合格
20190645,43,23,99,2,14,181,不合格
20190646,78,40,20,77,21,236,不合格
20190647,82,29,63,89,95,358,合格
20190648,97,85,13,64,0,259,不合格
20190649,83,5,5,32,68,193,不合格
20190650,46,90,9,57,6,208,不合格
20190651,72,14,76,61,59,282,不合格
20190652,53,96,36,65,74,324,合格
20190653,88,22,31,39,81,261,不合格
20190654,4,55,22,11,16,108,不合格
20190655,92,48,25,79,44,288,不合格
20190656,31,32,42,10,19,134,不合格
20190657,51,24,49,0,46,170,不合格
20190658,65,58,71,72,46,312,合格
20190659,13,71,1,53,15,153,不合格
20190660,94,82,78,56,91,401,合格
20190661,62,38,4,60,79,243,不合格
20190662,19,59,96,28,59,261,不合格
20190663,46,24,58,16,84,228,不合格
20190664,86,46,40,86,91,349,合格
20190665,83,8,93,9,9,202,不合格
20190666,75,64,22,79,29,269,不合格
20190667,40,48,15,50,7,160,不合格
20190668,20,86,6,67,52,231,不合格
20190669,89,69,78,43,46,325,合格
20190670,16,16,1,97,0,130,不合格
20190671,93,75,67,67,63,365,合格
20190672,24,80,32,35,61,232,不合格
20190673,19,70,55,33,38,215,不合格
20190674,16,27,62,21,3,129,不合格
20190675,56,51,19,79,9,214,不合格
20190676,48,86,34,24,26,218,不合格
20190677,43,51,19,35,13,161,不合格
20190678,50,0,87,69,61,267,不合格
20190679,3,15,83,13,46,160,不合格
20190680,35,47,57,41,52,232,不合格
20190681,21,64,98,44,58,285,不合格
20190682,68,11,65,62,68,274,不合格
20190683,31,25,78,35,50,219,不合格
20190684,75,93,97,89,47,401,合格
20190685,29,37,49,7,22,144,不合格
20190686,41,14,44,59,30,188,不合格
20190687,88,4,90,3,48,233,不合格
20190688,16,77,98,18,66,275,不合格
20190689,66,50,74,89,96,375,合格
20190690,89,64,20,59,61,293,不合格
20190691,11,29,56,78,10,184,不合格
20190692,99,60,1,73,41,274,不合格
20190693,86,79,28,29,60,282,不合格
20190694,62,62,29,25,88,266,不合格
20190695,20,72,30,21,93,236,不合格
20190696,78,2,28,44,96,248,不合格
20190697,49,96,70,84,63,362,合格
20190698,48,51,94,43,72,308,合格
20190699,14,26,19,7,97,163,不合格
20190700,95,70,15,52,53,285,不合格
20190701,36,24,46,92,69,267,不合格
20190702,48,66,83,47,91,335,合格
20190703,70,62,8,77,68,285,不合格
20190704,76,26,87,60,96,345,合格
20190705,36,43,15,48,15,157,不合格
20190706,13,91,52,35,94,285,不合格
20190707,30,71,17,10,2,130,不合格
20190708,56,44,93,34,35,262,不合格
20190709,68,49,13,41,48,219,不合格
20190710,28,95,62,49,56,290,不合格
20190711,42,34,77,85,95,333,合格
20190712,37,36,79,61,98,311,合格
20190713,74,52,89,22,9,246,不合格
20190714,38,49,1,60,49,197,不合格
20190715,92,15,70,63,78,318,合格
20190716,79,31,46,50,0,206,不合格
20190717,95,24,63,42,66,290,不合格
20190718,58,2,80,57,26,223,不合格
20190719,24,90,21,90,49,274,不合格
20190720,36,78,0,10,72,196,不合格
20190721,75,46,0,39,99,259,不合格
20190722,95,52,21,34,79,281,不合格
20190723,34,69,7,6,34,150,不合格
20190724,53,2,18,27,14,114,不合格
20190725,65,49,23,41,60,238,不合格
20190726,92,2,21,14,52,181,不合格
20190727,62,10,14,16,69,171,不合格
20190728,75,43,85,34,98,335,合格
20190729,95,81,40,34,60,310,合格
20190730,92,72,54,27,86,331,合格
20190731,92,7,71,43,57,270,不合格
20190732,19,12,37,97,82,247,不合格
20190733,11,91,12,16,79,209,不合格
20190734,70,93,49,76,77,365,合格
20190735,53,90,27,48,52,270,不合格
20190736,74,75,61,0,33,243,不合格
20190737,49,17,3,97,52,218,不合格
20190738,69,97,57,97,13,333,合格
20190739,64,45,48,91,69,317,合格
20190740,66,86,2,12,79,245,不合格
20190741,1,12,50,52,96,211,不合格
20190742,63,88,16,71,2,240,不合格
20190743,31,70,82,38,57,278,不合格
20190744,6,63,80,35,10,194,不合格
20190745,93,38,21,1,55,208,不合格
20190746,77,19,15,75,10,196,不合格
20190747,55,5,74,91,65,290,不合格
20190748,45,97,91,77,87,397,合格
20190749,0,70,72,85,54,281,不合格
20190750,87,18,23,35,23,186,不合格
20190751,55,73,71,32,77,308,合格
20190752,72,1,94,67,95,329,合格
20190753,42,17,86,3,46,194,不合格
20190754,79,94,14,86,52,325,合格
20190755,2,19,58,96,84,259,不合格
20190756,77,43,24,2,50,196,不合格
20190757,92,49,75,71,17,304,合格
20190758,44,44,70,43,31,232,不合格
20190759,1,89,73,9,26,198,不合格
20190760,21,1,6,77,75,180,不合格
20190761,56,31,77,25,91,280,不合格
20190762,74,41,19,69,96,299,不合格
20190763,62,43,44,97,33,279,不合格
20190764,78,62,71,87,13,311,合格
20190765,46,29,2,28,74,179,不合格
20190766,70,4,25,78,12,189,不合格
20190767,4,70,37,60,97,268,不合格
20190768,54,88,46,34,13,235,不合格
20190769,18,54,10,92,14,188,不合格
20190770,39,74,91,14,11,229,不合格
20190771,40,62,20,86,12,220,不合格
20190772,21,82,97,60,20,280,不合格
20190773,93,88,78,72,12,343,合格
20190774,38,6,93,80,29,246,不合格
20190775,34,29,59,44,74,240,不合格
20190776,85,92,71,62,53,363,合格
20190777,89,47,98,26,34,294,不合格
20190778,97,26,73,5,16,217,不合格
20190779,99,21,66,26,10,222,不合格
20190780,9,92,93,38,8,240,不合格
20190781,16,43,11,90,7,167,不合格
20190782,69,29,0,58,30,186,不合格
20190783,3,39,55,81,70,248,不合格
20190784,35,98,60,91,90,374,合格
20190785,61,61,59,33,92,306,合格
20190786,43,58,6,46,37,190,不合格
20190787,24,9,97,37,9,176,不合格
20190788,15,69,41,90,82,297,不合格
20190789,22,76,67,91,5,261,不合格
20190790,72,10,99,74,90,345,合格
20190791,47,75,87,77,93,379,合格
20190792,51,29,2,84,59,225,不合格
20190793,25,6,72,17,15,135,不合格
20190794,87,24,92,9,36,248,不合格
20190795,92,16,78,71,70,327,合格
20190796,23,48,55,15,15,156,不合格
20190797,25,46,57,0,55,183,不合格
20190798,84,38,19,32,95,268,不合格
20190799,90,18,94,9,85,296,不合格
20190800,88,77,65,76,53,359,合格
20190801,68,71,11,92,58,300,合格
20190802,80,39,7,60,21,207,不合格
20190803,0,61,16,13,2,92,不合格
20190804,82,91,15,78,4,270,不合格
20190805,67,89,14,70,57,297,不合格
20190806,27,47,24,41,49,188,不合格
20190807,48,71,53,25,19,216,不合格
20190808,12,77,80,16,48,233,不合格
20190809,21,34,51,80,99,285,不合格
20190810,52,96,87,17,65,317,合格
20190811,46,48,37,41,12,184,不合格
20190812,83,86,53,83,49,354,合格
20190813,44,75,13,52,25,209,不合格
20190814,44,33,75,4,32,188,不合格
20190815,36,43,44,61,30,214,不合格
20190816,68,63,91,82,32,336,合格
20190817,1,98,24,15,40,178,不合格
20190818,53,75,82,19,39,268,不合格
20190819,17,76,60,40,40,233,不合格
20190820,4,36,70,76,23,209,不合格
20190821,91,54,38,53,9,245,不合格
20190822,77,72,63,98,34,344,合格
20190823,84,46,94,57,35,316,合格
20190824,82,5,47,23,63,220,不合格
20190825,14,22,38,26,17,117,不合格
20190826,48,59,23,91,25,246,不合格
20190827,6,32,4,14,59,115,不合格
20190828,72,17,75,42,35,241,不合格
20190829,81,9,47,19,15,171,不合格
20190830,29,44,5,52,6,136,不合格
20190831,70,98,9,0,70,247,不合格
20190832,93,89,60,53,88,383,合格
20190833,30,54,61,19,53,217,不合格
20190834,50,5,13,24,31,123,不合格
20190835,44,24,45,93,83,289,不合格
20190836,66,22,47,46,85,266,不合格
20190837,17,95,55,43,46,256,不合格
20190838,33,58,53,53,64,261,不合格
20190839,43,99,72,70,69,353,合格
20190840,64,45,88,98,9,304,合格
20190841,0,8,91,42,94,235,不合格
20190842,61,61,70,63,4,259,不合格
20190843,5,37,84,6,23,155,不合格
20190844,10,67,31,32,74,214,不合格
20190845,78,88,32,97,36,331,合格
20190846,94,4,19,93,27,237,不合格
20190847,3,75,8,80,12,178,不合格
20190848,62,42,3,38,55,200,不合格
20190849,53,10,70,86,67,286,不合格
20190850,59,20,40,44,44,207,不合格
20190851,46,33,31,92,50,252,不合格
20190852,94,48,47,60,54,303,合格
20190853,42,84,16,3,17,162,不合格
20190854,0,14,21,32,20,87,不合格
20190855,47,78,28,24,66,243,不合格
20190856,6,53,61,64,4,188,不合格
20190857,98,4,12,64,92,270,不合格
20190858,36,50,83,79,86,334,合格
20190859,37,44,22,12,8,123,不合格
20190860,47,18,79,88,20,252,不合格
20190861,42,79,16,72,76,285,不合格
20190862,52,52,59,90,62,315,合格
20190863,54,90,88,14,75,321,合格
20190864,70,55,43,74,18,260,不合格
20190865,28,94,14,5,34,175,不合格
20190866,75,71,76,48,52,322,合格
20190867,91,64,3,74,71,303,合格
20190868,39,92,88,36,42,297,不合格
20190869,53,20,31,55,46,205,不合格
20190870,24,42,41,71,19,197,不合格
20190871,45,96,29,88,18,276,不合格
20190872,3,64,23,67,92,249,不合格
20190873,40,4,36,9,38,127,不合格
20190874,15,79,43,59,76,272,不合格
20190875,77,44,18,33,75,247,不合格
20190876,55,59,28,39,74,255,不合格
20190877,18,26,64,44,92,244,不合格
20190878,15,69,65,95,32,276,不合格
20190879,30,14,97,15,70,226,不合格
20190880,21,40,5,78,8,152,不合格
20190881,39,68,96,20,14,237,不合格
20190882,46,47,67,30,89,279,不合格
20190883,19,34,86,78,25,242,不合格
20190884,66,19,49,19,17,170,不合格
20190885,75,86,96,73,52,382,合格
20190886,74,76,22,16,32,220,不合格
20190887,35,43,75,34,26,213,不合格
20190888,91,28,73,27,31,250,不合格
20190889,79,87,33,77,2,278,不合格
20190890,73,8,33,67,85,266,不合格
20190891,69,57,2,61,28,217,不合格
20190892,58,38,21,66,61,244,不合格
20190893,59,2,36,44,89,230,不合格
20190894,38,82,17,60,4,201,不合格
20190895,9,15,54,49,41,168,不合格
20190896,99,76,52,86,19,332,合格
20190897,17,69,31,37,22,176,不合格
20190898,64,47,11,50,51,223,不合格
20190899,19,0,94,68,45,226,不合格
20190900,26,63,51,93,68,301,合格
20190901,96,32,48,73,47,296,不合格
20190902,94,5,16,50,84,249,不合格
20190903,51,87,36,2,58,234,不合格
20190904,8,27,78,29,72,214,不合格
20190905,46,19,71,53,17,206,不合格
20190906,5,6,17,50,44,122,不合格
20190907,83,31,47,18,9,188,不合格
20190908,1,18,0,99,65,183,不合格
20190909,89,73,55,86,31,334,合格
20190910,30,75,82,96,12,295,不合格
20190911,64,31,11,54,97,257,不合格
20190912,79,94,32,68,84,357,合格
20190913,24,84,64,38,37,247,不合格
20190914,56,54,57,5,90,262,不合格
20190915,27,64,29,87,47,254,不合格
20190916,15,37,73,31,10,166,不合格
20190917,26,12,27,95,7,167,不合格
20190918,38,0,10,68,9,125,不合格
20190919,19,83,64,93,61,320,合格
20190920,68,45,4,77,52,246,不合格
20190921,98,8,95,69,42,312,合格
20190922,71,31,13,51,60,226,不合格
20190923,54,98,87,10,30,279,不合格
20190924,47,33,99,67,76,322,合格
20190925,8,43,10,77,27,165,不合格
20190926,43,87,95,38,53,316,合格
20190927,72,92,37,37,55,293,不合格
20190928,34,92,39,34,42,241,不合格
20190929,87,25,6,36,55,209,不合格
20190930,34,62,15,45,16,172,不合格
20190931,34,45,40,39,76,234,不合格
20190932,7,68,32,15,25,147,不合格
20190933,28,60,88,88,31,295,不合格
20190934,85,89,99,47,54,374,合格
20190935,89,41,32,19,92,273,不合格
20190936,61,57,3,46,53,220,不合格
20190937,60,40,70,53,22,245,不合格
20190938,23,92,38,86,37,276,不合格
20190939,9,47,44,55,74,229,不合格
20190940,94,24,62,79,88,347,合格
20190941,65,56,18,85,8,232,不合格
20190942,60,87,34,77,78,336,合格
20190943,6,90,47,65,12,220,不合格
20190944,50,14,37,91,99,291,不合格
20190945,91,49,70,66,43,319,合格
20190946,86,22,94,38,65,305,合格
20190947,93,54,98,0,41,286,不合格
20190948,72,93,58,20,43,286,不合格
20190949,54,34,71,82,63,304,合格
20190950,11,62,36,79,89,277,不合格
20190951,4,52,72,12,79,219,不合格
20190952,61,33,9,24,48,175,不合格
20190953,77,1,1,84,44,207,不合格
20190954,13,83,94,99,49,338,合格
20190955,62,11,35,89,88,285,不合格
20190956,84,40,31,8,54,217,不合格
20190957,30,13,27,62,23,155,不合格
20190958,85,65,97,93,23,363,合格
20190959,88,81,64,91,94,418,合格
20190960,53,33,77,17,11,191,不合格
20190961,68,61,62,38,23,252,不合格
20190962,58,78,24,44,76,280,不合格
20190963,77,82,63,82,9,313,合格
20190964,1,33,64,11,46,155,不合格
20190965,22,48,63,59,19,211,不合格
20190966,23,62,26,14,24,149,不合格
20190967,69,50,19,50,55,243,不合格
20190968,17,86,29,68,0,200,不合格
20190969,17,7,76,99,22,221,不合格
20190970,30,79,2,55,87,253,不合格
20190971,52,64,28,7,31,182,不合格
20190972,65,0,44,48,40,197,不合格
20190973,22,1,25,57,19,124,不合格
20190974,62,50,19,79,37,247,不合格
20190975,13,16,11,10,9,59,不合格
20190976,42,45,97,30,24,238,不合格
20190977,67,49,93,5,44,258,不合格
20190978,82,6,28,97,96,309,合格
20190979,78,14,10,41,98,241,不合格
20190980,29,1,76,29,11,146,不合格
20190981,27,93,54,3,67,244,不合格
20190982,50,12,4,32,98,196,不合格
20190983,84,42,25,85,64,300,合格
20190984,82,97,89,52,5,325,合格
20190985,12,13,63,69,98,255,不合格
20190986,51,31,11,81,49,223,不合格
20190987,15,30,60,16,34,155,不合格
20190988,41,94,16,14,82,247,不合格
20190989,35,19,84,96,24,258,不合格
20190990,38,82,1,26,4,151,不合格
20190991,92,66,50,86,39,333,合格
20190992,91,19,62,22,90,284,不合格
20190993,64,87,94,63,45,353,合格
20190994,3,86,69,93,84,335,合格
20190995,59,7,10,37,87,200,不合格
20190996,29,22,75,35,53,214,不合格
20190997,3,48,65,13,21,150,不合格
20190998,32,20,1,69,56,178,不合格
20190999,24,28,2,36,25,115,不合格
20191000,46,67,17,28,51,209,不合格
20191001,51,76,1,29,66,223,不合格
20191002,52,69,6,94,8,229,不合格
20191003,93,44,66,65,98,366,合格
20191004,27,0,86,33,63,209,不合格
20191005,44,42,22,5,95,208,不合格
20191006,66,47,99,13,99,324,合格
20191007,42,89,80,14,90,315,合格
20191008,31,96,5,93,21,246,不合格
20191009,21,87,38,57,83,286,不合格
20191010,97,3,4,92,25,221,不合格
20191011,45,12,42,48,85,232,不合格
20191012,71,53,16,71,49,260,不合格
20191013,40,25,64,95,66,290,不合格
20191014,80,30,13,80,41,244,不合格
20191015,68,20,96,68,55,307,合格
20191016,69,92,84,70,18,333,合格
20191017,48,54,6,46,30,184,不合格
20191018,22,79,3,0,57,161,不合格
20191019,83,36,9,87,43,258,不合格
20191020,5,95,67,64,4,235,不合格
20191021,60,33,56,50,30,229,不合格
20191022,58,51,77,83,79,348,合格
20191023,24,19,17,46,58,164,不合格
20191024,14,13,12,47,19,105,不合格
20191025,51,34,42,18,66,211,不合格
20191026,5,31,42,17,80,175,不合格
20191027,40,14,24,25,25,128,不合格
20191028,8,0,5,77,30,120,不合格
20191029,14,97,98,91,33,333,合格
20191030,91,70,11,13,17,202,不合格
20191031,70,28,94,25,37,254,不合格
20191032,83,68,50,73,33,307,合格
20191033,32,13,15,90,21,171,不合格
20191034,40,4,24,84,85,237,不合格
20191035,70,48,70,24,79,291,不合格
20191036,29,32,84,7,75,227,不合格
20191037,99,64,11,45,28,247,不合格
20191038,25,14,31,92,33,195,不合格
20191039,5,24,26,93,69,217,不合格
20191040,39,79,50,27,66,261,不合格
20191041,34,91,54,67,75,321,合格
20191042,23,78,98,87,22,308,合格
20191043,96,67,92,85,86,426,合格
20191044,9,83,94,20,51,257,不合格
20191045,98,58,15,62,65,298,不合格
20191046,50,6,66,52,57,231,不合格
20191047,87,71,51,61,97,367,合格
20191048,23,75,12,28,10,148,不合格
20191049,75,72,84,91,38,360,合格
20191050,60,34,6,43,16,159,不合格
20191051,76,89,97,6,77,345,合格
20191052,77,4,55,27,43,206,不合格
20191053,2,90,77,64,8,241,不合格
20191054,60,4,58,72,40,234,不合格
20191055,68,95,14,71,14,262,不合格
20191056,52,7,43,43,76,221,不合格
20191057,81,29,59,3,78,250,不合格
20191058,7,74,22,92,1,196,不合格
20191059,82,9,31,18,32,172,不合格
20191060,35,37,71,64,84,291,不合格
20191061,61,83,2,81,52,279,不合格
20191062,19,22,75,16,31,163,不合格
20191063,28,50,76,40,87,281,不合格
20191064,86,11,13,53,23,186,不合格
20191065,68,65,65,38,73,309,合格
20191066,12,78,54,68,85,297,不合格
20191067,3,72,87,75,17,254,不合格
20191068,68,67,36,77,57,305,合格
20191069,62,79,73,10,65,289,不合格
20191070,98,23,33,3,35,192,不合格
20191071,20,64,42,26,43,195,不合格
20191072,70,22,95,81,40,308,合格
20191073,39,88,11,93,58,289,不合格
20191074,47,28,13,12,1,101,不合格
20191075,22,76,12,50,40,200,不合格
20191076,51,65,28,82,85,311,合格
20191077,98,72,57,79,83,389,合格
20191078,17,65,15,1,6,104,不合格
20191079,12,1,88,12,57,170,不合格
20191080,39,32,34,57,72,234,不合格
20191081,27,4,41,58,17,147,不合格
20191082,24,48,76,50,95,293,不合格
20191083,8,97,36,14,80,235,不合格
20191084,56,10,53,89,75,283,不合格
20191085,94,77,18,27,72,288,不合格
20191086,14,79,3,78,33,207,不合格
20191087,57,54,64,50,65,290,不合格
20191088,73,54,13,65,12,217,不合格
20191089,98,26,53,79,1,257,不合格
20191090,95,39,43,12,37,226,不合格
20191091,85,35,38,17,17,192,不合格
20191092,66,75,59,83,31,314,合格
20191093,9,21,42,90,79,241,不合格
20191094,91,89,64,7,34,285,不合格
20191095,43,73,14,7,22,159,不合格
20191096,35,89,45,10,43,222,不合格
20191097,76,10,36,94,40,256,不合格
20191098,17,25,71,53,10,176,不合格
20191099,68,76,66,76,3,289,不合格
20191100,90,36,19,15,18,178,不合格
20191101,40,50,19,67,57,233,不合格
20191102,70,91,80,75,87,403,合格
20191103,13,45,57,26,57,198,不合格
20191104,32,23,5,61,1,122,不合格
20191105,35,77,17,22,9,160,不合格
20191106,76,15,33,45,1,170,不合格
20191107,53,78,94,17,59,301,合格
20191108,44,15,19,22,5,105,不合格
20191109,79,84,52,79,3,297,不合格
20191110,32,0,41,43,77,193,不合格
20191111,49,68,1,11,64,193,不合格
20191112,83,74,42,29,53,281,不合格
20191113,54,99,56,58,56,323,合格
20191114,87,13,3,20,37,160,不合格
20191115,5,36,76,71,4,192,不合格
20191116,39,3,68,36,41,187,不合格
20191117,45,69,99,23,71,307,合格
20191118,24,37,96,25,56,238,不合格
20191119,7,49,25,74,44,199,不合格
20191120,38,24,25,47,19,153,不合格
20191121,2,86,8,2,58,156,不合格
20191122,37,20,72,53,91,273,不合格
20191123,69,28,72,30,98,297,不合格
20191124,14,49,10,24,27,124,不合格
20191125,89,3,83,54,95,324,合格
20191126,14,64,31,37,61,207,不合格
20191127,0,7,34,1,39,81,不合格
20191128,82,51,12,44,5,194,不合格
20191129,40,50,76,16,71,253,不合格
20191130,61,44,37,83,73,298,不合格
20191131,18,72,21,34,43,188,不合格
20191132,82,20,35,62,56,255,不合格
20191133,44,49,98,97,58,346,合格
20191134,98,99,77,23,9,306,合格
20191135,69,46,89,31,16,251,不合格
20191136,6,27,68,37,44,182,不合格
20191137,86,0,67,26,31,210,不合格
20191138,13,37,9,6,35,100,不合格
20191139,20,7,1,85,13,126,不合格
20191140,34,41,18,0,52,145,不合格
20191141,93,7,47,71,72,290,不合格
20191142,5,72,9,58,61,205,不合格
20191143,32,78,66,58,71,305,合格
20191144,4,65,11,68,10,158,不合格
20191145,14,87,61,74,37,273,不合格
20191146,77,81,31,66,45,300,合格
20191147,36,46,3,18,28,131,不合格
20191148,20,24,87,78,11,220,不合格
20191149,52,94,89,94,65,394,合格
20191150,89,77,40,81,25,312,合格
20191151,20,70,46,6,79,221,不合格
20191152,97,70,31,83,19,300,合格
20191153,18,80,35,49,45,227,不合格
20191154,20,89,62,30,49,250,不合格
20191155,55,7,32,33,94,221,不合格
20191156,97,87,31,60,2,277,不合格
20191157,83,40,80,47,4,254,不合格
20191158,90,22,67,62,47,288,不合格
20191159,42,55,74,97,84,352,合格
20191160,83,85,52,79,90,389,合格
20191161,73,52,29,7,86,247,不合格
20191162,0,76,93,48,57,274,不合格
20191163,31,87,26,8,55,207,不合格
20191164,81,85,91,93,39,389,合格
20191165,29,58,90,50,90,317,合格
20191166,75,11,87,60,11,244,不合格
20191167,81,60,28,7,56,232,不合格
20191168,61,96,48,57,42,304,合格
20191169,81,31,59,27,78,276,不合格
20191170,29,53,73,18,9,182,不合格
20191171,89,78,97,68,76,408,合格
20191172,28,65,58,40,90,281,不合格
20191173,3,39,66,27,84,219,不合格
20191174,47,22,89,77,43,278,不合格
20191175,69,49,81,50,49,298,不合格
20191176,55,12,28,90,79,264,不合格
20191177,22,29,36,4,89,180,不合格
20191178,94,9,37,55,8,203,不合格
20191179,32,90,58,68,70,318,合格
20191180,24,52,49,90,35,250,不合格
20191181,97,55,28,51,98,329,合格
20191182,74,82,45,58,70,329,合格
20191183,48,62,97,31,80,318,合格
20191184,9,30,96,95,67,297,不合格
20191185,69,71,23,79,25,267,不合格
20191186,29,37,71,38,76,251,不合格
20191187,22,35,27,78,39,201,不合格
20191188,16,28,31,71,11,157,不合格
20191189,55,16,83,79,20,253,不合格
20191190,82,41,15,38,4,180,不合格
20191191,64,9,56,21,92,242,不合格
20191192,29,60,4,9,98,200,不合格
20191193,33,71,45,8,62,219,不合格
20191194,37,95,30,57,43,262,不合格
20191195,90,17,74,45,79,305,合格
20191196,3,3,49,13,77,145,不合格
20191197,82,93,57,22,33,287,不合格
20191198,8,2,49,92,52,203,不合格
20191199,32,66,19,44,33,194,不合格
20191200,54,96,2,8,21,181,不合格
20191201,17,64,10,85,83,259,不合格
20191202,44,70,85,56,23,278,不合格
20191203,82,44,17,83,99,325,合格
20191204,12,73,45,14,71,215,不合格
20191205,33,0,32,10,12,87,不合格
20191206,58,4,35,41,39,177,不合格
20191207,95,92,67,20,74,348,合格
20191208,9,93,27,83,32,244,不合格
20191209,8,65,4,17,94,188,不合格
20191210,7,60,71,72,63,273,不合格
20191211,87,64,48,97,69,365,合格
20191212,93,73,96,31,69,362,合格
20191213,41,49,84,8,68,250,不合格
20191214,80,41,65,14,66,266,不合格
20191215,65,31,12,24,97,229,不合格
20191216,18,35,55,26,47,181,不合格
20191217,42,96,11,35,79,263,不合格
20191218,59,65,61,44,20,249,不合格
20191219,22,48,96,71,75,312,合格
20191220,97,30,23,68,61,279,不合格
20191221,44,36,88,15,45,228,不合格
20191222,70,18,70,75,32,265,不合格
20191223,71,44,1,49,67,232,不合格
20191224,16,98,4,96,61,275,不合格
20191225,17,57,88,30,40,232,不合格
20191226,2,43,85,39,82,251,不合格
20191227,79,15,99,30,24,247,不合格
20191228,97,38,72,38,83,328,合格
20191229,88,23,45,55,2,213,不合格
20191230,36,78,90,40,24,268,不合格
20191231,27,60,98,85,46,316,合格
20191232,93,51,42,55,26,267,不合格
20191233,12,64,84,69,44,273,不合格
20191234,72,82,26,37,36,253,不合格
20191235,73,81,34,52,46,286,不合格
20191236,30,78,99,0,5,212,不合格
20191237,11,32,46,56,53,198,不合格
20191238,42,45,50,33,36,206,不合格
20191239,97,0,67,9,13,186,不合格
20191240,21,63,32,29,45,190,不合格
20191241,98,53,62,46,32,291,不合格
20191242,48,70,62,98,62,340,合格
20191243,83,63,83,88,43,360,合格
20191244,45,47,20,44,27,183,不合格
20191245,0,31,22,63,26,142,不合格
20191246,6,5,86,67,0,164,不合格
20191247,71,43,97,74,12,297,不合格
20191248,86,69,75,24,59,313,合格
20191249,35,21,57,47,52,212,不合格
20191250,11,21,63,95,2,192,不合格
20191251,39,20,95,0,16,170,不合格
20191252,71,28,78,88,47,312,合格
20191253,15,75,40,54,48,232,不合格
20191254,97,58,11,8,90,264,不合格
20191255,35,44,72,27,94,272,不合格
20191256,50,23,20,93,18,204,不合格
20191257,70,66,61,47,59,303,合格
20191258,55,89,0,55,65,264,不合格
20191259,75,24,2,30,32,163,不合格
20191260,59,20,31,25,39,174,不合格
20191261,48,48,72,84,69,321,合格
20191262,53,30,68,55,78,284,不合格
20191263,13,15,52,30,43,153,不合格
20191264,21,89,62,58,22,252,不合格
20191265,40,10,34,19,10,113,不合格
20191266,85,91,37,11,62,286,不合格
20191267,52,92,41,85,50,320,合格
20191268,60,58,87,67,3,275,不合格
20191269,54,31,40,25,89,239,不合格
20191270,64,68,1,65,28,226,不合格
20191271,99,41,94,10,33,277,不合格
20191272,79,38,45,10,14,186,不合格
20191273,21,17,91,14,11,154,不合格
20191274,35,86,80,84,81,366,合格
20191275,54,48,32,99,80,313,合格
20191276,66,46,90,2,69,273,不合格
20191277,75,4,43,67,58,247,不合格
20191278,67,43,70,6,49,235,不合格
20191279,84,65,93,14,77,333,合格
20191280,77,60,49,2,89,277,不合格
20191281,13,64,86,91,36,290,不合格
20191282,20,64,91,63,61,299,不合格
20191283,11,95,10,53,19,188,不合格
20191284,3,40,64,27,17,151,不合格
20191285,43,39,58,98,34,272,不合格
20191286,57,36,29,90,78,290,不合格
20191287,30,18,24,56,51,179,不合格
20191288,41,45,94,89,30,299,不合格
20191289,90,80,83,69,76,398,合格
20191290,25,95,33,99,98,350,合格
20191291,46,54,80,60,9,249,不合格
20191292,32,13,30,92,74,241,不合格
20191293,70,53,68,68,24,283,不合格
20191294,55,37,60,98,97,347,合格
20191295,92,59,78,76,43,348,合格
20191296,67,61,83,14,90,315,合格
20191297,22,90,77,79,62,330,合格
20191298,37,79,7,11,30,164,不合格
20191299,3,64,73,1,61,202,不合格
20191300,78,89,51,1,30,249,不合格
20191301,22,66,88,9,67,252,不合格
20191302,78,71,13,60,21,243,不合格
20191303,41,61,35,57,0,194,不合格
20191304,69,41,8,60,48,226,不合格
20191305,76,39,37,83,17,252,不合格
20191306,38,43,18,49,18,166,不合格
20191307,86,54,38,93,20,291,不合格
20191308,53,63,3,84,66,269,不合格
20191309,65,75,32,48,60,280,不合格
20191310,68,88,86,6,63,311,合格
20191311,2,80,75,65,6,228,不合格
20191312,23,49,38,57,68,235,不合格
20191313,52,65,30,28,2,177,不合格
20191314,26,90,1,39,88,244,不合格
20191315,7,28,34,55,67,191,不合格
20191316,79,36,32,78,15,240,不合格
20191317,44,51,16,53,9,173,不合格
20191318,72,33,56,34,39,234,不合格
20191319,17,79,88,38,96,318,合格
20191320,81,22,50,51,98,302,合格
20191321,9,85,34,4,5,137,不合格
20191322,15,48,88,97,20,268,不合格
20191323,9,76,3,29,5,122,不合格
20191324,33,9,88,32,57,219,不合格
20191325,94,5,72,75,44,290,不合格
20191326,12,97,78,48,70,305,合格
20191327,86,8,44,9,58,205,不合格
20191328,63,93,25,16,23,220,不合格
20191329,71,49,11,3,96,230,不合格
20191330,46,63,74,30,85,298,不合格
20191331,0,49,57,3,21,130,不合格
20191332,50,17,71,51,19,208,不合格
20191333,9,63,4,79,10,165,不合格
20191334,1,3,67,90,24,185,不合格
20191335,41,14,32,89,41,217,不合格
20191336,72,26,75,35,38,246,不合格
20191337,99,98,25,67,56,345,合格
20191338,18,34,52,80,6,190,不合格
20191339,56,21,0,30,44,151,不合格
20191340,99,45,92,24,45,305,合格
20191341,32,1,52,24,52,161,不合格
20191342,12,68,52,76,17,225,不合格
20191343,10,8,70,83,50,221,不合格
20191344,46,61,30,49,27,213,不合格
20191345,30,76,90,24,25,245,不合格
20191346,96,14,52,81,73,316,合格
20191347,9,67,48,34,60,218,不合格
20191348,49,36,7,91,97,280,不合格
20191349,15,41,63,61,99,279,不合格
20191350,45,62,15,0,81,203,不合格
20191351,41,37,79,24,48,229,不合格
20191352,43,16,47,17,19,142,不合格
20191353,84,2,32,21,16,155,不合格
20191354,80,33,95,83,99,390,合格
20191355,61,2,63,33,99,258,不合格
20191356,67,44,39,21,78,249,不合格
20191357,37,4,78,24,75,218,不合格
20191358,43,51,12,7,12,125,不合格
20191359,63,14,28,72,39,216,不合格
20191360,83,59,88,19,6,255,不合格
20191361,36,12,11,18,85,162,不合格
20191362,52,39,71,53,77,292,不合格
20191363,87,49,73,21,34,264,不合格
20191364,66,1,34,58,21,180,不合格
20191365,9,37,76,59,6,187,不合格
20191366,24,56,67,71,59,277,不合格
20191367,31,18,93,93,45,280,不合格
20191368,57,94,42,18,36,247,不合格
20191369,77,52,52,15,5,201,不合格
20191370,73,86,81,52,14,306,合格
20191371,83,42,89,58,95,367,合格
20191372,23,92,80,83,57,335,合格
20191373,61,2,35,2,1,101,不合格
20191374,21,20,88,82,72,283,不合格
20191375,87,79,80,2,99,347,合格
20191376,91,45,71,16,96,319,合格
20191377,27,8,23,12,68,138,不合格
20191378,74,73,91,30,14,282,不合格
20191379,59,55,11,1,24,150,不合格
20191380,70,65,71,6,81,293,不合格
20191381,29,94,76,79,28,306,合格
20191382,95,34,25,43,20,217,不合格
20191383,6,79,73,70,94,322,合格
20191384,89,12,34,34,46,215,不合格
20191385,62,94,40,61,34,291,不合格
20191386,61,87,43,59,9,259,不合格
20191387,79,7,32,26,6,150,不合格
20191388,80,54,71,70,13,288,不合格
20191389,23,42,44,88,62,259,不合格
20191390,25,96,68,69,10,268,不合格
20191391,55,26,93,21,53,248,不合格
20191392,11,30,96,71,40,248,不合格
20191393,29,99,75,41,53,297,不合格
20191394,89,32,53,52,8,234,不合格
20191395,40,38,73,14,5,170,不合格
20191396,76,40,67,28,32,243,不合格
20191397,90,19,84,36,87,316,合格
20191398,45,48,12,2,28,135,不合格
20191399,52,78,56,44,21,251,不合格
20191400,9,29,69,20,31,158,不合格
20191401,70,28,18,47,89,252,不合格
20191402,55,88,95,97,5,340,合格
20191403,87,70,76,69,53,355,合格
20191404,60,95,17,36,38,246,不合格
20191405,99,38,90,25,36,288,不合格
20191406,97,51,62,42,21,273,不合格
20191407,26,23,98,14,91,252,不合格
20191408,42,70,42,69,19,242,不合格
20191409,54,42,14,80,84,274,不合格
20191410,19,40,13,50,51,173,不合格
20191411,38,84,70,98,31,321,合格
20191412,90,20,66,22,5,203,不合格
20191413,90,96,13,24,75,298,不合格
20191414,48,80,66,33,75,302,合格
20191415,63,2,97,27,12,201,不合格
20191416,82,45,81,11,69,288,不合格
20191417,43,34,65,41,27,210,不合格
20191418,35,40,68,81,11,235,不合格
20191419,60,17,31,82,13,203,不合格
20191420,79,41,42,78,69,309,合格
20191421,87,69,65,39,87,347,合格
20191422,24,81,11,14,82,212,不合格
20191423,35,32,24,14,50,155,不合格
20191424,76,76,32,61,32,277,不合格
20191425,96,44,7,47,97,291,不合格
20191426,81,1,60,82,67,291,不合格
20191427,93,54,81,43,75,346,合格
20191428,25,80,98,21,26,250,不合格
20191429,50,61,56,29,8,204,不合格
20191430,25,87,3,2,94,211,不合格
20191431,91,45,74,27,23,260,不合格
20191432,87,5,53,1,27,173,不合格
20191433,33,34,10,32,36,145,不合格
20191434,70,20,52,0,54,196,不合格
20191435,2,61,24,62,36,185,不合格
20191436,25,45,9,27,32,138,不合格
20191437,20,95,6,15,48,184,不合格
20191438,27,11,86,17,88,229,不合格
20191439,53,19,59,82,74,287,不合格
20191440,32,20,48,92,62,254,不合格
20191441,65,78,60,45,73,321,合格
20191442,23,40,43,84,86,276,不合格
20191443,47,9,74,19,83,232,不合格
20191444,31,94,71,24,22,242,不合格
20191445,58,96,85,27,96,362,合格
20191446,36,61,44,57,31,229,不合格
20191447,79,53,73,77,29,311,合格
20191448,61,5,45,5,60,176,不合格
20191449,77,46,77,69,17,286,不合格
20191450,3,5,10,15,27,60,不合格
20191451,26,95,10,96,52,279,不合格
20191452,16,65,44,70,38,233,不合格
20191453,40,87,55,94,52,328,合格
20191454,53,0,28,75,17,173,不合格
20191455,33,89,51,5,55,233,不合格
20191456,68,39,66,53,1,227,不合格
20191457,28,57,3,19,42,149,不合格
20191458,36,70,89,29,19,243,不合格
20191459,92,26,69,69,22,278,不合格
20191460,95,64,15,30,48,252,不合格
20191461,34,42,80,45,53,254,不合格
20191462,28,65,75,10,36,214,不合格
20191463,89,85,12,65,55,306,合格
20191464,4,25,51,43,22,145,不合格
20191465,59,52,54,98,65,328,合格
20191466,81,49,71,61,27,289,不合格
20191467,58,75,78,28,13,252,不合格
20191468,12,72,83,3,49,219,不合格
20191469,96,51,34,46,81,308,合格
20191470,49,56,6,14,20,145,不合格
20191471,85,4,86,81,12,268,不合格
20191472,90,18,1,92,28,229,不合格
20191473,88,63,82,54,10,297,不合格
20191474,90,94,59,70,62,375,合格
20191475,63,28,33,81,95,300,合格
20191476,18,26,76,76,39,235,不合格
20191477,1,58,11,0,62,132,不合格
20191478,84,34,61,1,26,206,不合格
20191479,78,29,47,55,23,232,不合格
20191480,51,99,37,1,63,251,不合格
20191481,24,84,43,25,11,187,不合格
20191482,58,40,42,79,74,293,不合格
20191483,23,90,39,95,72,319,合格
20191484,58,52,30,59,8,207,不合格
20191485,51,56,85,19,3,214,不合格
20191486,74,57,65,6,95,297,不合格
20191487,84,94,99,58,6,341,合格
20191488,73,99,46,63,31,312,合格
20191489,0,14,29,84,79,206,不合格
20191490,36,39,97,79,57,308,合格
20191491,35,37,72,98,59,301,合格
20191492,8,21,86,57,75,247,不合格
20191493,51,20,83,98,14,266,不合格
20191494,42,5,85,58,6,196,不合格
20191495,0,73,60,92,16,241,不合格
20191496,51,97,70,45,96,359,合格
20191497,71,54,57,98,5,285,不合格
20191498,92,29,44,37,56,258,不合格
20191499,16,60,2,0,88,166,不合格
20191500,60,17,41,42,54,214,不合格
20191501,34,85,83,33,78,313,合格
20191502,8,13,97,11,3,132,不合格
20191503,28,0,3,72,29,132,不合格
20191504,19,60,12,99,9,199,不合格
20191505,4,77,85,49,71,286,不合格
20191506,55,70,91,34,76,326,合格
20191507,60,59,42,9,7,177,不合格
20191508,34,48,63,43,37,225,不合格
20191509,12,56,9,69,13,159,不合格
20191510,65,61,18,97,13,254,不合格
20191511,0,19,95,23,6,143,不合格
20191512,82,9,20,77,97,285,不合格
20191513,77,44,6,92,76,295,不合格
20191514,47,44,39,27,20,177,不合格
20191515,66,73,66,30,2,237,不合格
20191516,94,53,36,65,62,310,合格
20191517,19,69,60,73,40,261,不合格
20191518,89,91,33,85,76,374,合格
20191519,85,80,81,42,35,323,合格
20191520,21,58,40,26,11,156,不合格
20191521,84,40,88,27,22,261,不合格
20191522,28,65,15,17,1,126,不合格
20191523,74,53,84,59,25,295,不合格
20191524,1,20,49,4,93,167,不合格
20191525,43,19,0,88,77,227,不合格
20191526,26,63,22,94,63,268,不合格
20191527,10,94,86,9,82,281,不合格
20191528,79,78,78,13,31,279,不合格
20191529,0,53,94,68,98,313,合格
20191530,60,46,85,29,38,258,不合格
20191531,4,77,53,22,63,219,不合格
20191532,49,48,11,38,2,148,不合格
20191533,85,42,57,45,21,250,不合格
20191534,55,85,3,87,76,306,合格
20191535,63,62,38,59,26,248,不合格
20191536,30,76,85,28,33,252,不合格
20191537,73,2,54,54,47,230,不合格
20191538,5,8,46,71,97,227,不合格
20191539,67,60,58,88,26,299,不合格
20191540,65,97,33,89,73,357,合格
20191541,97,43,22,91,28,281,不合格
20191542,35,14,7,52,16,124,不合格
20191543,7,90,64,24,54,239,不合格
20191544,30,80,7,63,11,191,不合格
20191545,89,35,26,47,69,266,不合格
20191546,7,99,62,67,71,306,合格
20191547,79,77,25,62,67,310,合格
20191548,32,34,59,21,77,223,不合格
20191549,82,34,48,57,35,256,不合格
20191550,48,90,14,87,15,254,不合格
20191551,6,92,2,69,99,268,不合格
20191552,27,52,13,97,59,248,不合格
20191553,57,14,77,80,94,322,合格
20191554,26,52,88,53,13,232,不合格
20191555,19,74,77,68,70,308,合格
20191556,84,63,32,29,77,285,不合格
20191557,21,54,88,20,86,269,不合格
20191558,73,70,1,8,63,215,不合格
20191559,5,40,18,35,41,139,不合格
20191560,82,25,42,4,5,158,不合格
20191561,90,36,83,87,63,359,合格
20191562,29,70,67,53,64,283,不合格
20191563,35,77,24,93,17,246,不合格
20191564,43,93,12,50,28,226,不合格
20191565,72,30,35,35,97,269,不合格
20191566,36,63,27,34,76,236,不合格
20191567,25,35,41,80,22,203,不合格
20191568,66,59,53,14,47,239,不合格
20191569,71,55,79,89,55,349,合格
20191570,91,91,6,0,60,248,不合格
20191571,59,65,76,49,52,301,合格
20191572,68,17,72,18,52,227,不合格
20191573,19,18,62,93,53,245,不合格
20191574,26,11,61,93,7,198,不合格
20191575,26,59,4,51,68,208,不合格
20191576,77,29,98,24,83,311,合格
20191577,78,60,30,87,30,285,不合格
20191578,25,30,74,88,15,232,不合格
20191579,50,69,35,10,4,168,不合格
20191580,73,53,15,95,65,301,合格
20191581,14,26,73,91,49,253,不合格
20191582,19,35,26,92,79,251,不合格
20191583,1,58,97,67,34,257,不合格
20191584,10,15,71,96,40,232,不合格
20191585,62,48,90,21,24,245,不合格
20191586,47,36,59,79,19,240,不合格
20191587,47,3,8,54,22,134,不合格
20191588,12,21,85,55,28,201,不合格
20191589,64,9,10,66,41,190,不合格
20191590,63,33,64,10,57,227,不合格
20191591,60,12,53,38,29,192,不合格
20191592,6,28,9,2,88,133,不合格
20191593,95,18,6,63,90,272,不合格
20191594,21,65,25,94,53,258,不合格
20191595,48,37,93,66,46,290,不合格
20191596,66,14,46,66,32,224,不合格
20191597,8,69,3,36,75,191,不合格
20191598,69,82,9,44,69,273,不合格
20191599,37,65,90,51,2,245,不合格
20191600,4,39,70,65,42,220,不合格
20191601,64,89,30,9,94,286,不合格
20191602,17,85,88,53,53,296,不合格
20191603,48,41,13,87,47,236,不合格
20191604,13,35,16,14,71,149,不合格
20191605,68,17,64,8,24,181,不合格
20191606,92,91,18,45,87,333,合格
20191607,69,80,44,1,51,245,不合格
20191608,91,3,34,80,60,268,不合格
20191609,58,17,48,63,23,209,不合格
20191610,45,71,87,67,71,341,合格
20191611,72,76,81,43,49,321,合格
20191612,66,92,25,83,65,331,合格
20191613,86,25,59,7,7,184,不合格
20191614,68,89,97,20,47,321,合格
20191615,86,82,18,94,95,375,合格
20191616,9,77,34,3,64,187,不合格
20191617,84,4,97,77,82,344,合格
20191618,5,22,18,21,43,109,不合格
20191619,74,98,96,73,25,366,合格
20191620,35,97,89,83,91,395,合格
20191621,36,13,41,52,37,179,不合格
20191622,5,27,94,80,50,256,不合格
20191623,77,76,4,65,97,319,合格
20191624,67,80,19,89,55,310,合格
20191625,80,13,98,55,64,310,合格
20191626,24,47,20,95,17,203,不合格
20191627,84,87,33,29,27,260,不合格
20191628,52,96,84,71,8,311,合格
20191629,33,85,63,0,46,227,不合格
20191630,84,78,43,4,44,253,不合格
20191631,82,46,56,61,27,272,不合格
20191632,55,7,53,37,41,193,不合格
20191633,0,53,95,22,43,213,不合格
20191634,11,39,69,6,65,190,不合格
20191635,53,52,62,38,87,292,不合格
20191636,78,55,44,59,51,287,不合格
20191637,25,68,99,54,80,326,合格
20191638,70,91,96,78,17,352,合格
20191639,52,97,12,29,36,226,不合格
20191640,50,43,93,55,18,259,不合格
20191641,93,67,19,8,37,224,不合格
20191642,39,5,52,46,0,142,不合格
20191643,68,86,29,18,45,246,不合格
20191644,94,72,89,51,38,344,合格
20191645,39,12,92,83,32,258,不合格
20191646,40,97,70,2,74,283,不合格
20191647,65,2,54,45,87,253,不合格
20191648,49,56,45,55,71,276,不合格
20191649,44,29,98,84,12,267,不合格
20191650,84,64,35,31,11,225,不合格
20191651,40,2,54,79,90,265,不合格
20191652,58,91,98,95,46,388,合格
20191653,1,71,54,76,7,209,不合格
20191654,75,37,80,6,88,286,不合格
20191655,7,52,59,12,19,149,不合格
20191656,46,8,81,75,95,305,合格
20191657,30,26,92,17,23,188,不合格
20191658,48,8,76,83,64,279,不合格
20191659,0,11,89,61,23,184,不合格
20191660,36,78,96,81,24,315,合格
20191661,71,12,59,12,32,186,不合格
20191662,4,29,29,97,11,170,不合格
20191663,73,86,92,79,4,334,合格
20191664,44,95,71,25,50,285,不合格
20191665,87,48,25,76,66,302,合格
20191666,34,41,88,22,34,219,不合格
20191667,2,17,57,3,61,140,不合格
20191668,2,42,21,28,44,137,不合格
20191669,65,36,24,27,67,219,不合格
20191670,66,88,88,92,8,342,合格
20191671,69,82,99,81,83,414,合格
20191672,4,20,43,0,66,133,不合格
20191673,86,24,99,93,56,358,合格
20191674,89,89,77,69,16,340,合格
20191675,53,52,22,54,24,205,不合格
20191676,9,90,8,51,60,218,不合格
20191677,59,3,43,39,97,241,不合格
20191678,43,95,44,5,59,246,不合格
20191679,30,20,5,93,91,239,不合格
20191680,6,56,89,42,83,276,不合格
20191681,85,92,5,0,2,184,不合格
20191682,36,68,9,30,47,190,不合格
20191683,87,97,3,55,90,332,合格
20191684,69,27,50,42,55,243,不合格
20191685,88,78,99,30,78,373,合格
20191686,77,25,90,22,94,308,合格
20191687,7,95,74,97,9,282,不合格
20191688,45,86,34,46,41,252,不合格
20191689,29,42,42,14,19,146,不合格
20191690,70,26,24,93,66,279,不合格
20191691,13,22,84,77,97,293,不合格
20191692,89,15,19,25,95,243,不合格
20191693,76,92,51,47,6,272,不合格
20191694,98,2,14,27,87,228,不合格
20191695,92,18,37,3,4,154,不合格
20191696,99,35,75,23,76,308,合格
20191697,23,0,5,41,7,76,不合格
20191698,34,82,62,14,7,199,不合格
20191699,97,3,18,90,74,282,不合格
20191700,13,88,70,76,29,276,不合格
20191701,90,80,48,11,54,283,不合格
20191702,33,94,51,37,31,246,不合格
20191703,12,96,65,67,51,291,不合格
20191704,43,90,74,32,76,315,合格
20191705,56,63,84,18,72,293,不合格
20191706,67,45,80,4,60,256,不合格
20191707,43,54,39,35,91,262,不合格
20191708,67,48,14,91,57,277,不合格
20191709,91,91,37,51,45,315,合格
20191710,79,11,37,85,98,310,合格
20191711,75,80,64,49,73,341,合格
20191712,15,27,41,24,56,163,不合格
20191713,73,86,45,76,23,303,合格
20191714,57,64,66,62,82,331,合格
20191715,10,82,23,79,21,215,不合格
20191716,63,6,98,10,51,228,不合格
20191717,99,56,65,48,85,353,合格
20191718,36,93,62,47,74,312,合格
20191719,27,70,44,62,97,300,合格
20191720,68,43,10,9,11,141,不合格
20191721,77,86,65,58,91,377,合格
20191722,83,54,86,17,36,276,不合格
20191723,6,81,95,12,34,228,不合格
20191724,88,20,7,83,19,217,不合格
20191725,89,39,20,20,29,197,不合格
20191726,23,81,83,3,88,278,不合格
20191727,22,61,30,35,65,213,不合格
20191728,87,54,14,49,71,275,不合格
20191729,32,19,23,86,39,199,不合格
20191730,86,78,6,21,51,242,不合格
20191731,1,0,17,68,30,116,不合格
20191732,26,97,80,40,99,342,合格
20191733,24,50,5,32,85,196,不合格
20191734,71,58,28,60,21,238,不合格
20191735,36,24,68,53,48,229,不合格
20191736,71,52,93,78,21,315,合格
20191737,12,77,53,54,10,206,不合格
20191738,10,4,74,89,65,242,不合格
20191739,88,62,29,75,65,319,合格
20191740,50,60,80,66,35,291,不合格
20191741,23,5,75,85,94,282,不合格
20191742,46,96,6,47,75,270,不合格
20191743,51,45,62,25,23,206,不合格
20191744,96,95,88,34,41,354,合格
20191745,8,13,19,24,48,112,不合格
20191746,35,10,60,81,60,246,不合格
20191747,63,89,84,29,55,320,合格
20191748,0,7,88,31,77,203,不合格
20191749,26,39,25,77,44,211,不合格
20191750,40,94,33,52,40,259,不合格
20191751,13,42,81,12,56,204,不合格
20191752,84,67,35,32,92,310,合格
20191753,54,18,69,32,99,272,不合格
20191754,47,28,99,94,96,364,合格
20191755,68,81,56,55,69,329,合格
20191756,75,44,27,73,76,295,不合格
20191757,39,17,57,6,56,175,不合格
20191758,12,51,32,68,85,248,不合格
20191759,92,80,62,82,35,351,合格
20191760,99,43,75,78,0,295,不合格
20191761,40,48,51,66,4,209,不合格
20191762,15,62,51,0,13,141,不合格
20191763,39,19,88,39,5,190,不合格
20191764,51,27,92,57,62,289,不合格
20191765,33,97,97,44,37,308,合格
20191766,58,87,65,73,70,353,合格
20191767,22,44,45,96,12,219,不合格
20191768,27,99,1,42,56,225,不合格
20191769,74,78,25,30,5,212,不合格
20191770,78,55,14,41,5,193,不合格
20191771,36,33,10,77,61,217,不合格
20191772,64,97,54,50,81,346,合格
20191773,67,37,6,94,31,235,不合格
20191774,95,87,35,56,87,360,合格
20191775,62,34,6,6,70,178,不合格
20191776,80,93,20,81,17,291,不合格
20191777,64,16,59,92,60,291,不合格
20191778,64,26,94,71,40,295,不合格
20191779,50,8,65,54,70,247,不合格
20191780,1,87,25,17,73,203,不合格
20191781,39,31,2,70,21,163,不合格
20191782,34,63,44,82,95,318,合格
20191783,20,25,51,20,26,142,不合格
20191784,64,20,72,45,88,289,不合格
20191785,41,85,58,75,93,352,合格
20191786,8,10,20,59,15,112,不合格
20191787,83,0,35,38,33,189,不合格
20191788,92,25,81,23,1,222,不合格
20191789,70,24,83,59,2,238,不合格
20191790,38,84,8,61,15,206,不合格
20191791,55,64,31,63,66,279,不合格
20191792,81,72,0,3,57,213,不合格
20191793,55,7,21,11,25,119,不合格
20191794,98,36,66,52,32,284,不合格
20191795,22,71,20,33,20,166,不合格
20191796,25,3,96,19,35,178,不合格
20191797,25,4,96,64,97,286,不合格
20191798,77,89,34,81,31,312,合格
20191799,66,53,44,1,96,260,不合格
20191800,8,39,52,53,50,202,不合格
20191801,52,48,4,2,70,176,不合格
20191802,99,39,35,13,58,244,不合格
20191803,72,6,47,84,13,222,不合格
20191804,4,1,83,29,19,136,不合格
20191805,10,29,56,69,89,253,不合格
20191806,95,62,28,95,4,284,不合格
20191807,59,29,99,69,3,259,不合格
20191808,75,84,29,55,92,335,合格
20191809,15,54,66,95,51,281,不合格
20191810,54,52,29,88,61,284,不合格
20191811,76,90,65,36,14,281,不合格
20191812,33,66,2,29,21,151,不合格
20191813,35,50,65,64,23,237,不合格
20191814,80,49,3,63,39,234,不合格
20191815,24,38,29,5,69,165,不合格
20191816,8,98,71,50,93,320,合格
20191817,0,39,53,86,85,263,不合格
20191818,45,87,1,28,57,218,不合格
20191819,49,58,58,52,22,239,不合格
20191820,66,86,26,62,4,244,不合格
20191821,18,72,34,5,83,212,不合格
20191822,95,67,63,65,39,329,合格
20191823,52,80,17,92,69,310,合格
20191824,48,11,51,44,65,219,不合格
20191825,36,44,0,24,97,201,不合格
20191826,19,21,2,42,52,136,不合格
20191827,79,52,54,7,28,220,不合格
20191828,0,32,90,34,3,159,不合格
20191829,63,60,47,4,53,227,不合格
20191830,4,54,67,69,28,222,不合格
20191831,6,49,68,10,72,205,不合格
20191832,23,45,68,80,53,269,不合格
20191833,82,14,38,14,35,183,不合格
20191834,14,93,60,93,36,296,不合格
20191835,63,44,70,35,48,260,不合格
20191836,5,81,65,54,58,263,不合格
20191837,49,85,98,93,45,370,合格
20191838,78,52,17,83,36,266,不合格
20191839,58,59,48,27,29,221,不合格
20191840,80,55,27,80,56,298,不合格
20191841,86,73,61,28,90,338,合格
20191842,41,40,25,75,76,257,不合格
20191843,19,49,19,85,65,237,不合格
20191844,95,65,89,46,39,334,合格
20191845,80,68,59,17,2,226,不合格
20191846,21,84,41,85,20,251,不合格
20191847,18,17,28,18,22,103,不合格
20191848,7,83,78,79,78,325,合格
20191849,28,34,23,28,2,115,不合格
20191850,25,4,34,17,57,137,不合格
20191851,94,18,84,46,32,274,不合格
20191852,12,88,33,39,97,269,不合格
20191853,50,5,15,38,92,200,不合格
20191854,94,62,43,28,22,249,不合格
20191855,66,19,50,0,86,221,不合格
20191856,45,19,7,13,68,152,不合格
20191857,47,40,13,87,17,204,不合格
20191858,15,14,75,70,27,201,不合格
20191859,93,24,22,27,13,179,不合格
20191860,24,28,33,37,91,213,不合格
20191861,99,94,77,5,15,290,不合格
20191862,49,69,76,6,91,291,不合格
20191863,26,85,66,94,34,305,合格
20191864,57,80,61,10,6,214,不合格
20191865,60,73,4,40,93,270,不合格
20191866,98,56,63,66,1,284,不合格
20191867,41,66,56,47,58,268,不合格
20191868,70,49,39,8,31,197,不合格
20191869,22,79,45,4,46,196,不合格
20191870,73,17,91,5,30,216,不合格
20191871,92,18,83,12,81,286,不合格
20191872,3,84,33,28,64,212,不合格
20191873,61,42,58,69,50,280,不合格
20191874,33,74,75,36,60,278,不合格
20191875,90,89,89,68,30,366,合格
20191876,76,14,42,93,55,280,不合格
20191877,15,86,63,75,21,260,不合格
20191878,41,25,62,16,85,229,不合格
20191879,91,93,44,42,16,286,不合格
20191880,22,66,50,39,93,270,不合格
20191881,67,65,62,58,26,278,不合格
20191882,90,93,35,49,43,310,合格
20191883,41,58,94,81,80,354,合格
20191884,73,70,33,41,52,269,不合格
20191885,34,23,67,98,85,307,合格
20191886,94,79,9,95,44,321,合格
20191887,44,61,31,56,7,199,不合格
20191888,0,83,8,2,69,162,不合格
20191889,98,78,43,85,81,385,合格
20191890,93,85,61,84,9,332,合格
20191891,58,69,25,46,59,257,不合格
20191892,6,77,98,27,3,211,不合格
20191893,5,0,58,41,80,184,不合格
20191894,13,27,83,70,71,264,不合格
20191895,38,12,62,98,72,282,不合格
20191896,20,67,28,62,46,223,不合格
20191897,4,0,32,49,85,170,不合格
20191898,30,8,20,95,53,206,不合格
20191899,30,50,25,60,97,262,不合格
20191900,55,86,49,68,15,273,不合格
20191901,93,56,34,42,21,246,不合格
20191902,10,26,69,48,23,176,不合格
20191903,90,90,44,22,87,333,合格
20191904,72,19,95,70,14,270,不合格
20191905,34,55,59,83,65,296,不合格
20191906,94,18,96,24,52,284,不合格
20191907,94,33,59,5,65,256,不合格
20191908,26,42,91,56,39,254,不合格
20191909,33,36,2,61,14,146,不合格
20191910,68,84,30,21,50,253,不合格
20191911,82,78,28,31,79,298,不合格
20191912,30,6,0,52,47,135,不合格
20191913,62,43,71,74,39,289,不合格
20191914,67,59,13,73,24,236,不合格
20191915,4,85,60,86,88,323,合格
20191916,27,8,12,17,85,149,不合格
20191917,84,39,0,26,10,159,不合格
20191918,81,3,77,18,3,182,不合格
20191919,64,3,88,36,80,271,不合格
20191920,70,88,19,34,4,215,不合格
20191921,61,91,34,59,62,307,合格
20191922,46,92,96,8,49,291,不合格
20191923,4,28,98,94,35,259,不合格
20191924,82,36,31,25,18,192,不合格
20191925,9,8,93,56,9,175,不合格
20191926,58,2,80,93,79,312,合格
20191927,8,50,76,67,12,213,不合格
20191928,10,52,30,76,46,214,不合格
20191929,51,35,63,80,79,308,合格
20191930,15,55,28,35,56,189,不合格
20191931,65,48,11,23,88,235,不合格
20191932,17,88,43,91,28,267,不合格
20191933,51,41,16,75,58,241,不合格
20191934,2,56,4,66,62,190,不合格
20191935,47,86,84,39,6,262,不合格
20191936,79,55,84,84,20,322,合格
20191937,72,63,66,37,2,240,不合格
20191938,89,52,47,52,34,274,不合格
20191939,24,29,77,10,11,151,不合格
20191940,87,83,14,13,86,283,不合格
20191941,81,27,83,40,88,319,合格
20191942,53,61,79,94,19,306,合格
20191943,3,28,50,73,83,237,不合格
20191944,92,43,62,42,88,327,合格
20191945,56,13,95,19,41,224,不合格
20191946,28,89,32,26,64,239,不合格
20191947,99,24,3,93,42,261,不合格
20191948,71,71,13,35,36,226,不合格
20191949,33,37,40,31,65,206,不合格
20191950,43,72,11,22,23,171,不合格
20191951,26,35,86,94,63,304,合格
20191952,86,99,83,18,63,349,合格
20191953,50,69,20,36,41,216,不合格
20191954,31,67,48,20,23,189,不合格
20191955,98,41,28,62,54,283,不合格
20191956,4,47,99,19,7,176,不合格
20191957,45,82,23,46,42,238,不合格
20191958,0,89,1,66,59,215,不合格
20191959,39,48,37,11,56,191,不合格
20191960,18,92,50,58,34,252,不合格
20191961,89,87,5,15,8,204,不合格
20191962,89,27,85,14,67,282,不合格
20191963,2,83,62,34,89,270,不合格
20191964,46,21,58,64,97,286,不合格
20191965,69,90,89,21,62,331,合格
20191966,6,96,28,26,99,255,不合格
20191967,97,4,65,19,64,249,不合格
20191968,63,98,5,31,30,227,不合格
20191969,80,65,3,85,50,283,不合格
20191970,88,31,35,15,27,196,不合格
20191971,1,32,34,83,46,196,不合格
20191972,42,4,77,78,14,215,不合格
20191973,38,70,36,34,99,277,不合格
20191974,95,15,77,41,94,322,合格
20191975,42,0,42,60,59,203,不合格
20191976,61,49,13,89,14,226,不合格
20191977,6,79,32,92,80,289,不合格
20191978,64,25,57,36,16,198,不合格
20191979,44,45,64,98,67,318,合格
20191980,15,20,98,59,0,192,不合格
20191981,66,36,71,28,6,207,不合格
20191982,29,63,67,65,48,272,不合格
20191983,69,16,68,72,28,253,不合格
20191984,9,94,47,22,90,262,不合格
20191985,68,1,62,72,72,275,不合格
20191986,96,58,50,17,36,257,不合格
20191987,7,13,15,96,95,226,不合格
20191988,26,52,60,57,64,259,不合格
20191989,19,33,36,19,7,114,不合格
20191990,97,69,70,77,17,330,合格
20191991,64,6,26,59,25,180,不合格
20191992,87,35,59,88,77,346,合格
20191993,92,54,72,50,18,286,不合格
20191994,7,64,45,34,51,201,不合格
20191995,41,97,31,12,1,182,不合格
20191996,2,50,75,9,60,196,不合格
20191997,59,79,2,9,34,183,不合格
20191998,99,94,82,85,85,445,合格
20191999,84,65,47,65,12,273,不合格
20192000,69,61,35,41,4,210,不合格
20192001,13,42,38,30,11,134,不合格
20192002,8,21,86,40,51,206,不合格
20192003,86,42,56,56,24,264,不合格
20192004,60,36,50,19,77,242,不合格
20192005,24,35,56,74,26,215,不合格
20192006,77,13,72,72,91,325,合格
20192007,79,75,27,11,48,240,不合格
20192008,85,60,3,15,77,240,不合格
20192009,14,90,76,12,14,206,不合格
20192010,9,39,39,54,42,183,不合格
20192011,55,74,71,71,82,353,合格
20192012,25,59,80,77,46,287,不合格
20192013,70,67,54,99,90,380,合格
20192014,22,55,32,2,30,141,不合格
20192015,52,54,45,35,53,239,不合格
20192016,34,32,87,15,85,253,不合格
20192017,64,0,50,76,12,202,不合格
20192018,91,65,38,29,76,299,不合格
20192019,23,90,29,71,54,267,不合格
20192020,45,33,44,67,47,236,不合格
20192021,80,53,64,87,13,297,不合格
20192022,34,86,87,3,79,289,不合格
20192023,75,58,46,88,52,319,合格
20192024,71,9,84,24,15,203,不合格
20192025,73,6,83,57,6,225,不合格
20192026,44,67,20,36,47,214,不合格
20192027,80,14,18,96,58,266,不合格
20192028,31,42,73,15,3,164,不合格
20192029,99,3,76,95,40,313,合格
20192030,22,36,71,9,72,210,不合格
20192031,53,40,89,38,31,251,不合格
20192032,56,27,85,35,95,298,不合格
20192033,0,98,49,70,12,229,不合格
20192034,4,79,9,46,29,167,不合格
20192035,83,59,51,4,34,231,不合格
20192036,61,14,8,47,89,219,不合格
20192037,91,67,32,73,92,355,合格
20192038,56,23,19,68,6,172,不合格
20192039,3,16,7,3,25,54,不合格
20192040,34,44,35,86,45,244,不合格
20192041,89,36,18,33,21,197,不合格
20192042,22,55,93,7,14,191,不合格
20192043,69,1,75,41,2,188,不合格
20192044,66,64,72,66,5,273,不合格
20192045,23,88,60,0,91,262,不合格
20192046,5,77,20,24,73,199,不合格
20192047,2,21,97,62,47,229,不合格
20192048,2,46,60,8,36,152,不合格
20192049,66,30,69,58,74,297,不合格
20192050,49,53,26,93,71,292,不合格
20192051,76,42,80,93,42,333,合格
20192052,54,38,46,57,9,204,不合格
20192053,37,41,15,14,95,202,不合格
20192054,85,33,67,43,19,247,不合格
20192055,51,43,74,41,51,260,不合格
20192056,56,15,36,76,49,232,不合格
20192057,54,63,15,14,1,147,不合格
20192058,56,22,61,87,89,315,合格
20192059,9,0,81,1,54,145,不合格
20192060,1,33,16,44,66,160,不合格
20192061,10,91,50,44,14,209,不合格
20192062,61,34,59,90,83,327,合格
20192063,49,44,35,24,15,167,不合格
20192064,69,36,30,89,15,239,不合格
20192065,14,4,40,29,75,162,不合格
20192066,49,93,34,20,19,215,不合格
20192067,45,71,27,71,85,299,不合格
20192068,86,34,25,40,72,257,不合格
20192069,19,73,91,38,18,239,不合格
20192070,50,48,48,40,8,194,不合格
20192071,73,57,20,21,82,253,不合格
20192072,99,25,95,51,79,349,合格
20192073,3,81,62,70,54,270,不合格
20192074,5,72,64,56,23,220,不合格
20192075,60,33,25,62,71,251,不合格
20192076,79,7,49,53,62,250,不合格
20192077,10,7,34,59,60,170,不合格
20192078,1,75,79,9,98,262,不合格
20192079,30,86,27,49,54,246,不合格
20192080,21,50,64,54,17,206,不合格
20192081,50,48,42,7,29,176,不合格
20192082,8,95,63,29,42,237,不合格
20192083,13,54,17,13,82,179,不合格
20192084,3,73,91,97,51,315,合格
20192085,85,35,89,72,11,292,不合格
20192086,28,30,62,54,46,220,不合格
20192087,34,72,11,20,86,223,不合格
20192088,42,56,22,32,87,239,不合格
20192089,57,33,56,8,31,185,不合格
20192090,48,23,31,22,82,206,不合格
20192091,63,16,12,46,11,148,不合格
20192092,14,28,26,38,31,137,不合格
20192093,82,72,36,78,60,328,合格
20192094,98,64,66,58,1,287,不合格
20192095,56,51,21,82,50,260,不合格
20192096,81,72,20,52,80,305,合格
20192097,61,90,47,16,7,221,不合格
20192098,88,64,90,73,66,381,合格
20192099,66,88,47,68,84,353,合格
20192100,24,48,56,28,49,205,不合格
20192101,4,32,70,88,87,281,不合格
20192102,78,47,74,72,65,336,合格
20192103,53,47,55,79,90,324,合格
20192104,95,94,35,3,31,258,不合格
20192105,81,95,69,32,90,367,合格
20192106,0,58,50,2,61,171,不合格
20192107,57,16,83,64,8,228,不合格
20192108,40,16,74,57,30,217,不合格
20192109,4,49,57,56,79,245,不合格
20192110,77,9,96,93,80,355,合格
20192111,21,81,5,73,85,265,不合格
20192112,37,0,11,60,64,172,不合格
20192113,35,84,48,5,79,251,不合格
20192114,73,36,60,60,66,295,不合格
20192115,74,3,18,36,42,173,不合格
20192116,40,21,33,43,52,189,不合格
20192117,98,89,11,86,88,372,合格
20192118,78,0,49,12,38,177,不合格
20192119,64,23,22,84,74,267,不合格
20192120,7,84,53,69,7,220,不合格
20192121,69,31,23,68,48,239,不合格
20192122,63,39,72,44,61,279,不合格
20192123,65,96,92,71,11,335,合格
20192124,67,23,18,13,48,169,不合格
20192125,14,70,92,68,12,256,不合格
20192126,64,48,64,41,85,302,合格
20192127,21,88,19,40,21,189,不合格
20192128,78,35,96,17,77,303,合格
20192129,71,33,55,12,25,196,不合格
20192130,83,85,76,32,98,374,合格
20192131,25,31,36,84,59,235,不合格
20192132,28,48,92,72,40,280,不合格
20192133,7,1,33,41,35,117,不合格
20192134,43,34,52,31,4,164,不合格
20192135,40,8,81,25,7,161,不合格
20192136,8,72,68,84,61,293,不合格
20192137,53,9,68,36,39,205,不合格
20192138,30,58,44,5,84,221,不合格
20192139,29,13,77,80,76,275,不合格
20192140,7,49,14,27,80,177,不合格
20192141,98,62,13,99,65,337,合格
20192142,3,41,59,28,78,209,不合格
20192143,41,7,62,77,91,278,不合格
20192144,69,98,36,59,52,314,合格
20192145,36,8,79,75,87,285,不合格
20192146,83,69,32,87,0,271,不合格
20192147,44,15,47,89,81,276,不合格
20192148,10,92,89,32,95,318,合格
20192149,80,65,25,67,8,245,不合格
20192150,26,24,80,88,89,307,合格
20192151,37,42,83,88,89,339,合格
20192152,61,77,37,49,98,322,合格
20192153,60,86,91,67,45,349,合格
20192154,92,62,33,19,38,244,不合格
20192155,63,74,4,27,57,225,不合格
20192156,33,42,20,1,28,124,不合格
20192157,62,38,79,99,2,280,不合格
20192158,43,68,33,20,65,229,不合格
20192159,76,88,28,85,31,308,合格
20192160,57,65,34,15,23,194,不合格
20192161,13,93,3,29,43,181,不合格
20192162,4,61,82,36,28,211,不合格
20192163,66,26,9,5,98,204,不合格
20192164,40,64,7,8,51,170,不合格
20192165,91,46,23,41,73,274,不合格
20192166,40,77,53,16,87,273,不合格
20192167,51,45,63,41,83,283,不合格
20192168,80,79,36,30,77,302,合格
20192169,52,6,47,37,1,143,不合格
20192170,11,18,23,67,51,170,不合格
20192171,15,57,62,78,21,233,不合格
20192172,25,0,42,2,39,108,不合格
20192173,46,48,82,59,22,257,不合格
20192174,98,30,58,63,89,338,合格
20192175,0,35,58,4,34,131,不合格
20192176,54,40,37,52,94,277,不合格
20192177,54,59,16,57,95,281,不合格
20192178,99,79,28,54,11,271,不合格
20192179,78,12,61,95,29,275,不合格
20192180,9,69,33,12,51,174,不合格
20192181,52,77,15,98,91,333,合格
20192182,7,42,99,38,94,280,不合格
20192183,95,95,42,65,19,316,合格
20192184,22,83,81,47,99,332,合格
20192185,20,86,96,82,20,304,合格
20192186,22,97,66,93,16,294,不合格
20192187,32,65,69,95,4,265,不合格
20192188,64,39,93,28,20,244,不合格
20192189,20,1,25,4,3,53,不合格
20192190,56,59,13,88,69,285,不合格
20192191,50,61,92,12,41,256,不合格
20192192,1,24,70,94,12,201,不合格
20192193,74,32,70,82,49,307,合格
20192194,62,42,45,56,8,213,不合格
20192195,26,49,20,91,23,209,不合格
20192196,88,6,6,24,83,207,不合格
20192197,2,58,35,12,6,113,不合格
20192198,28,21,4,93,6,152,不合格
20192199,34,42,81,41,92,290,不合格
20192200,85,46,23,22,97,273,不合格
20192201,14,17,94,8,14,147,不合格
20192202,22,55,41,17,16,151,不合格
20192203,75,55,23,40,40,233,不合格
20192204,55,2,51,45,65,218,不合格
20192205,7,4,24,71,74,180,不合格
20192206,50,83,39,27,88,287,不合格
20192207,48,88,2,25,87,250,不合格
20192208,14,69,76,64,50,273,不合格
20192209,48,61,51,97,18,275,不合格
20192210,55,10,34,46,45,190,不合格
20192211,63,26,7,10,66,172,不合格
20192212,43,52,10,39,91,235,不合格
20192213,57,89,46,94,24,310,合格
20192214,79,12,29,89,96,305,合格
20192215,31,11,69,71,99,281,不合格
20192216,74,62,12,0,0,148,不合格
20192217,86,6,41,47,51,231,不合格
20192218,72,53,30,47,43,245,不合格
20192219,11,8,56,83,54,212,不合格
20192220,58,19,67,68,53,265,不合格
20192221,86,24,84,90,97,381,合格
20192222,89,38,39,29,66,261,不合格
20192223,87,5,94,92,61,339,合格
20192224,27,14,91,39,91,262,不合格
20192225,53,49,4,96,39,241,不合格
20192226,4,10,21,92,65,192,不合格
20192227,13,38,98,96,39,284,不合格
20192228,26,64,60,13,0,163,不合格
20192229,81,69,44,77,73,344,合格
20192230,56,98,97,46,16,313,合格
20192231,56,35,51,86,96,324,合格
20192232,30,24,19,23,34,130,不合格
20192233,1,0,85,4,52,142,不合格
20192234,31,95,93,55,33,307,合格
20192235,11,52,56,45,19,183,不合格
20192236,77,37,88,99,5,306,合格
20192237,36,38,15,87,37,213,不合格
20192238,47,35,56,36,23,197,不合格
20192239,91,38,37,10,78,254,不合格
20192240,2,47,69,50,31,199,不合格
20192241,8,1,8,15,53,85,不合格
20192242,92,46,77,88,9,312,合格
20192243,73,89,70,47,83,362,合格
20192244,19,87,6,79,47,238,不合格
20192245,85,91,44,0,42,262,不合格
20192246,79,78,5,86,17,265,不合格
20192247,72,66,69,55,92,354,合格
20192248,75,95,56,69,27,322,合格
20192249,99,92,36,27,79,333,合格
20192250,92,27,31,0,88,238,不合格
20192251,92,17,65,88,5,267,不合格
20192252,60,20,1,83,65,229,不合格
20192253,33,85,3,17,43,181,不合格
20192254,8,98,0,10,77,193,不合格
20192255,21,50,23,45,51,190,不合格
20192256,36,92,81,49,9,267,不合格
20192257,32,79,1,33,0,145,不合格
20192258,49,64,37,39,6,195,不合格
20192259,13,76,6,84,58,237,不合格
20192260,18,14,48,65,24,169,不合格
20192261,88,85,93,11,0,277,不合格
20192262,62,50,45,20,7,184,不合格
20192263,67,67,96,38,96,364,合格
20192264,64,42,23,75,57,261,不合格
20192265,45,56,14,31,2,148,不合格
20192266,93,35,9,9,0,146,不合格
20192267,10,83,36,1,14,144,不合格
20192268,68,29,73,94,0,264,不合格
20192269,5,94,33,31,46,209,不合格
20192270,10,25,37,37,89,198,不合格
20192271,85,48,76,15,47,271,不合格
20192272,91,44,35,61,54,285,不合格
20192273,13,74,35,52,7,181,不合格
20192274,94,10,68,2,93,267,不合格
20192275,69,21,24,79,28,221,不合格
20192276,28,27,47,94,6,202,不合格
20192277,81,65,32,12,37,227,不合格
20192278,46,43,81,62,65,297,不合格
20192279,44,89,2,31,75,241,不合格
20192280,54,57,31,87,53,282,不合格
20192281,71,50,1,91,59,272,不合格
20192282,6,32,61,28,25,152,不合格
20192283,81,53,45,58,27,264,不合格
20192284,52,19,1,51,10,133,不合格
20192285,96,89,79,82,58,404,合格
20192286,92,77,7,52,72,300,合格
20192287,72,39,83,76,72,342,合格
20192288,4,41,94,24,63,226,不合格
20192289,37,77,14,36,38,202,不合格
20192290,10,24,35,67,59,195,不合格
20192291,34,16,67,0,74,191,不合格
20192292,65,44,83,26,54,272,不合格
20192293,14,52,38,22,61,187,不合格
20192294,11,62,45,75,21,214,不合格
20192295,87,17,50,84,61,299,不合格
20192296,3,54,85,52,58,252,不合格
20192297,39,95,55,9,73,271,不合格
20192298,14,85,42,79,66,286,不合格
20192299,11,57,46,14,46,174,不合格
20192300,41,36,53,38,3,171,不合格
20192301,94,92,77,96,97,456,合格
20192302,77,56,31,97,52,313,合格
20192303,66,43,36,92,24,261,不合格
20192304,46,31,47,11,62,197,不合格
20192305,90,9,86,0,5,190,不合格
20192306,50,76,95,55,79,355,合格
20192307,28,11,10,91,55,195,不合格
20192308,91,28,39,18,57,233,不合格
20192309,49,30,2,83,36,200,不合格
20192310,47,72,82,67,54,322,合格
20192311,31,91,83,66,49,320,合格
20192312,90,86,37,36,90,339,合格
20192313,48,60,90,44,42,284,不合格
20192314,38,32,18,21,69,178,不合格
20192315,9,32,69,23,14,147,不合格
20192316,32,10,93,47,33,215,不合格
20192317,36,10,0,62,47,155,不合格
20192318,24,48,60,69,38,239,不合格
20192319,58,75,1,14,11,159,不合格
20192320,13,17,56,23,96,205,不合格
20192321,46,40,27,70,75,258,不合格
20192322,71,10,16,8,18,123,不合格
20192323,6,47,83,73,55,264,不合格
20192324,33,79,67,27,82,288,不合格
20192325,81,39,94,89,83,386,合格
20192326,67,86,81,70,67,371,合格
20192327,24,81,19,67,48,239,不合格
20192328,69,39,23,39,72,242,不合格
20192329,2,94,28,88,51,263,不合格
20192330,6,40,27,68,86,227,不合格
20192331,32,24,77,89,69,291,不合格
20192332,21,3,5,70,90,189,不合格
20192333,40,81,97,80,49,347,合格
20192334,25,43,33,47,21,169,不合格
20192335,5,53,28,73,42,201,不合格
20192336,12,21,19,21,89,162,不合格
20192337,80,70,1,20,44,215,不合格
20192338,91,65,10,89,17,272,不合格
20192339,70,52,28,96,73,319,合格
20192340,7,21,70,21,76,195,不合格
20192341,21,34,53,34,43,185,不合格
20192342,4,82,33,78,21,218,不合格
20192343,12,4,71,58,56,201,不合格
20192344,33,58,99,98,28,316,合格
20192345,70,31,94,23,55,273,不合格
20192346,28,86,17,24,82,237,不合格
20192347,32,8,92,52,90,274,不合格
20192348,0,89,56,60,59,264,不合格
20192349,43,36,13,50,9,151,不合格
20192350,36,24,73,12,25,170,不合格
20192351,36,0,63,87,77,263,不合格
20192352,70,34,8,79,44,235,不合格
20192353,25,13,54,20,50,162,不合格
20192354,10,55,20,44,0,129,不合格
20192355,12,95,23,16,74,220,不合格
20192356,53,44,86,79,16,278,不合格
20192357,53,94,71,55,50,323,合格
20192358,3,65,90,56,72,286,不合格
20192359,49,80,74,53,54,310,合格
20192360,41,46,47,33,20,187,不合格
20192361,69,22,75,88,67,321,合格
20192362,87,61,20,78,67,313,合格
20192363,60,35,66,14,76,251,不合格
20192364,70,5,73,38,14,200,不合格
20192365,58,71,48,38,63,278,不合格
20192366,2,84,38,77,19,220,不合格
20192367,63,58,82,88,47,338,合格
20192368,71,37,17,46,61,232,不合格
20192369,48,81,86,20,7,242,不合格
20192370,17,93,83,14,47,254,不合格
20192371,84,52,48,36,7,227,不合格
20192372,25,57,59,92,99,332,合格
20192373,42,89,13,6,0,150,不合格
20192374,81,56,62,3,98,300,合格
20192375,43,49,5,13,91,201,不合格
20192376,37,40,57,9,79,222,不合格
20192377,52,18,5,55,56,186,不合格
20192378,73,67,55,12,12,219,不合格
20192379,33,40,93,76,3,245,不合格
20192380,12,1,45,25,6,89,不合格
20192381,71,70,77,66,60,344,合格
20192382,83,2,74,92,29,280,不合格
20192383,26,38,17,87,59,227,不合格
20192384,25,75,48,42,9,199,不合格
20192385,84,12,9,73,23,201,不合格
20192386,85,90,50,86,27,338,合格
20192387,56,25,54,21,99,255,不合格
20192388,86,65,75,99,57,382,合格
20192389,15,8,82,92,82,279,不合格
20192390,12,92,78,64,80,326,合格
20192391,20,18,40,33,21,132,不合格
20192392,91,53,15,8,73,240,不合格
20192393,61,74,76,77,35,323,合格
20192394,91,78,69,89,21,348,合格
20192395,92,88,61,88,92,421,合格
20192396,28,93,87,22,4,234,不合格
20192397,58,21,34,42,61,216,不合格
20192398,23,8,72,43,97,243,不合格
20192399,95,12,81,34,15,237,不合格
20192400,48,92,15,7,97,259,不合格
20192401,69,40,0,29,51,189,不合格
20192402,93,41,62,1,32,229,不合格
20192403,8,10,40,3,27,88,不合格
20192404,32,3,88,4,24,151,不合格
20192405,63,36,66,24,43,232,不合格
20192406,7,95,63,2,78,245,不合格
20192407,22,8,77,14,22,143,不合格
20192408,0,85,65,7,18,175,不合格
20192409,47,95,37,2,64,245,不合格
20192410,33,99,32,46,49,259,不合格
20192411,14,69,80,99,56,318,合格
20192412,53,33,25,49,56,216,不合格
20192413,21,15,84,75,44,239,不合格
20192414,22,30,37,98,90,277,不合格
20192415,8,70,91,50,84,303,合格
20192416,53,11,93,11,73,241,不合格
20192417,11,5,41,4,7,68,不合格
20192418,28,78,77,8,80,271,不合格
20192419,75,2,48,17,20,162,不合格
20192420,79,80,2,57,45,263,不合格
20192421,23,51,4,10,19,107,不合格
20192422,57,92,58,60,48,315,合格
20192423,58,4,41,64,47,214,不合格
20192424,37,31,43,9,10,130,不合格
20192425,87,32,40,24,58,241,不合格
20192426,3,20,18,74,92,207,不合格
20192427,94,92,83,91,16,376,合格
20192428,38,26,46,18,19,147,不合格
20192429,98,51,9,80,48,286,不合格
20192430,64,43,61,24,81,273,不合格
20192431,5,82,61,87,10,245,不合格
20192432,99,33,52,36,31,251,不合格
20192433,79,35,60,70,6,250,不合格
20192434,36,20,28,38,44,166,不合格
20192435,55,78,74,23,76,306,合格
20192436,13,97,87,15,99,311,合格
20192437,58,5,68,40,32,203,不合格
20192438,85,78,40,81,95,379,合格
20192439,24,77,0,98,51,250,不合格
20192440,27,79,6,12,94,218,不合格
20192441,63,28,13,98,96,298,不合格
20192442,6,14,71,7,11,109,不合格
20192443,69,41,79,54,43,286,不合格
20192444,4,74,50,54,86,268,不合格
20192445,93,58,72,97,60,380,合格
20192446,82,86,90,32,60,350,合格
20192447,70,41,35,52,12,210,不合格
20192448,44,46,86,87,30,293,不合格
20192449,87,47,24,87,35,280,不合格
20192450,61,76,20,49,55,261,不合格
20192451,91,9,88,49,83,320,合格
20192452,92,64,25,2,85,268,不合格
20192453,9,65,66,19,37,196,不合格
20192454,44,59,57,69,8,237,不合格
20192455,23,97,9,38,74,241,不合格
20192456,35,27,74,27,84,247,不合格
20192457,3,79,76,32,88,278,不合格
20192458,35,22,21,73,75,226,不合格
20192459,41,49,75,67,45,277,不合格
20192460,96,87,73,14,92,362,合格
20192461,37,91,88,41,46,303,合格
20192462,39,39,38,67,57,240,不合格
20192463,16,38,21,37,68,180,不合格
20192464,11,12,38,72,5,138,不合格
20192465,77,72,74,72,69,364,合格
20192466,13,77,30,88,50,258,不合格
20192467,54,64,61,40,24,243,不合格
20192468,20,39,38,25,66,188,不合格
20192469,81,76,96,48,31,332,合格
20192470,89,62,96,74,56,377,合格
20192471,16,33,34,56,80,219,不合格
20192472,82,21,42,74,91,310,合格
20192473,97,61,12,63,86,319,合格
20192474,42,75,79,43,90,329,合格
20192475,54,82,94,99,5,334,合格
20192476,18,93,0,86,69,266,不合格
20192477,59,42,93,29,2,225,不合格
20192478,10,99,22,57,29,217,不合格
20192479,54,88,6,12,6,166,不合格
20192480,2,53,51,65,6,177,不合格
20192481,49,30,10,76,3,168,不合格
20192482,17,45,85,78,83,308,合格
20192483,86,89,17,46,44,282,不合格
20192484,17,33,29,26,73,178,不合格
20192485,0,55,29,75,59,218,不合格
20192486,62,8,6,89,64,229,不合格
20192487,4,59,32,42,92,229,不合格
20192488,22,4,72,97,92,287,不合格
20192489,3,73,84,22,62,244,不合格
20192490,20,58,9,63,54,204,不合格
20192491,96,63,92,69,87,407,合格
20192492,39,28,36,79,6,188,不合格
20192493,50,44,78,98,12,282,不合格
20192494,34,83,27,83,49,276,不合格
20192495,97,87,4,15,75,278,不合格
20192496,11,10,67,8,76,172,不合格
20192497,93,23,21,83,24,244,不合格
20192498,12,77,62,33,62,246,不合格
20192499,23,62,17,76,59,237,不合格
20192500,20,76,26,53,37,212,不合格
20192501,32,11,40,79,66,228,不合格
20192502,16,21,16,16,16,85,不合格
20192503,84,97,3,13,3,200,不合格
20192504,49,71,20,42,0,182,不合格
20192505,22,66,12,84,10,194,不合格
20192506,67,59,78,19,19,242,不合格
20192507,99,28,98,79,59,363,合格
20192508,83,86,82,63,14,328,合格
20192509,57,93,89,38,13,290,不合格
20192510,49,53,23,87,74,286,不合格
20192511,6,72,60,48,55,241,不合格
20192512,38,4,24,60,28,154,不合格
20192513,5,95,38,51,80,269,不合格
20192514,54,1,74,69,98,296,不合格
20192515,30,59,95,3,4,191,不合格
20192516,45,84,27,43,1,200,不合格
20192517,61,5,96,86,69,317,合格
20192518,19,85,33,63,13,213,不合格
20192519,86,56,75,85,54,356,合格
20192520,71,27,75,66,39,278,不合格
20192521,98,35,52,91,32,308,合格
20192522,49,15,83,95,2,244,不合格
20192523,41,72,11,41,95,260,不合格
20192524,84,11,68,26,69,258,不合格
20192525,36,59,32,41,3,171,不合格
20192526,16,69,16,65,83,249,不合格
20192527,52,26,68,99,7,252,不合格
20192528,27,33,29,66,93,248,不合格
20192529,76,8,79,77,1,241,不合格
20192530,56,18,94,42,36,246,不合格
20192531,99,58,82,42,8,289,不合格
20192532,84,69,54,37,72,316,合格
20192533,21,10,42,93,23,189,不合格
20192534,44,0,9,61,4,118,不合格
20192535,57,39,89,57,79,321,合格
20192536,21,94,12,70,33,230,不合格
20192537,68,10,40,20,70,208,不合格
20192538,58,41,86,38,99,322,合格
20192539,65,9,82,12,87,255,不合格
20192540,84,92,15,0,83,274,不合格
20192541,58,58,15,85,21,237,不合格
20192542,12,17,8,40,23,100,不合格
20192543,77,84,22,51,66,300,合格
20192544,97,73,72,67,93,402,合格
20192545,75,12,15,1,51,154,不合格
20192546,72,48,72,18,74,284,不合格
20192547,91,49,88,53,95,376,合格
20192548,21,23,27,34,89,194,不合格
20192549,47,63,61,66,81,318,合格
20192550,63,54,1,18,64,200,不合格
20192551,85,46,55,20,51,257,不合格
20192552,49,80,80,59,56,324,合格
20192553,5,4,6,79,10,104,不合格
20192554,17,14,24,76,63,194,不合格
20192555,59,85,80,74,61,359,合格
20192556,53,66,30,19,25,193,不合格
20192557,15,7,62,48,59,191,不合格
20192558,49,39,92,18,8,206,不合格
20192559,19,2,65,71,67,224,不合格
20192560,2,78,21,93,31,225,不合格
20192561,79,74,31,42,88,314,合格
20192562,24,96,18,47,2,187,不合格
20192563,55,57,26,95,36,269,不合格
20192564,41,24,32,35,38,170,不合格
20192565,51,50,6,7,54,168,不合格
20192566,40,9,85,10,66,210,不合格
20192567,65,58,98,96,17,334,合格
20192568,18,22,61,63,32,196,不合格
20192569,37,59,38,63,89,286,不合格
20192570,4,52,48,4,29,137,不合格
20192571,24,95,5,68,58,250,不合格
20192572,14,72,80,89,6,261,不合格
20192573,88,35,85,71,58,337,合格
20192574,60,41,30,77,29,237,不合格
20192575,8,62,60,92,33,255,不合格
20192576,56,18,45,77,62,258,不合格
20192577,40,30,9,82,17,178,不合格
20192578,49,31,62,28,52,222,不合格
20192579,60,19,14,58,37,188,不合格
20192580,25,43,29,10,43,150,不合格
20192581,23,75,70,75,92,335,合格
20192582,23,40,48,56,66,233,不合格
20192583,82,16,4,99,38,239,不合格
20192584,65,29,97,97,9,297,不合格
20192585,10,0,23,34,81,148,不合格
20192586,92,11,14,13,3,133,不合格
20192587,62,0,21,62,36,181,不合格
20192588,67,37,95,14,32,245,不合格
20192589,3,48,72,22,18,163,不合格
20192590,45,65,1,58,12,181,不合格
20192591,2,37,64,29,78,210,不合格
20192592,69,72,77,75,21,314,合格
20192593,6,98,69,25,13,211,不合格
20192594,41,37,57,61,53,249,不合格
20192595,49,11,65,5,10,140,不合格
20192596,54,59,66,99,66,344,合格
20192597,12,71,47,88,49,267,不合格
20192598,25,34,97,30,58,244,不合格
20192599,13,28,7,55,28,131,不合格
20192600,87,24,44,41,76,272,不合格
20192601,70,22,80,39,37,248,不合格
20192602,47,68,63,50,51,279,不合格
20192603,43,26,30,77,9,185,不合格
20192604,3,20,62,66,69,220,不合格
20192605,96,21,81,8,0,206,不合格
20192606,89,88,54,15,91,337,合格
20192607,30,88,3,51,52,224,不合格
20192608,63,51,88,77,67,346,合格
20192609,10,63,47,99,78,297,不合格
20192610,13,79,64,63,65,284,不合格
20192611,69,57,52,38,81,297,不合格
20192612,80,48,30,99,66,323,合格
20192613,14,33,52,99,48,246,不合格
20192614,0,82,62,49,39,232,不合格
20192615,45,90,94,27,28,284,不合格
20192616,14,39,23,60,49,185,不合格
20192617,84,10,79,12,7,192,不合格
20192618,29,99,73,38,39,278,不合格
20192619,47,0,62,60,78,247,不合格
20192620,73,32,37,85,73,300,合格
20192621,74,98,14,43,30,259,不合格
20192622,8,17,30,20,24,99,不合格
20192623,10,57,73,82,76,298,不合格
20192624,0,34,59,75,3,171,不合格
20192625,25,72,70,75,64,306,合格
20192626,82,34,95,4,87,302,合格
20192627,36,33,96,76,51,292,不合格
20192628,2,7,48,21,85,163,不合格
20192629,53,36,18,50,22,179,不合格
20192630,43,18,45,20,96,222,不合格
20192631,45,89,10,23,68,235,不合格
20192632,42,57,70,80,34,283,不合格
20192633,11,19,67,96,76,269,不合格
20192634,10,83,47,63,70,273,不合格
20192635,30,41,73,49,17,210,不合格
20192636,64,43,20,1,90,218,不合格
20192637,20,61,75,21,81,258,不合格
20192638,65,48,49,34,66,262,不合格
20192639,42,41,81,69,66,299,不合格
20192640,71,2,38,74,32,217,不合格
20192641,57,48,55,66,20,246,不合格
20192642,26,44,29,29,20,148,不合格
20192643,44,78,20,64,48,254,不合格
20192644,5,97,75,36,76,289,不合格
20192645,32,50,12,1,21,116,不合格
20192646,78,5,18,14,19,134,不合格
20192647,89,97,53,30,97,366,合格
20192648,91,80,90,54,5,320,合格
20192649,69,78,53,22,57,279,不合格
20192650,65,15,11,90,32,213,不合格
20192651,82,86,5,50,0,223,不合格
20192652,86,36,97,30,8,257,不合格
20192653,79,37,97,46,1,260,不合格
20192654,31,67,41,39,47,225,不合格
20192655,34,39,56,11,35,175,不合格
20192656,92,9,11,98,40,250,不合格
20192657,45,21,98,30,18,212,不合格
20192658,43,19,22,60,73,217,不合格
20192659,49,62,50,70,27,258,不合格
20192660,10,79,98,63,79,329,合格
20192661,30,5,27,30,8,100,不合格
20192662,2,5,68,69,98,242,不合格
20192663,44,65,92,95,6,302,合格
20192664,55,3,17,0,58,133,不合格
20192665,3,5,88,92,62,250,不合格
20192666,27,4,92,67,45,235,不合格
20192667,71,86,7,16,78,258,不合格
20192668,31,87,31,69,79,297,不合格
20192669,68,44,36,8,8,164,不合格
20192670,24,56,42,77,17,216,不合格
20192671,90,90,11,61,9,261,不合格
20192672,97,30,6,7,41,181,不合格
20192673,36,81,96,33,44,290,不合格
20192674,45,55,33,16,4,153,不合格
20192675,46,93,26,30,62,257,不合格
20192676,0,58,8,61,21,148,不合格
20192677,53,38,95,6,22,214,不合格
20192678,98,8,39,93,91,329,合格
20192679,96,14,80,77,17,284,不合格
20192680,31,72,24,29,41,197,不合格
20192681,61,62,61,24,79,287,不合格
20192682,68,11,1,15,82,177,不合格
20192683,17,93,57,61,91,319,合格
20192684,18,25,80,92,33,248,不合格
20192685,34,50,81,9,91,265,不合格
20192686,46,83,30,21,62,242,不合格
20192687,30,70,15,15,87,217,不合格
20192688,44,31,78,15,99,267,不合格
20192689,38,77,52,7,17,191,不合格
20192690,43,43,39,1,65,191,不合格
20192691,28,89,15,44,7,183,不合格
20192692,21,42,96,70,67,296,不合格
20192693,52,77,85,81,46,341,合格
20192694,79,57,25,77,39,277,不合格
20192695,10,59,37,16,6,128,不合格
20192696,69,22,58,92,90,331,合格
20192697,60,7,99,86,86,338,合格
20192698,73,53,86,36,8,256,不合格
20192699,79,42,31,43,75,270,不合格
20192700,81,55,98,81,37,352,合格
20192701,15,56,94,57,97,319,合格
20192702,64,88,85,79,65,381,合格
20192703,54,45,4,62,73,238,不合格
20192704,11,39,76,36,1,163,不合格
20192705,55,69,68,71,21,284,不合格
20192706,2,94,52,4,85,237,不合格
20192707,28,44,10,53,90,225,不合格
20192708,18,89,90,37,48,282,不合格
20192709,66,87,79,42,27,301,合格
20192710,17,20,29,86,45,197,不合格
20192711,87,61,41,95,19,303,合格
20192712,57,44,91,74,91,357,合格
20192713,77,63,17,98,48,303,合格
20192714,90,64,4,88,7,253,不合格
20192715,34,95,45,81,44,299,不合格
20192716,26,51,83,20,34,214,不合格
20192717,64,36,56,1,67,224,不合格
20192718,6,63,18,81,3,171,不合格
20192719,47,65,93,97,9,311,合格
20192720,71,56,56,50,46,279,不合格
20192721,52,78,6,24,4,164,不合格
20192722,7,90,33,49,62,241,不合格
20192723,27,87,73,54,9,250,不合格
20192724,34,77,70,78,33,292,不合格
20192725,61,54,33,1,37,186,不合格
20192726,45,6,39,5,64,159,不合格
20192727,64,55,31,88,57,295,不合格
20192728,78,74,41,32,33,258,不合格
20192729,76,80,91,93,49,389,合格
20192730,22,79,11,76,7,195,不合格
20192731,59,5,98,65,28,255,不合格
20192732,23,28,49,8,59,167,不合格
20192733,28,7,97,53,31,216,不合格
20192734,68,93,30,7,3,201,不合格
20192735,24,18,36,76,16,170,不合格
20192736,50,89,93,26,31,289,不合格
20192737,86,81,59,22,97,345,合格
20192738,93,93,69,61,48,364,合格
20192739,24,22,10,10,7,73,不合格
20192740,12,37,26,97,66,238,不合格
20192741,49,41,84,16,40,230,不合格
20192742,53,32,5,1,78,169,不合格
20192743,44,69,69,10,11,203,不合格
20192744,83,3,53,70,19,228,不合格
20192745,24,15,6,28,15,88,不合格
20192746,76,87,92,96,78,429,合格
20192747,5,53,21,53,88,220,不合格
20192748,18,8,31,12,80,149,不合格
20192749,51,40,33,31,34,189,不合格
20192750,43,93,80,43,17,276,不合格
20192751,85,44,77,27,74,307,合格
20192752,28,53,41,48,42,212,不合格
20192753,50,60,65,90,54,319,合格
20192754,50,80,88,43,6,267,不合格
20192755,85,60,80,34,71,330,合格
20192756,7,2,68,42,3,122,不合格
20192757,94,74,52,95,1,316,合格
20192758,78,22,54,6,56,216,不合格
20192759,38,7,97,40,93,275,不合格
20192760,8,50,21,94,78,251,不合格
20192761,97,41,50,75,71,334,合格
20192762,44,3,69,55,35,206,不合格
20192763,4,54,23,91,2,174,不合格
20192764,36,81,24,72,32,245,不合格
20192765,51,51,77,21,57,257,不合格
20192766,62,3,39,25,92,221,不合格
20192767,28,83,14,54,36,215,不合格
20192768,34,64,18,3,14,133,不合格
20192769,13,97,45,73,85,313,合格
20192770,71,15,53,18,79,236,不合格
20192771,2,96,30,80,95,303,合格
20192772,41,10,15,96,83,245,不合格
20192773,98,48,74,6,25,251,不合格
20192774,87,97,6,78,99,367,合格
20192775,33,75,52,30,9,199,不合格
20192776,53,22,61,64,32,232,不合格
20192777,63,25,97,41,47,273,不合格
20192778,43,66,86,46,35,276,不合格
20192779,76,75,59,91,11,312,合格
20192780,58,2,32,64,88,244,不合格
20192781,53,56,64,38,94,305,合格
20192782,71,40,91,60,37,299,不合格
20192783,91,88,78,21,65,343,合格
20192784,22,88,68,67,85,330,合格
20192785,42,44,50,85,63,284,不合格
20192786,87,0,48,51,19,205,不合格
20192787,64,85,70,71,19,309,合格
20192788,51,76,88,10,52,277,不合格
20192789,54,5,90,94,13,256,不合格
20192790,54,40,77,13,53,237,不合格
20192791,34,79,40,92,2,247,不合格
20192792,81,29,97,44,19,270,不合格
20192793,34,68,15,35,54,206,不合格
20192794,54,71,90,61,2,278,不合格
20192795,52,28,25,68,9,182,不合格
20192796,41,79,68,39,24,251,不合格
20192797,35,68,0,56,67,226,不合格
20192798,37,40,15,69,10,171,不合格
20192799,46,14,67,71,2,200,不合格
20192800,94,22,48,98,48,310,合格
20192801,71,92,96,76,50,385,合格
20192802,14,45,53,49,34,195,不合格
20192803,3,48,12,83,35,181,不合格
20192804,0,79,12,68,36,195,不合格
20192805,22,19,76,65,72,254,不合格
20192806,85,25,62,61,84,317,合格
20192807,93,83,26,70,18,290,不合格
20192808,17,96,6,20,28,167,不合格
20192809,16,14,64,57,77,228,不合格
20192810,49,79,73,26,94,321,合格
20192811,71,62,62,59,67,321,合格
20192812,52,43,20,98,32,245,不合格
20192813,58,68,32,1,67,226,不合格
20192814,17,76,50,16,6,165,不合格
20192815,25,17,85,84,27,238,不合格
20192816,27,76,92,70,61,326,合格
20192817,78,95,93,8,71,345,合格
20192818,18,62,30,65,43,218,不合格
20192819,29,64,43,54,11,201,不合格
20192820,33,44,33,65,13,188,不合格
20192821,2,37,75,47,23,184,不合格
20192822,41,19,35,1,31,127,不合格
20192823,35,32,83,13,84,247,不合格
20192824,77,51,90,17,91,326,合格
20192825,64,29,32,13,12,150,不合格
20192826,16,90,30,40,58,234,不合格
20192827,2,82,6,47,61,198,不合格
20192828,87,79,92,40,46,344,合格
20192829,33,79,96,70,74,352,合格
20192830,2,48,63,89,19,221,不合格
20192831,57,66,48,34,65,270,不合格
20192832,21,18,93,66,15,213,不合格
20192833,95,55,98,87,74,409,合格
20192834,46,89,1,15,25,176,不合格
20192835,60,12,59,19,40,190,不合格
20192836,8,13,62,32,35,150,不合格
20192837,57,54,12,41,83,247,不合格
20192838,3,67,72,82,50,274,不合格
20192839,58,41,24,77,15,215,不合格
20192840,6,11,51,87,23,178,不合格
20192841,71,37,84,70,59,321,合格
20192842,4,31,4,47,81,167,不合格
20192843,10,45,49,30,87,221,不合格
20192844,33,44,18,61,15,171,不合格
20192845,66,47,49,92,62,316,合格
20192846,23,58,2,50,35,168,不合格
20192847,61,7,39,91,25,223,不合格
20192848,0,32,15,4,90,141,不合格
20192849,85,66,14,52,4,221,不合格
20192850,26,9,29,47,37,148,不合格
20192851,61,7,52,8,58,186,不合格
20192852,90,71,52,24,87,324,合格
20192853,69,54,30,78,50,281,不合格
20192854,90,76,41,43,62,312,合格
20192855,46,76,28,82,19,251,不合格
20192856,0,50,3,37,34,124,不合格
20192857,18,11,4,69,98,200,不合格
20192858,70,79,16,31,12,208,不合格
20192859,40,56,46,2,48,192,不合格
20192860,7,18,4,52,6,87,不合格
20192861,48,12,10,0,93,163,不合格
20192862,72,40,67,54,27,260,不合格
20192863,55,48,57,37,89,286,不合格
20192864,74,70,93,83,73,393,合格
20192865,67,89,30,75,4,265,不合格
20192866,69,22,34,80,89,294,不合格
20192867,90,73,84,87,84,418,合格
20192868,59,64,71,24,99,317,合格
20192869,50,60,38,86,88,322,合格
20192870,76,53,29,81,98,337,合格
20192871,6,68,47,31,49,201,不合格
20192872,44,89,85,17,53,288,不合格
20192873,20,71,80,95,77,343,合格
20192874,8,36,93,45,46,228,不合格
20192875,52,86,57,90,75,360,合格
20192876,90,59,9,0,56,214,不合格
20192877,55,25,20,37,21,158,不合格
20192878,6,69,12,28,74,189,不合格
20192879,76,42,49,93,43,303,合格
20192880,69,14,33,62,45,223,不合格
20192881,97,53,51,74,74,349,合格
20192882,99,51,43,93,42,328,合格
20192883,74,70,78,23,46,291,不合格
20192884,6,25,10,3,6,50,不合格
20192885,76,44,63,47,28,258,不合格
20192886,53,58,66,98,1,276,不合格
20192887,60,4,86,27,93,270,不合格
20192888,49,38,86,46,21,240,不合格
20192889,91,20,99,77,62,349,合格
20192890,16,72,66,70,66,290,不合格
20192891,61,59,83,20,45,268,不合格
20192892,66,28,26,9,7,136,不合格
20192893,94,45,21,96,66,322,合格
20192894,42,3,1,25,34,105,不合格
20192895,56,36,5,90,14,201,不合格
20192896,24,74,61,86,33,278,不合格
20192897,8,73,85,54,29,249,不合格
20192898,91,47,23,6,68,235,不合格
20192899,36,4,38,92,96,266,不合格
20192900,1,56,70,6,80,213,不合格
20192901,33,61,47,22,45,208,不合格
20192902,21,52,15,72,88,248,不合格
20192903,27,57,6,35,68,193,不合格
20192904,45,82,54,18,70,269,不合格
20192905,52,69,15,19,16,171,不合格
20192906,62,69,74,49,29,283,不合格
20192907,78,15,14,5,64,176,不合格
20192908,85,80,57,30,94,346,合格
20192909,60,85,15,90,38,288,不合格
20192910,88,16,48,49,33,234,不合格
20192911,63,17,59,42,37,218,不合格
20192912,76,76,73,66,84,375,合格
20192913,83,54,2,30,30,199,不合格
20192914,85,54,14,89,50,292,不合格
20192915,14,24,87,60,94,279,不合格
20192916,64,31,14,70,69,248,不合格
20192917,41,19,7,65,76,208,不合格
20192918,46,51,24,45,87,253,不合格
20192919,58,54,92,70,73,347,合格
20192920,86,35,44,69,38,272,不合格
20192921,41,88,83,55,42,309,合格
20192922,26,12,21,99,30,188,不合格
20192923,79,74,78,65,33,329,合格
20192924,81,99,86,85,5,356,合格
20192925,78,77,40,13,82,290,不合格
20192926,67,52,81,56,31,287,不合格
20192927,2,54,52,59,32,199,不合格
20192928,73,13,97,33,21,237,不合格
20192929,56,81,22,27,53,239,不合格
20192930,70,5,34,69,50,228,不合格
20192931,47,49,20,24,66,206,不合格
20192932,69,71,93,94,67,394,合格
20192933,67,27,25,46,53,218,不合格
20192934,14,59,97,33,85,288,不合格
20192935,93,28,27,15,58,221,不合格
20192936,89,68,42,28,47,274,不合格
20192937,77,86,61,52,67,343,合格
20192938,66,12,53,55,71,257,不合格
20192939,54,46,15,56,61,232,不合格
20192940,78,82,39,92,37,328,合格
20192941,32,94,34,36,39,235,不合格
20192942,62,85,62,92,75,376,合格
20192943,36,31,19,18,9,113,不合格
20192944,58,60,25,45,71,259,不合格
20192945,89,71,87,21,77,345,合格
20192946,71,56,28,35,18,208,不合格
20192947,23,52,64,86,21,246,不合格
20192948,23,1,96,4,3,127,不合格
20192949,74,10,63,41,4,192,不合格
20192950,97,99,45,43,62,346,合格
20192951,8,15,49,79,94,245,不合格
20192952,20,93,95,16,58,282,不合格
20192953,20,22,75,42,26,185,不合格
20192954,73,40,3,71,8,195,不合格
20192955,57,34,92,85,45,313,合格
20192956,96,78,65,52,89,380,合格
20192957,84,27,30,83,10,234,不合格
20192958,66,22,35,13,82,218,不合格
20192959,72,98,99,29,43,341,合格
20192960,56,39,90,78,13,276,不合格
20192961,81,94,60,7,40,282,不合格
20192962,16,54,4,89,76,239,不合格
20192963,46,51,86,44,64,291,不合格
20192964,67,64,66,88,37,322,合格
20192965,67,95,29,61,20,272,不合格
20192966,42,95,48,14,58,257,不合格
20192967,67,77,37,71,89,341,合格
20192968,24,21,72,92,78,287,不合格
20192969,98,82,26,54,45,305,合格
20192970,90,17,23,3,91,224,不合格
20192971,79,25,79,88,29,300,合格
20192972,65,53,87,14,26,245,不合格
20192973,2,7,85,17,26,137,不合格
20192974,62,93,45,87,72,359,合格
20192975,3,44,57,4,95,203,不合格
20192976,68,34,75,10,15,202,不合格
20192977,85,50,24,45,52,256,不合格
20192978,73,47,49,77,4,250,不合格
20192979,27,0,68,94,35,224,不合格
20192980,53,40,7,97,41,238,不合格
20192981,95,96,0,55,3,249,不合格
20192982,72,88,26,86,18,290,不合格
20192983,18,93,58,1,0,170,不合格
20192984,66,72,10,50,90,288,不合格
20192985,75,89,3,39,68,274,不合格
20192986,6,0,79,53,43,181,不合格
20192987,89,8,20,91,55,263,不合格
20192988,11,0,28,26,0,65,不合格
20192989,18,30,6,19,38,111,不合格
20192990,83,78,54,62,95,372,合格
20192991,97,30,75,68,81,351,合格
20192992,5,59,67,5,75,211,不合格
20192993,24,19,83,30,37,193,不合格
20192994,92,90,22,51,79,334,合格
20192995,89,91,96,74,97,447,合格
20192996,23,44,15,4,33,119,不合格
20192997,45,61,16,57,1,180,不合格
20192998,60,60,91,60,78,349,合格
20192999,58,4,68,18,54,202,不合格
20193000,97,7,4,67,34,209,不合格
20193001,93,4,29,48,65,239,不合格
20193002,64,12,30,61,81,248,不合格
20193003,88,97,0,65,46,296,不合格
20193004,82,56,66,91,80,375,合格
20193005,75,89,67,5,60,296,不合格
20193006,92,17,60,82,45,296,不合格
20193007,88,41,47,36,47,259,不合格
20193008,18,12,37,61,39,167,不合格
20193009,27,73,41,45,93,279,不合格
20193010,40,18,31,64,27,180,不合格
20193011,95,0,40,1,75,211,不合格
20193012,97,27,79,93,41,337,合格
20193013,43,75,4,38,59,219,不合格
20193014,94,43,48,8,14,207,不合格
20193015,78,19,58,61,79,295,不合格
20193016,73,61,64,61,82,341,合格
20193017,37,43,33,6,56,175,不合格
20193018,23,53,30,31,43,180,不合格
20193019,28,13,86,97,87,311,合格
20193020,28,10,52,44,38,172,不合格
20193021,82,85,29,22,20,238,不合格
20193022,46,25,78,49,70,268,不合格
20193023,3,71,41,20,74,209,不合格
20193024,38,46,28,81,18,211,不合格
20193025,84,4,30,32,38,188,不合格
20193026,30,8,56,72,0,166,不合格
20193027,15,20,81,13,72,201,不合格
20193028,2,63,35,34,94,228,不合格
20193029,47,46,92,72,0,257,不合格
20193030,40,45,30,90,75,280,不合格
20193031,32,20,65,71,10,198,不合格
20193032,97,83,37,46,22,285,不合格
20193033,37,80,14,42,59,232,不合格
20193034,16,72,71,37,48,244,不合格
20193035,71,31,95,36,10,243,不合格
20193036,26,65,18,48,30,187,不合格
20193037,42,32,65,21,34,194,不合格
20193038,65,4,26,81,27,203,不合格
20193039,85,89,95,7,10,286,不合格
20193040,91,45,85,97,45,363,合格
20193041,10,86,2,46,87,231,不合格
20193042,56,34,8,88,67,253,不合格
20193043,61,14,62,84,42,263,不合格
20193044,83,60,40,50,6,239,不合格
20193045,94,20,62,33,57,266,不合格
20193046,85,79,73,29,52,318,合格
20193047,10,57,82,15,41,205,不合格
20193048,65,70,70,77,85,367,合格
20193049,2,43,33,64,93,235,不合格
20193050,1,14,84,50,42,191,不合格
20193051,2,24,78,52,32,188,不合格
20193052,86,72,16,51,29,254,不合格
20193053,39,91,44,97,50,321,合格
20193054,69,19,77,4,96,265,不合格
20193055,68,66,84,82,16,316,合格
20193056,72,98,0,89,10,269,不合格
20193057,65,80,74,74,22,315,合格
20193058,24,80,86,16,39,245,不合格
20193059,42,61,40,87,99,329,合格
20193060,0,52,47,9,20,128,不合格
20193061,71,93,29,69,82,344,合格
20193062,1,48,71,93,57,270,不合格
20193063,74,89,10,54,97,324,合格
20193064,82,30,23,71,40,246,不合格
20193065,8,44,88,74,35,249,不合格
20193066,29,26,98,86,26,265,不合格
20193067,65,50,24,37,71,247,不合格
20193068,95,39,8,58,83,283,不合格
20193069,56,84,27,97,84,348,合格
20193070,53,41,22,35,85,236,不合格
20193071,35,44,92,15,81,267,不合格
20193072,77,4,43,11,7,142,不合格
20193073,71,48,37,92,75,323,合格
20193074,39,68,26,71,96,300,合格
20193075,86,34,25,19,2,166,不合格
20193076,42,66,92,84,89,373,合格
20193077,1,73,31,45,16,166,不合格
20193078,63,50,92,10,74,289,不合格
20193079,47,85,51,75,70,328,合格
20193080,47,58,14,86,21,226,不合格
20193081,71,74,33,85,74,337,合格
20193082,29,57,38,76,54,254,不合格
20193083,95,67,28,19,44,253,不合格
20193084,30,14,29,69,20,162,不合格
20193085,40,38,87,57,17,239,不合格
20193086,24,71,67,48,85,295,不合格
20193087,45,77,84,49,44,299,不合格
20193088,74,24,26,67,25,216,不合格
20193089,56,25,78,37,83,279,不合格
20193090,17,78,29,91,51,266,不合格
20193091,31,73,20,13,92,229,不合格
20193092,83,77,47,6,96,309,合格
20193093,1,2,8,50,15,76,不合格
20193094,50,36,3,14,58,161,不合格
20193095,5,89,4,5,84,187,不合格
20193096,12,82,13,89,89,285,不合格
20193097,64,53,89,87,3,296,不合格
20193098,61,38,27,93,49,268,不合格
20193099,64,60,28,98,99,349,合格
20193100,34,2,13,49,40,138,不合格
20193101,56,26,30,9,98,219,不合格
20193102,88,75,51,43,93,350,合格
20193103,1,97,77,26,28,229,不合格
20193104,49,28,8,90,13,188,不合格
20193105,42,93,54,90,87,366,合格
20193106,93,41,14,65,60,273,不合格
20193107,53,85,94,90,68,390,合格
20193108,31,71,75,76,22,275,不合格
20193109,78,83,88,76,20,345,合格
20193110,74,16,47,94,59,290,不合格
20193111,26,58,21,27,57,189,不合格
20193112,1,89,61,16,36,203,不合格
20193113,15,38,10,14,89,166,不合格
20193114,21,82,97,62,69,331,合格
20193115,47,91,15,21,59,233,不合格
20193116,49,59,41,44,5,198,不合格
20193117,93,33,1,35,62,224,不合格
20193118,12,93,8,72,85,270,不合格
20193119,93,21,63,38,37,252,不合格
20193120,88,76,5,67,61,297,不合格
20193121,72,52,83,70,11,288,不合格
20193122,46,27,45,79,95,292,不合格
20193123,63,76,99,43,67,348,合格
20193124,42,88,70,59,20,279,不合格
20193125,87,84,49,43,77,340,合格
20193126,96,50,31,19,74,270,不合格
20193127,76,13,97,33,43,262,不合格
20193128,2,13,98,19,57,189,不合格
20193129,91,85,60,37,96,369,合格
20193130,23,59,5,63,3,153,不合格
20193131,70,41,89,52,48,300,合格
20193132,14,23,80,45,2,164,不合格
20193133,92,52,99,80,92,415,合格
20193134,8,16,6,77,89,196,不合格
20193135,75,0,65,3,45,188,不合格
20193136,25,24,27,92,51,219,不合格
20193137,66,0,36,22,76,200,不合格
20193138,20,85,48,84,88,325,合格
20193139,9,69,24,76,65,243,不合格
20193140,5,38,1,59,51,154,不合格
20193141,4,23,25,55,72,179,不合格
20193142,70,64,41,53,35,263,不合格
20193143,2,50,21,8,2,83,不合格
20193144,2,41,16,33,51,143,不合格
20193145,90,17,14,23,77,221,不合格
20193146,92,77,87,75,8,339,合格
20193147,16,80,86,12,22,216,不合格
20193148,82,51,63,52,74,322,合格
20193149,46,91,74,3,55,269,不合格
20193150,85,92,13,59,98,347,合格
20193151,6,69,10,67,22,174,不合格
20193152,27,52,64,41,27,211,不合格
20193153,83,49,87,64,27,310,合格
20193154,66,26,83,31,15,221,不合格
20193155,76,78,43,43,93,333,合格
20193156,43,55,58,30,72,258,不合格
20193157,89,70,93,84,18,354,合格
20193158,33,68,68,31,77,277,不合格
20193159,66,45,80,77,76,344,合格
20193160,68,66,45,27,64,270,不合格
20193161,41,59,29,3,89,221,不合格
20193162,56,81,59,68,82,346,合格
20193163,10,7,72,55,10,154,不合格
20193164,64,6,98,53,47,268,不合格
20193165,15,89,52,95,76,327,合格
20193166,97,1,22,3,71,194,不合格
20193167,13,80,36,72,90,291,不合格
20193168,97,45,39,31,26,238,不合格
20193169,57,85,37,97,43,319,合格
20193170,31,53,61,84,26,255,不合格
20193171,82,23,8,89,51,253,不合格
20193172,87,91,42,4,6,230,不合格
20193173,85,76,42,96,37,336,合格
20193174,67,45,91,67,42,312,合格
20193175,62,2,49,37,84,234,不合格
20193176,4,98,67,26,8,203,不合格
20193177,26,14,9,81,27,157,不合格
20193178,26,74,67,91,98,356,合格
20193179,42,40,95,77,94,348,合格
20193180,45,52,11,35,8,151,不合格
20193181,45,39,9,34,99,226,不合格
20193182,9,47,44,79,21,200,不合格
20193183,4,80,69,79,22,254,不合格
20193184,59,99,60,25,33,276,不合格
20193185,41,55,29,48,48,221,不合格
20193186,12,42,94,91,51,290,不合格
20193187,79,14,59,98,83,333,合格
20193188,4,73,52,62,32,223,不合格
20193189,77,13,97,98,53,338,合格
20193190,74,70,32,34,48,258,不合格
20193191,46,78,94,28,49,295,不合格
20193192,92,26,61,63,72,314,合格
20193193,8,64,65,41,68,246,不合格
20193194,20,27,8,65,17,137,不合格
20193195,90,93,60,64,27,334,合格
20193196,13,9,35,59,20,136,不合格
20193197,65,30,97,57,45,294,不合格
20193198,53,43,83,73,6,258,不合格
20193199,78,83,36,39,46,282,不合格
20193200,29,25,95,77,38,264,不合格
20193201,11,1,28,80,1,121,不合格
20193202,43,99,67,6,21,236,不合格
20193203,74,90,24,52,65,305,合格
20193204,15,7,61,31,29,143,不合格
20193205,80,5,20,67,92,264,不合格
20193206,46,16,40,54,75,231,不合格
20193207,31,39,82,78,22,252,不合格
20193208,73,51,79,40,28,271,不合格
20193209,17,55,53,66,40,231,不合格
20193210,70,21,73,48,12,224,不合格
20193211,81,98,51,48,19,297,不合格
20193212,46,44,78,77,57,302,合格
20193213,41,64,2,10,65,182,不合格
20193214,63,63,59,87,73,345,合格
20193215,99,14,78,86,30,307,合格
20193216,13,23,34,15,79,164,不合格
20193217,29,65,51,94,85,324,合格
20193218,97,98,25,49,16,285,不合格
20193219,39,28,79,45,54,245,不合格
20193220,14,76,82,36,17,225,不合格
20193221,31,5,72,99,60,267,不合格
20193222,60,43,53,57,42,255,不合格
20193223,95,51,6,57,40,249,不合格
20193224,56,94,59,63,28,300,合格
20193225,74,68,49,50,74,315,合格
20193226,97,64,8,75,5,249,不合格
20193227,65,29,30,57,20,201,不合格
20193228,65,48,75,59,12,259,不合格
20193229,13,11,83,28,26,161,不合格
20193230,65,86,78,83,10,322,合格
20193231,44,29,63,5,28,169,不合格
20193232,99,89,5,61,93,347,合格
20193233,30,82,99,36,36,283,不合格
20193234,66,84,13,64,37,264,不合格
20193235,42,36,47,1,63,189,不合格
20193236,9,84,37,15,1,146,不合格
20193237,89,97,60,84,91,421,合格
20193238,81,52,26,45,72,276,不合格
20193239,47,49,42,23,33,194,不合格
20193240,91,77,2,18,2,190,不合格
20193241,82,70,96,2,35,285,不合格
20193242,24,81,21,15,6,147,不合格
20193243,98,19,13,65,79,274,不合格
20193244,2,62,92,94,28,278,不合格
20193245,7,0,20,34,28,89,不合格
20193246,4,37,24,75,11,151,不合格
20193247,52,70,26,38,58,244,不合格
20193248,99,16,93,74,21,303,合格
20193249,69,72,90,67,73,371,合格
20193250,6,5,42,17,91,161,不合格
20193251,75,27,70,15,97,284,不合格
20193252,24,77,93,61,60,315,合格
20193253,82,48,28,83,39,280,不合格
20193254,46,18,48,36,47,195,不合格
20193255,86,82,43,1,90,302,合格
20193256,65,26,60,28,64,243,不合格
20193257,13,79,75,54,4,225,不合格
20193258,31,34,56,14,85,220,不合格
20193259,81,90,67,84,5,327,合格
20193260,50,34,30,51,9,174,不合格
20193261,46,61,30,13,42,192,不合格
20193262,95,84,44,95,12,330,合格
20193263,47,15,1,31,43,137,不合格
20193264,42,7,1,38,84,172,不合格
20193265,3,58,84,75,67,287,不合格
20193266,65,35,37,12,5,154,不合格
20193267,45,23,73,56,21,218,不合格
20193268,37,84,38,35,23,217,不合格
20193269,30,34,31,26,54,175,不合格
20193270,42,10,52,85,1,190,不合格
20193271,97,43,97,74,77,388,合格
20193272,17,56,98,2,11,184,不合格
20193273,26,16,6,34,66,148,不合格
20193274,46,58,22,19,77,222,不合格
20193275,69,81,46,3,46,245,不合格
20193276,40,57,55,16,91,259,不合格
20193277,67,9,66,0,49,191,不合格
20193278,35,25,30,69,66,225,不合格
20193279,19,84,18,97,88,306,合格
20193280,85,40,66,37,15,243,不合格
20193281,26,84,99,46,77,332,合格
20193282,36,41,79,11,71,238,不合格
20193283,31,75,75,54,86,321,合格
20193284,62,97,38,16,40,253,不合格
20193285,84,37,30,8,86,245,不合格
20193286,99,94,77,88,59,417,合格
20193287,89,8,24,74,27,222,不合格
20193288,97,31,51,59,30,268,不合格
20193289,8,42,48,34,92,224,不合格
20193290,22,20,0,52,54,148,不合格
20193291,48,97,98,44,35,322,合格
20193292,21,83,70,49,9,232,不合格
20193293,75,25,64,56,91,311,合格
20193294,62,84,71,72,1,290,不合格
20193295,54,90,19,17,19,199,不合格
20193296,36,33,96,41,51,257,不合格
20193297,93,43,89,54,15,294,不合格
20193298,25,7,39,88,37,196,不合格
20193299,12,95,42,68,67,284,不合格
20193300,61,47,52,88,79,327,合格
20193301,2,37,30,92,56,217,不合格
20193302,90,58,54,71,72,345,合格
20193303,46,76,48,51,1,222,不合格
20193304,64,34,24,61,13,196,不合格
20193305,98,26,33,24,7,188,不合格
20193306,32,67,90,94,99,382,合格
20193307,23,89,66,24,60,262,不合格
20193308,19,56,24,89,43,231,不合格
20193309,21,95,59,35,62,272,不合格
20193310,40,17,38,45,0,140,不合格
20193311,49,59,46,85,71,310,合格
20193312,35,62,76,6,95,274,不合格
20193313,88,39,19,55,88,289,不合格
20193314,70,29,14,64,18,195,不合格
20193315,15,16,94,25,71,221,不合格
20193316,20,92,38,16,0,166,不合格
20193317,58,17,38,68,98,279,不合格
20193318,19,40,68,96,8,231,不合格
20193319,4,7,14,52,60,137,不合格
20193320,37,38,71,2,17,165,不合格
20193321,66,70,36,51,43,266,不合格
20193322,43,98,9,69,29,248,不合格
20193323,94,91,86,93,21,385,合格
20193324,30,53,17,54,62,216,不合格
20193325,7,22,17,6,18,70,不合格
20193326,87,61,35,98,34,315,合格
20193327,97,20,3,80,18,218,不合格
20193328,80,18,89,70,35,292,不合格
20193329,58,29,16,80,86,269,不合格
20193330,60,28,34,67,27,216,不合格
20193331,9,66,66,53,36,230,不合格
20193332,45,78,8,59,71,261,不合格
20193333,55,69,18,82,53,277,不合格
20193334,28,6,19,70,12,135,不合格
20193335,34,2,6,90,88,220,不合格
20193336,71,48,56,61,42,278,不合格
20193337,95,39,78,37,15,264,不合格
20193338,99,92,85,56,70,402,合格
20193339,97,77,52,2,4,232,不合格
20193340,91,21,17,24,94,247,不合格
20193341,71,36,51,61,73,292,不合格
20193342,16,95,78,36,5,230,不合格
20193343,88,13,49,45,89,284,不合格
20193344,59,84,60,38,35,276,不合格
20193345,6,29,36,71,9,151,不合格
20193346,62,44,1,90,39,236,不合格
20193347,8,53,22,41,41,165,不合格
20193348,48,13,54,47,80,242,不合格
20193349,62,30,52,17,18,179,不合格
20193350,46,36,52,28,49,211,不合格
20193351,15,1,86,60,68,230,不合格
20193352,24,0,64,4,65,157,不合格
20193353,51,51,74,90,46,312,合格
20193354,95,76,69,25,48,313,合格
20193355,43,3,80,50,74,250,不合格
20193356,87,89,76,89,9,350,合格
20193357,21,81,25,26,45,198,不合格
20193358,51,51,4,23,34,163,不合格
20193359,98,70,54,87,93,402,合格
20193360,89,11,0,20,74,194,不合格
20193361,88,51,42,30,84,295,不合格
20193362,10,29,13,60,16,128,不合格
20193363,19,7,55,47,81,209,不合格
20193364,5,20,6,88,5,124,不合格
20193365,73,6,52,37,60,228,不合格
20193366,95,83,72,71,84,405,合格
20193367,87,28,9,21,62,207,不合格
20193368,38,26,88,59,43,254,不合格
20193369,46,83,99,58,95,381,合格
20193370,77,12,7,45,1,142,不合格
20193371,38,19,95,25,41,218,不合格
20193372,54,86,70,64,54,328,合格
20193373,84,43,97,0,65,289,不合格
20193374,31,30,1,96,32,190,不合格
20193375,77,77,70,72,22,318,合格
20193376,96,68,48,6,63,281,不合格
20193377,45,84,64,68,98,359,合格
20193378,94,21,7,54,5,181,不合格
20193379,19,21,66,61,29,196,不合格
20193380,10,28,13,89,71,211,不合格
20193381,52,61,89,45,33,280,不合格
20193382,23,49,97,10,78,257,不合格
20193383,12,5,1,7,86,111,不合格
20193384,24,0,11,17,56,108,不合格
20193385,61,12,41,56,79,249,不合格
20193386,46,14,71,38,32,201,不合格
20193387,25,71,69,81,17,263,不合格
20193388,51,20,24,50,91,236,不合格
20193389,25,55,14,59,60,213,不合格
20193390,72,49,12,40,20,193,不合格
20193391,10,65,92,13,45,225,不合格
20193392,90,21,59,41,88,299,不合格
20193393,71,5,36,83,73,268,不合格
20193394,2,22,27,23,60,134,不合格
20193395,93,65,52,83,32,325,合格
20193396,51,47,44,90,1,233,不合格
20193397,54,27,93,78,43,295,不合格
20193398,42,54,80,97,61,334,合格
20193399,48,36,67,59,16,226,不合格
20193400,35,48,93,98,78,352,合格
20193401,49,60,62,68,73,312,合格
20193402,99,80,20,62,65,326,合格
20193403,40,30,40,85,66,261,不合格
20193404,44,21,49,30,76,220,不合格
20193405,23,89,81,0,11,204,不合格
20193406,86,49,13,35,31,214,不合格
20193407,22,23,30,30,45,150,不合格
20193408,50,85,8,83,10,236,不合格
20193409,14,61,72,53,34,234,不合格
20193410,69,26,73,45,90,303,合格
20193411,99,1,12,70,86,268,不合格
20193412,86,36,74,14,58,268,不合格
20193413,1,7,48,99,50,205,不合格
20193414,1,94,57,62,79,293,不合格
20193415,86,48,7,71,13,225,不合格
20193416,89,98,0,30,38,255,不合格
20193417,60,42,9,54,61,226,不合格
20193418,85,25,63,94,53,320,合格
20193419,43,59,21,83,41,247,不合格
20193420,62,49,59,41,15,226,不合格
20193421,44,43,19,61,6,173,不合格
20193422,34,40,69,3,78,224,不合格
20193423,61,81,33,70,3,248,不合格
20193424,27,94,96,29,85,331,合格
20193425,48,5,52,69,98,272,不合格
20193426,89,97,91,93,24,394,合格
20193427,44,99,53,32,46,274,不合格
20193428,36,23,77,79,3,218,不合格
20193429,78,76,34,68,50,306,合格
20193430,48,78,39,86,47,298,不合格
20193431,38,86,76,34,59,293,不合格
20193432,13,52,59,81,29,234,不合格
20193433,52,27,12,51,83,225,不合格
20193434,32,35,96,61,55,279,不合格
20193435,42,52,80,81,80,335,合格
20193436,40,44,41,85,28,238,不合格
20193437,39,32,22,15,27,135,不合格
20193438,33,49,71,12,10,175,不合格
20193439,64,74,15,25,12,190,不合格
20193440,17,93,81,93,90,374,合格
20193441,27,26,7,13,71,144,不合格
20193442,36,95,61,34,17,243,不合格
20193443,92,56,27,28,84,287,不合格
20193444,73,86,49,11,64,283,不合格
20193445,48,15,22,16,67,168,不合格
20193446,71,95,61,39,22,288,不合格
20193447,22,11,47,42,71,193,不合格
20193448,18,18,8,18,9,71,不合格
20193449,93,77,82,83,76,411,合格
20193450,40,90,25,0,7,162,不合格
20193451,60,39,52,32,34,217,不合格
20193452,20,11,79,31,93,234,不合格
20193453,13,49,76,54,79,271,不合格
20193454,53,80,90,55,87,365,合格
20193455,73,15,73,47,45,253,不合格
20193456,56,59,85,49,31,280,不合格
20193457,5,4,62,95,76,242,不合格
20193458,48,28,67,7,62,212,不合格
20193459,20,4,0,95,33,152,不合格
20193460,36,69,21,27,57,210,不合格
20193461,72,71,86,30,81,340,合格
20193462,11,11,88,13,78,201,不合格
20193463,71,81,90,23,32,297,不合格
20193464,95,98,53,54,38,338,合格
20193465,1,8,97,47,0,153,不合格
20193466,53,59,38,41,33,224,不合格
20193467,31,58,96,56,89,330,合格
20193468,19,80,59,48,50,256,不合格
20193469,84,21,49,79,84,317,合格
20193470,15,81,35,60,11,202,不合格
20193471,6,87,5,20,79,197,不合格
20193472,7,93,40,1,33,174,不合格
20193473,16,94,24,72,40,246,不合格
20193474,92,98,7,22,34,253,不合格
20193475,51,56,92,33,16,248,不合格
20193476,64,86,39,42,20,251,不合格
20193477,11,27,16,73,34,161,不合格
20193478,49,19,71,37,79,255,不合格
20193479,73,84,10,4,56,227,不合格
20193480,87,77,36,32,49,281,不合格
20193481,13,80,80,73,82,328,合格
20193482,59,99,91,55,29,333,合格
20193483,90,86,13,32,18,239,不合格
20193484,67,1,98,20,19,205,不合格
20193485,29,97,49,47,82,304,合格
20193486,95,61,17,30,57,260,不合格
20193487,79,17,4,14,78,192,不合格
20193488,93,56,45,5,26,225,不合格
20193489,48,62,78,57,34,279,不合格
20193490,77,60,4,16,33,190,不合格
20193491,6,63,96,54,56,275,不合格
20193492,71,12,49,93,91,316,合格
20193493,83,48,91,64,39,325,合格
20193494,87,79,26,40,26,258,不合格
20193495,27,52,15,30,80,204,不合格
20193496,25,6,8,62,13,114,不合格
20193497,19,38,61,27,37,182,不合格
20193498,38,79,15,26,10,168,不合格
20193499,10,31,34,43,27,145,不合格
20193500,25,49,88,98,37,297,不合格
20193501,82,92,12,32,10,228,不合格
20193502,89,5,48,77,18,237,不合格
20193503,31,65,93,23,52,264,不合格
20193504,79,50,81,32,1,243,不合格
20193505,3,36,45,27,46,157,不合格
20193506,33,34,39,23,69,198,不合格
20193507,80,46,90,63,84,363,合格
20193508,13,7,95,47,59,221,不合格
20193509,49,49,18,7,88,211,不合格
20193510,61,30,34,28,42,195,不合格
20193511,46,35,62,35,7,185,不合格
20193512,71,20,37,23,23,174,不合格
20193513,36,66,93,21,63,279,不合格
20193514,15,62,81,63,83,304,合格
20193515,59,29,69,99,18,274,不合格
20193516,54,14,84,48,74,274,不合格
20193517,20,42,6,18,5,91,不合格
20193518,75,30,96,64,4,269,不合格
20193519,95,3,52,95,72,317,合格
20193520,79,45,61,43,17,245,不合格
20193521,33,68,84,9,9,203,不合格
20193522,30,83,49,22,64,248,不合格
20193523,59,23,75,44,11,212,不合格
20193524,53,47,24,99,97,320,合格
20193525,18,46,48,37,1,150,不合格
20193526,7,12,33,83,97,232,不合格
20193527,51,22,71,94,96,334,合格
20193528,74,22,87,25,33,241,不合格
20193529,19,7,58,50,47,181,不合格
20193530,38,54,37,39,15,183,不合格
20193531,44,1,5,12,89,151,不合格
20193532,72,80,33,90,68,343,合格
20193533,3,34,25,44,70,176,不合格
20193534,41,52,23,69,16,201,不合格
20193535,57,73,10,23,48,211,不合格
20193536,87,95,95,54,13,344,合格
20193537,24,48,91,93,95,351,合格
20193538,87,46,60,13,32,238,不合格
20193539,21,65,94,78,17,275,不合格
20193540,99,87,64,96,15,361,合格
20193541,40,30,87,80,63,300,合格
20193542,37,41,41,15,35,169,不合格
20193543,22,0,5,12,10,49,不合格
20193544,85,2,76,26,5,194,不合格
20193545,70,3,83,19,41,216,不合格
20193546,99,61,99,36,97,392,合格
20193547,19,40,55,46,92,252,不合格
20193548,42,70,72,14,26,224,不合格
20193549,31,96,40,25,43,235,不合格
20193550,26,47,42,42,48,205,不合格
20193551,93,59,8,37,76,273,不合格
20193552,57,83,12,92,16,260,不合格
20193553,92,83,92,10,24,301,合格
20193554,84,65,0,48,27,224,不合格
20193555,98,19,68,74,90,349,合格
20193556,42,79,45,94,36,296,不合格
20193557,85,80,71,99,86,421,合格
20193558,4,49,12,68,80,213,不合格
20193559,37,55,38,6,79,215,不合格
20193560,94,60,82,30,17,283,不合格
20193561,6,35,14,72,83,210,不合格
20193562,31,19,9,15,84,158,不合格
20193563,40,70,8,25,42,185,不合格
20193564,71,78,29,67,90,335,合格
20193565,35,87,23,3,6,154,不合格
20193566,15,65,40,80,77,277,不合格
20193567,45,63,54,24,63,249,不合格
20193568,5,97,68,48,69,287,不合格
20193569,43,80,49,34,32,238,不合格
20193570,75,82,46,74,0,277,不合格
20193571,87,3,22,1,62,175,不合格
20193572,48,61,27,15,20,171,不合格
20193573,32,36,72,96,82,318,合格
20193574,98,83,93,81,51,406,合格
20193575,37,12,35,23,16,123,不合格
20193576,78,57,32,41,32,240,不合格
20193577,95,79,55,52,83,364,合格
20193578,22,30,60,91,97,300,合格
20193579,90,77,16,78,53,314,合格
20193580,26,21,77,43,83,250,不合格
20193581,56,25,80,53,56,270,不合格
20193582,87,82,88,81,78,416,合格
20193583,5,77,98,18,48,246,不合格
20193584,69,26,14,68,72,249,不合格
20193585,59,90,98,53,74,374,合格
20193586,8,30,48,11,64,161,不合格
20193587,43,4,83,20,5,155,不合格
20193588,18,72,99,41,58,288,不合格
20193589,96,24,32,6,39,197,不合格
20193590,98,35,9,2,38,182,不合格
20193591,37,64,81,25,80,287,不合格
20193592,49,73,86,6,85,299,不合格
20193593,2,7,72,14,66,161,不合格
20193594,97,68,63,92,3,323,合格
20193595,61,30,99,92,14,296,不合格
20193596,24,51,45,5,31,156,不合格
20193597,13,62,56,67,76,274,不合格
20193598,16,7,12,13,46,94,不合格
20193599,21,55,96,66,49,287,不合格
20193600,36,5,23,8,49,121,不合格
20193601,75,77,24,77,11,264,不合格
20193602,32,59,95,87,32,305,合格
20193603,23,70,60,57,10,220,不合格
20193604,91,7,36,9,78,221,不合格
20193605,92,32,77,58,34,293,不合格
20193606,90,3,65,53,84,295,不合格
20193607,93,90,28,51,15,277,不合格
20193608,63,68,63,73,98,365,合格
20193609,61,83,24,87,30,285,不合格
20193610,35,21,20,78,65,219,不合格
20193611,72,93,72,71,49,357,合格
20193612,9,84,24,78,99,294,不合格
20193613,21,61,95,57,71,305,合格
20193614,70,88,74,65,98,395,合格
20193615,86,55,96,6,27,270,不合格
20193616,69,31,54,63,73,290,不合格
20193617,31,41,42,32,3,149,不合格
20193618,91,11,75,10,77,264,不合格
20193619,76,59,55,10,75,275,不合格
20193620,77,55,40,56,98,326,合格
20193621,11,77,85,56,87,316,合格
20193622,52,96,1,51,51,251,不合格
20193623,20,2,45,5,42,114,不合格
20193624,35,22,15,61,96,229,不合格
20193625,51,64,34,57,6,212,不合格
20193626,5,0,24,17,14,60,不合格
20193627,61,20,78,59,18,236,不合格
20193628,64,98,92,29,91,374,合格
20193629,88,52,11,5,76,232,不合格
20193630,43,98,84,4,24,253,不合格
20193631,61,80,12,22,29,204,不合格
20193632,14,44,70,60,46,234,不合格
20193633,16,37,36,85,37,211,不合格
20193634,37,75,56,47,81,296,不合格
20193635,78,76,86,23,7,270,不合格
20193636,83,7,31,29,60,210,不合格
20193637,71,2,89,89,33,284,不合格
20193638,33,89,3,41,40,206,不合格
20193639,31,59,44,99,34,267,不合格
20193640,64,99,66,4,85,318,合格
20193641,87,95,91,5,46,324,合格
20193642,81,95,88,34,14,312,合格
20193643,43,65,27,99,5,239,不合格
20193644,86,64,35,20,54,259,不合格
20193645,64,31,75,10,45,225,不合格
20193646,94,79,13,26,13,225,不合格
20193647,16,30,63,29,4,142,不合格
20193648,4,81,51,94,54,284,不合格
20193649,72,42,19,49,66,248,不合格
20193650,73,9,49,29,90,250,不合格
20193651,65,99,75,59,63,361,合格
20193652,13,25,21,44,41,144,不合格
20193653,6,97,92,52,95,342,合格
20193654,91,39,40,54,11,235,不合格
20193655,53,74,86,44,63,320,合格
20193656,6,91,84,94,22,297,不合格
20193657,85,89,42,77,46,339,合格
20193658,44,51,10,79,33,217,不合格
20193659,0,99,99,14,72,284,不合格
20193660,58,79,88,66,47,338,合格
20193661,75,71,4,39,83,272,不合格
20193662,97,92,14,43,88,334,合格
20193663,63,80,43,24,27,237,不合格
20193664,16,68,62,36,28,210,不合格
20193665,81,29,60,38,47,255,不合格
20193666,47,70,63,79,61,320,合格
20193667,2,0,30,36,1,69,不合格
20193668,94,56,89,78,98,415,合格
20193669,59,27,39,78,51,254,不合格
20193670,30,18,22,55,39,164,不合格
20193671,99,46,35,34,75,289,不合格
20193672,51,40,81,47,76,295,不合格
20193673,32,63,99,41,97,332,合格
20193674,2,5,95,19,35,156,不合格
20193675,14,7,31,6,73,131,不合格
20193676,85,94,4,32,48,263,不合格
20193677,25,53,49,52,51,230,不合格
20193678,43,52,15,83,19,212,不合格
20193679,7,56,80,89,18,250,不合格
20193680,19,54,33,50,69,225,不合格
20193681,85,74,30,32,7,228,不合格
20193682,63,30,49,89,66,297,不合格
20193683,27,9,10,90,49,185,不合格
20193684,98,56,32,67,9,262,不合格
20193685,84,35,88,19,59,285,不合格
20193686,65,75,82,14,80,316,合格
20193687,8,60,11,93,23,195,不合格
20193688,39,17,37,62,64,219,不合格
20193689,71,73,42,78,78,342,合格
20193690,70,98,61,87,20,336,合格
20193691,58,48,80,28,66,280,不合格
20193692,47,20,46,94,69,276,不合格
20193693,75,70,55,34,62,296,不合格
20193694,94,33,27,30,93,277,不合格
20193695,23,50,87,48,66,274,不合格
20193696,10,67,81,85,7,250,不合格
20193697,36,64,79,78,16,273,不合格
20193698,84,7,68,55,70,284,不合格
20193699,3,91,4,41,27,166,不合格
20193700,4,88,38,91,45,266,不合格
20193701,58,33,61,53,54,259,不合格
20193702,74,77,93,65,64,373,合格
20193703,86,73,83,85,33,360,合格
20193704,58,56,97,75,63,349,合格
20193705,53,20,22,16,2,113,不合格
20193706,5,9,8,79,32,133,不合格
20193707,91,68,25,31,61,276,不合格
20193708,34,32,60,23,36,185,不合格
20193709,78,79,51,49,78,335,合格
20193710,82,50,0,60,59,251,不合格
20193711,87,2,81,79,96,345,合格
20193712,40,82,73,16,94,305,合格
20193713,3,56,54,90,81,284,不合格
20193714,94,42,52,32,27,247,不合格
20193715,29,49,85,51,21,235,不合格
20193716,43,77,44,11,21,196,不合格
20193717,51,19,43,72,68,253,不合格
20193718,15,50,68,74,26,233,不合格
20193719,49,67,61,70,70,317,合格
20193720,70,76,60,51,80,337,合格
20193721,98,24,24,99,13,258,不合格
20193722,96,20,59,50,37,262,不合格
20193723,11,83,75,95,50,314,合格
20193724,20,20,58,98,97,293,不合格
20193725,98,9,59,8,86,260,不合格
20193726,42,29,74,89,80,314,合格
20193727,19,82,68,39,0,208,不合格
20193728,42,55,38,76,87,298,不合格
20193729,59,76,7,22,85,249,不合格
20193730,6,10,29,9,92,146,不合格
20193731,97,71,68,65,21,322,合格
20193732,44,80,88,3,44,259,不合格
20193733,74,35,67,2,51,229,不合格
20193734,77,6,16,65,78,242,不合格
20193735,94,80,94,94,68,430,合格
20193736,10,3,6,71,37,127,不合格
20193737,76,51,30,39,37,233,不合格
20193738,57,82,28,97,76,340,合格
20193739,10,14,67,68,69,228,不合格
20193740,6,46,84,76,12,224,不合格
20193741,63,54,1,43,26,187,不合格
20193742,86,98,58,35,5,282,不合格
20193743,58,6,73,50,47,234,不合格
20193744,62,10,72,14,63,221,不合格
20193745,72,64,28,82,31,277,不合格
20193746,48,88,48,95,59,338,合格
20193747,33,57,49,71,56,266,不合格
20193748,4,39,22,80,8,153,不合格
20193749,65,69,58,78,13,283,不合格
20193750,74,53,27,10,6,170,不合格
20193751,72,92,78,12,85,339,合格
20193752,31,45,93,80,1,250,不合格
20193753,98,65,38,53,17,271,不合格
20193754,18,57,9,55,73,212,不合格
20193755,70,43,43,76,7,239,不合格
20193756,98,58,78,56,68,358,合格
20193757,7,95,96,37,3,238,不合格
20193758,39,54,48,25,29,195,不合格
20193759,80,45,80,53,88,346,合格
20193760,73,81,48,6,17,225,不合格
20193761,51,7,88,49,38,233,不合格
20193762,43,92,47,32,40,254,不合格
20193763,19,58,26,87,53,243,不合格
20193764,67,68,93,70,0,298,不合格
20193765,69,4,70,84,36,263,不合格
20193766,37,23,16,23,83,182,不合格
20193767,94,68,59,41,41,303,合格
20193768,5,8,65,13,46,137,不合格
20193769,48,33,27,7,98,213,不合格
20193770,89,40,58,2,36,225,不合格
20193771,47,24,54,69,44,238,不合格
20193772,70,63,86,18,23,260,不合格
20193773,14,76,76,65,32,263,不合格
20193774,81,42,69,48,1,241,不合格
20193775,66,7,66,18,48,205,不合格
20193776,80,0,41,57,93,271,不合格
20193777,97,50,11,74,91,323,合格
20193778,15,15,3,40,60,133,不合格
20193779,70,98,59,17,48,292,不合格
20193780,68,34,98,24,23,247,不合格
20193781,65,58,1,31,2,157,不合格
20193782,99,80,63,71,18,331,合格
20193783,82,76,14,78,31,281,不合格
20193784,3,5,25,55,70,158,不合格
20193785,85,1,50,98,19,253,不合格
20193786,91,46,0,87,97,321,合格
20193787,43,77,82,8,7,217,不合格
20193788,51,84,9,74,51,269,不合格
20193789,20,6,17,62,3,108,不合格
20193790,66,78,15,81,66,306,合格
20193791,94,12,23,33,49,211,不合格
20193792,65,75,72,75,54,341,合格
20193793,74,94,50,35,27,280,不合格
20193794,61,21,14,98,53,247,不合格
20193795,14,1,79,85,27,206,不合格
20193796,10,25,2,91,50,178,不合格
20193797,96,5,79,82,84,346,合格
20193798,62,54,20,3,64,203,不合格
20193799,29,13,95,72,89,298,不合格
20193800,88,13,14,2,10,127,不合格
20193801,85,23,1,60,50,219,不合格
20193802,11,49,58,95,49,262,不合格
20193803,2,6,38,84,57,187,不合格
20193804,63,46,68,22,14,213,不合格
20193805,87,13,58,15,53,226,不合格
20193806,29,53,63,18,37,200,不合格
20193807,9,50,96,0,59,214,不合格
20193808,32,7,35,35,67,176,不合格
20193809,55,71,5,52,59,242,不合格
20193810,89,21,49,78,80,317,合格
20193811,81,15,83,0,30,209,不合格
20193812,35,87,70,18,91,301,合格
20193813,69,19,70,42,62,262,不合格
20193814,9,45,27,0,69,150,不合格
20193815,2,79,23,25,42,171,不合格
20193816,14,47,21,52,56,190,不合格
20193817,17,28,77,52,71,245,不合格
20193818,99,63,13,94,83,352,合格
20193819,63,21,75,29,79,267,不合格
20193820,2,47,3,85,34,171,不合格
20193821,49,50,87,15,67,268,不合格
20193822,91,55,83,93,18,340,合格
20193823,76,17,37,34,97,261,不合格
20193824,35,75,0,18,41,169,不合格
20193825,17,41,50,81,46,235,不合格
20193826,87,6,74,38,5,210,不合格
20193827,88,95,90,68,10,351,合格
20193828,58,87,76,4,77,302,合格
20193829,61,89,43,81,3,277,不合格
20193830,42,70,77,38,87,314,合格
20193831,35,93,49,0,63,240,不合格
20193832,68,47,46,1,32,194,不合格
20193833,68,75,10,91,79,323,合格
20193834,10,6,8,98,62,184,不合格
20193835,11,43,19,57,7,137,不合格
20193836,44,45,85,78,35,287,不合格
20193837,53,0,82,47,94,276,不合格
20193838,46,54,35,16,51,202,不合格
20193839,56,14,41,43,54,208,不合格
20193840,94,63,38,33,9,237,不合格
20193841,37,98,18,76,71,300,合格
20193842,78,33,59,90,19,279,不合格
20193843,96,65,26,60,26,273,不合格
20193844,61,36,18,50,97,262,不合格
20193845,72,97,7,38,51,265,不合格
20193846,45,66,57,76,20,264,不合格
20193847,44,14,61,58,32,209,不合格
20193848,49,90,28,44,54,265,不合格
20193849,68,5,24,55,18,170,不合格
20193850,24,3,38,30,21,116,不合格
20193851,34,45,48,48,27,202,不合格
20193852,6,37,13,59,19,134,不合格
20193853,3,27,10,58,40,138,不合格
20193854,12,12,75,15,32,146,不合格
20193855,37,80,75,39,87,318,合格
20193856,72,59,58,69,15,273,不合格
20193857,24,36,37,35,51,183,不合格
20193858,66,99,67,41,38,311,合格
20193859,17,31,11,41,96,196,不合格
20193860,0,50,10,92,26,178,不合格
20193861,86,62,40,15,65,268,不合格
20193862,62,14,83,3,56,218,不合格
20193863,30,20,28,33,87,198,不合格
20193864,19,7,52,54,56,188,不合格
20193865,26,26,83,82,31,248,不合格
20193866,28,58,36,10,69,201,不合格
20193867,6,34,91,36,70,237,不合格
20193868,16,38,65,68,77,264,不合格
20193869,36,19,98,64,76,293,不合格
20193870,75,86,81,23,44,309,合格
20193871,22,81,84,44,45,276,不合格
20193872,34,19,10,11,64,138,不合格
20193873,69,34,67,71,31,272,不合格
20193874,62,97,82,25,1,267,不合格
20193875,18,7,37,8,68,138,不合格
20193876,61,67,42,91,32,293,不合格
20193877,33,7,31,10,97,178,不合格
20193878,77,48,80,55,11,271,不合格
20193879,3,59,80,27,20,189,不合格
20193880,73,27,28,67,30,225,不合格
20193881,67,23,70,94,24,278,不合格
20193882,78,4,9,51,48,190,不合格
20193883,10,50,92,81,87,320,合格
20193884,2,79,17,55,11,164,不合格
20193885,29,29,29,84,53,224,不合格
20193886,74,65,80,17,12,248,不合格
20193887,22,98,93,85,35,333,合格
20193888,94,67,25,82,70,338,合格
20193889,92,87,95,4,9,287,不合格
20193890,83,42,69,52,87,333,合格
20193891,56,10,9,8,85,168,不合格
20193892,85,35,87,53,97,357,合格
20193893,90,25,88,3,84,290,不合格
20193894,87,19,96,77,20,299,不合格
20193895,2,24,63,88,52,229,不合格
20193896,63,67,32,14,7,183,不合格
20193897,76,76,21,48,15,236,不合格
20193898,99,70,36,55,2,262,不合格
20193899,14,58,73,1,12,158,不合格
20193900,57,26,40,33,94,250,不合格
20193901,97,49,67,22,3,238,不合格
20193902,0,72,7,25,76,180,不合格
20193903,91,25,28,2,79,225,不合格
20193904,76,14,3,0,37,130,不合格
20193905,27,29,30,1,82,169,不合格
20193906,18,42,4,64,46,174,不合格
20193907,92,39,89,87,88,395,合格
20193908,78,81,77,35,82,353,合格
20193909,65,24,80,64,97,330,合格
20193910,19,31,27,3,30,110,不合格
20193911,1,59,22,56,28,166,不合格
20193912,8,47,24,13,77,169,不合格
20193913,4,90,26,48,48,216,不合格
20193914,0,26,92,1,60,179,不合格
20193915,80,9,70,57,1,217,不合格
20193916,55,77,34,20,80,266,不合格
20193917,4,43,56,80,45,228,不合格
20193918,68,3,6,89,71,237,不合格
20193919,85,64,91,52,83,375,合格
20193920,32,90,86,9,93,310,合格
20193921,86,52,59,0,39,236,不合格
20193922,46,55,14,9,72,196,不合格
20193923,67,85,23,3,59,237,不合格
20193924,88,79,82,37,54,340,合格
20193925,65,76,92,10,81,324,合格
20193926,89,37,84,16,55,281,不合格
20193927,44,50,72,16,56,238,不合格
20193928,90,30,95,72,18,305,合格
20193929,69,79,12,52,77,289,不合格
20193930,24,78,91,59,63,315,合格
20193931,36,84,96,13,97,326,合格
20193932,86,11,53,79,73,302,合格
20193933,37,81,87,73,18,296,不合格
20193934,51,3,80,84,58,276,不合格
20193935,42,13,97,30,22,204,不合格
20193936,84,20,95,73,34,306,合格
20193937,4,25,57,21,70,177,不合格
20193938,85,27,83,75,19,289,不合格
20193939,77,78,82,57,84,378,合格
20193940,92,40,39,22,68,261,不合格
20193941,11,80,25,62,52,230,不合格
20193942,37,28,93,35,7,200,不合格
20193943,2,78,41,98,15,234,不合格
20193944,12,24,75,39,82,232,不合格
20193945,28,1,6,6,3,44,不合格
20193946,9,63,65,84,31,252,不合格
20193947,0,93,63,89,88,333,合格
20193948,75,46,3,52,71,247,不合格
20193949,17,31,83,45,31,207,不合格
20193950,87,23,24,56,85,275,不合格
20193951,68,25,97,91,51,332,合格
20193952,88,56,87,0,52,283,不合格
20193953,99,57,13,98,30,297,不合格
20193954,85,77,55,76,21,314,合格
20193955,65,2,93,34,80,274,不合格
20193956,8,89,41,18,41,197,不合格
20193957,84,50,6,65,46,251,不合格
20193958,13,78,64,86,44,285,不合格
20193959,64,67,84,36,16,267,不合格
20193960,22,98,90,27,1,238,不合格
20193961,28,88,96,18,82,312,合格
20193962,12,1,77,86,14,190,不合格
20193963,28,15,70,97,46,256,不合格
20193964,20,9,82,59,88,258,不合格
20193965,77,94,59,1,87,318,合格
20193966,94,8,44,68,56,270,不合格
20193967,39,79,38,1,82,239,不合格
20193968,19,2,72,28,87,208,不合格
20193969,72,30,75,91,66,334,合格
20193970,3,60,67,66,35,231,不合格
20193971,80,73,53,28,88,322,合格
20193972,44,89,52,59,65,309,合格
20193973,4,12,38,46,98,198,不合格
20193974,59,98,51,19,58,285,不合格
20193975,67,11,60,58,82,278,不合格
20193976,59,29,71,78,59,296,不合格
20193977,32,87,33,79,49,280,不合格
20193978,58,28,67,52,52,257,不合格
20193979,2,74,89,32,16,213,不合格
20193980,45,81,24,70,90,310,合格
20193981,26,26,9,13,4,78,不合格
20193982,44,91,44,42,61,282,不合格
20193983,77,21,33,77,85,293,不合格
20193984,4,56,15,49,77,201,不合格
20193985,18,6,45,38,87,194,不合格
20193986,71,25,12,39,71,218,不合格
20193987,66,69,47,7,32,221,不合格
20193988,43,74,38,78,49,282,不合格
20193989,51,94,42,59,11,257,不合格
20193990,25,2,76,19,9,131,不合格
20193991,92,1,85,38,47,263,不合格
20193992,44,88,73,0,65,270,不合格
20193993,90,84,64,41,7,286,不合格
20193994,59,16,17,23,64,179,不合格
20193995,47,38,86,16,22,209,不合格
20193996,86,9,35,60,56,246,不合格
20193997,96,72,60,89,39,356,合格
20193998,85,43,5,63,38,234,不合格
20193999,90,9,94,5,22,220,不合格
20194000,97,62,1,31,31,222,不合格
20194001,51,22,31,15,55,174,不合格
20194002,18,59,69,6,15,167,不合格
20194003,3,8,60,0,28,99,不合格
20194004,90,77,71,61,61,360,合格
20194005,80,88,92,53,33,346,合格
20194006,26,53,97,52,61,289,不合格
20194007,87,93,12,28,83,303,合格
20194008,84,56,59,32,74,305,合格
20194009,81,60,75,29,17,262,不合格
20194010,44,90,40,94,69,337,合格
20194011,9,96,19,17,70,211,不合格
20194012,25,54,80,19,43,221,不合格
20194013,79,88,45,5,94,311,合格
20194014,88,11,19,43,80,241,不合格
20194015,76,61,15,95,88,335,合格
20194016,11,96,34,25,46,212,不合格
20194017,87,99,12,84,11,293,不合格
20194018,69,5,57,54,52,237,不合格
20194019,7,71,12,80,66,236,不合格
20194020,40,85,51,53,74,303,合格
20194021,32,51,25,61,84,253,不合格
20194022,70,53,96,36,59,314,合格
20194023,45,41,22,34,25,167,不合格
20194024,46,23,99,20,68,256,不合格
20194025,84,46,46,72,90,338,合格
20194026,51,82,73,88,39,333,合格
20194027,28,92,9,93,15,237,不合格
20194028,66,76,6,61,22,231,不合格
20194029,14,69,81,50,32,246,不合格
20194030,15,37,38,46,37,173,不合格
20194031,96,2,83,24,91,296,不合格
20194032,94,84,94,27,2,301,合格
20194033,88,4,55,44,59,250,不合格
20194034,89,73,85,72,80,399,合格
20194035,44,70,86,83,68,351,合格
20194036,76,36,34,60,47,253,不合格
20194037,92,27,14,98,83,314,合格
20194038,40,82,1,97,84,304,合格
20194039,94,47,10,51,42,244,不合格
20194040,64,76,33,57,78,308,合格
20194041,90,6,58,3,34,191,不合格
20194042,51,16,4,9,40,120,不合格
20194043,79,8,18,74,67,246,不合格
20194044,43,46,39,18,21,167,不合格
20194045,2,48,69,51,81,251,不合格
20194046,67,1,65,49,55,237,不合格
20194047,50,3,72,25,56,206,不合格
20194048,10,6,34,49,94,193,不合格
20194049,83,82,91,39,15,310,合格
20194050,15,72,45,94,48,274,不合格
20194051,43,74,52,93,0,262,不合格
20194052,20,54,57,3,11,145,不合格
20194053,79,97,42,40,33,291,不合格
20194054,50,64,59,7,42,222,不合格
20194055,92,3,22,32,75,224,不合格
20194056,45,90,82,28,28,273,不合格
20194057,27,67,5,9,52,160,不合格
20194058,27,97,60,87,98,369,合格
20194059,76,29,65,56,53,279,不合格
20194060,64,82,8,10,49,213,不合格
20194061,14,70,35,15,73,207,不合格
20194062,23,96,20,24,42,205,不合格
20194063,5,22,53,70,92,242,不合格
20194064,93,85,34,92,95,399,合格
20194065,64,81,5,44,64,258,不合格
20194066,33,52,55,21,92,253,不合格
20194067,68,85,58,42,94,347,合格
20194068,63,46,28,46,94,277,不合格
20194069,61,17,76,75,95,324,合格
20194070,65,67,28,29,35,224,不合格
20194071,84,68,73,58,77,360,合格
20194072,57,96,96,25,38,312,合格
20194073,81,67,46,57,50,301,合格
20194074,27,41,29,20,88,205,不合格
20194075,88,66,62,29,75,320,合格
20194076,62,36,11,59,81,249,不合格
20194077,43,49,66,29,28,215,不合格
20194078,73,78,30,2,39,222,不合格
20194079,32,9,6,79,78,204,不合格
20194080,56,31,63,51,20,221,不合格
20194081,62,97,40,97,40,336,合格
20194082,64,11,80,84,48,287,不合格
20194083,84,23,1,56,50,214,不合格
20194084,51,93,64,68,52,328,合格
20194085,75,43,16,1,54,189,不合格
20194086,5,7,50,50,42,154,不合格
20194087,28,58,73,97,24,280,不合格
20194088,82,80,5,31,38,236,不合格
20194089,0,88,81,17,48,234,不合格
20194090,62,29,71,47,7,216,不合格
20194091,66,40,94,97,74,371,合格
20194092,69,79,96,8,20,272,不合格
20194093,29,28,25,40,59,181,不合格
20194094,42,34,27,35,79,217,不合格
20194095,68,55,49,87,95,354,合格
20194096,25,55,19,36,55,190,不合格
20194097,89,93,79,86,32,379,合格
20194098,50,14,35,98,84,281,不合格
20194099,58,2,12,71,25,168,不合格
20194100,62,66,86,3,45,262,不合格
20194101,69,12,7,19,83,190,不合格
20194102,96,46,69,50,51,312,合格
20194103,23,46,21,17,8,115,不合格
20194104,91,12,53,77,35,268,不合格
20194105,79,52,74,5,56,266,不合格
20194106,28,48,64,40,93,273,不合格
20194107,84,52,82,86,83,387,合格
20194108,95,97,71,22,55,340,合格
20194109,72,68,92,82,70,384,合格
20194110,80,29,9,14,32,164,不合格
20194111,0,42,0,41,29,112,不合格
20194112,5,50,80,98,97,330,合格
20194113,9,73,17,76,2,177,不合格
20194114,97,2,82,17,18,216,不合格
20194115,66,10,51,26,17,170,不合格
20194116,18,65,69,57,56,265,不合格
20194117,9,62,20,46,99,236,不合格
20194118,93,71,55,96,37,352,合格
20194119,29,12,63,6,8,118,不合格
20194120,13,69,31,36,83,232,不合格
20194121,59,28,66,59,76,288,不合格
20194122,75,36,21,15,92,239,不合格
20194123,6,58,50,26,91,231,不合格
20194124,93,83,34,93,83,386,合格
20194125,62,30,22,22,16,152,不合格
20194126,6,22,29,58,63,178,不合格
20194127,46,55,33,38,79,251,不合格
20194128,57,1,76,33,22,189,不合格
20194129,98,70,52,92,35,347,合格
20194130,10,64,73,1,27,175,不合格
20194131,55,83,0,32,33,203,不合格
20194132,76,48,63,69,19,275,不合格
20194133,94,99,19,95,60,367,合格
20194134,35,9,67,44,70,225,不合格
20194135,74,31,20,87,19,231,不合格
20194136,61,30,38,85,96,310,合格
20194137,45,91,19,30,43,228,不合格
20194138,83,0,68,90,94,335,合格
20194139,72,13,14,44,93,236,不合格
20194140,53,95,85,39,68,340,合格
20194141,20,39,72,22,47,200,不合格
20194142,40,17,84,81,3,225,不合格
20194143,44,5,31,35,84,199,不合格
20194144,88,24,98,64,97,371,合格
20194145,4,59,22,43,3,131,不合格
20194146,57,30,37,7,73,204,不合格
20194147,42,14,16,63,84,219,不合格
20194148,34,74,53,52,30,243,不合格
20194149,77,50,59,18,68,272,不合格
20194150,78,72,69,80,8,307,合格
20194151,3,15,45,52,61,176,不合格
20194152,22,28,1,55,5,111,不合格
20194153,83,12,27,3,46,171,不合格
20194154,58,24,72,32,76,262,不合格
20194155,25,50,26,80,33,214,不合格
20194156,53,33,6,44,53,189,不合格
20194157,37,96,11,72,33,249,不合格
20194158,31,18,45,85,16,195,不合格
20194159,52,96,14,12,18,192,不合格
20194160,34,74,21,62,84,275,不合格
20194161,23,69,42,0,59,193,不合格
20194162,0,43,16,90,79,228,不合格
20194163,40,45,26,88,79,278,不合格
20194164,59,69,65,65,85,343,合格
20194165,87,87,31,93,69,367,合格
20194166,40,67,5,58,67,237,不合格
20194167,64,63,38,29,46,240,不合格
20194168,40,81,62,46,90,319,合格
20194169,73,33,35,5,47,193,不合格
20194170,0,77,90,50,93,310,合格
20194171,4,93,32,99,58,286,不合格
20194172,8,6,22,86,27,149,不合格
20194173,49,52,11,66,12,190,不合格
20194174,16,67,10,12,89,194,不合格
20194175,24,83,61,30,89,287,不合格
20194176,65,87,88,73,89,402,合格
20194177,6,73,26,95,94,294,不合格
20194178,87,11,49,28,20,195,不合格
20194179,35,66,16,53,39,209,不合格
20194180,53,46,64,17,72,252,不合格
20194181,69,84,42,26,32,253,不合格
20194182,91,58,70,62,75,356,合格
20194183,39,37,99,76,70,321,合格
20194184,81,35,88,31,1,236,不合格
20194185,11,69,97,19,5,201,不合格
20194186,43,37,10,19,56,165,不合格
20194187,42,54,68,91,55,310,合格
20194188,94,44,57,39,51,285,不合格
20194189,95,59,98,64,61,377,合格
20194190,36,55,23,58,40,212,不合格
20194191,72,25,37,16,33,183,不合格
20194192,94,9,42,77,46,268,不合格
20194193,61,83,78,85,92,399,合格
20194194,87,21,32,67,52,259,不合格
20194195,14,49,20,74,79,236,不合格
20194196,27,23,10,97,66,223,不合格
20194197,65,34,26,59,42,226,不合格
20194198,23,83,82,31,64,283,不合格
20194199,32,25,77,7,80,221,不合格
20194200,85,1,26,86,61,259,不合格
20194201,42,70,55,54,66,287,不合格
20194202,11,76,47,37,95,266,不合格
20194203,36,67,63,70,71,307,合格
20194204,29,97,7,41,20,194,不合格
20194205,25,49,34,79,17,204,不合格
20194206,60,63,51,80,62,316,合格
20194207,86,3,92,2,65,248,不合格
20194208,98,54,39,13,0,204,不合格
20194209,78,95,85,22,47,327,合格
20194210,70,95,78,23,55,321,合格
20194211,81,11,75,34,85,286,不合格
20194212,98,12,17,65,39,231,不合格
20194213,59,54,73,61,49,296,不合格
20194214,59,17,36,48,94,254,不合格
20194215,34,44,40,30,13,161,不合格
20194216,72,29,59,8,0,168,不合格
20194217,45,79,54,97,44,319,合格
20194218,33,33,43,37,74,220,不合格
20194219,18,44,75,60,56,253,不合格
20194220,30,2,98,59,10,199,不合格
20194221,86,47,70,24,30,257,不合格
20194222,78,50,1,31,9,169,不合格
20194223,5,63,58,68,6,200,不合格
20194224,26,66,35,84,69,280,不合格
20194225,24,24,82,62,87,279,不合格
20194226,54,4,49,80,51,238,不合格
20194227,48,67,82,52,23,272,不合格
20194228,5,4,24,28,14,75,不合格
20194229,12,77,35,63,27,214,不合格
20194230,0,67,19,65,2,153,不合格
20194231,18,40,39,98,34,229,不合格
20194232,16,39,82,36,95,268,不合格
20194233,63,87,34,3,6,193,不合格
20194234,87,97,58,71,54,367,合格
20194235,6,27,44,54,76,207,不合格
20194236,99,25,71,69,8,272,不合格
20194237,35,12,40,8,66,161,不合格
20194238,20,23,17,97,82,239,不合格
20194239,62,67,0,13,84,226,不合格
20194240,60,96,10,67,37,270,不合格
20194241,86,86,81,9,73,335,合格
20194242,68,7,69,81,76,301,合格
20194243,55,91,29,39,86,300,合格
20194244,90,40,12,39,22,203,不合格
20194245,67,4,1,36,74,182,不合格
20194246,57,2,62,77,47,245,不合格
20194247,57,19,0,53,45,174,不合格
20194248,82,35,52,63,41,273,不合格
20194249,77,45,56,5,3,186,不合格
20194250,96,30,87,44,40,297,不合格
20194251,41,72,9,66,65,253,不合格
20194252,25,44,42,24,3,138,不合格
20194253,52,49,37,66,92,296,不合格
20194254,45,63,3,80,43,234,不合格
20194255,46,81,96,50,49,322,合格
20194256,59,45,65,60,96,325,合格
20194257,90,87,0,68,72,317,合格
20194258,84,15,52,56,54,261,不合格
20194259,42,76,53,71,92,334,合格
20194260,48,80,88,78,82,376,合格
20194261,48,77,37,0,89,251,不合格
20194262,67,22,16,45,18,168,不合格
20194263,89,72,37,64,67,329,合格
20194264,72,7,21,4,37,141,不合格
20194265,15,21,47,6,3,92,不合格
20194266,95,44,16,11,52,218,不合格
20194267,28,88,1,97,31,245,不合格
20194268,37,53,76,69,56,291,不合格
20194269,86,63,88,22,72,331,合格
20194270,56,27,93,97,91,364,合格
20194271,75,94,87,34,81,371,合格
20194272,84,42,16,60,57,259,不合格
20194273,76,43,29,74,82,304,合格
20194274,96,94,1,72,92,355,合格
20194275,34,15,29,15,97,190,不合格
20194276,87,63,95,70,88,403,合格
20194277,60,57,88,15,82,302,合格
20194278,93,21,14,55,17,200,不合格
20194279,42,69,72,75,28,286,不合格
20194280,59,41,20,6,82,208,不合格
20194281,41,71,93,98,51,354,合格
20194282,7,36,22,87,63,215,不合格
20194283,68,73,49,50,47,287,不合格
20194284,2,76,63,67,24,232,不合格
20194285,22,64,55,69,91,301,合格
20194286,22,30,74,20,0,146,不合格
20194287,84,34,78,55,93,344,合格
20194288,94,10,4,19,55,182,不合格
20194289,99,14,83,62,85,343,合格
20194290,41,80,4,35,83,243,不合格
20194291,50,25,93,94,72,334,合格
20194292,20,92,75,7,13,207,不合格
20194293,13,66,58,87,8,232,不合格
20194294,56,32,23,8,75,194,不合格
20194295,87,72,67,96,63,385,合格
20194296,44,51,78,8,99,280,不合格
20194297,77,52,11,0,13,153,不合格
20194298,9,9,39,99,92,248,不合格
20194299,28,65,92,72,4,261,不合格
20194300,46,52,83,61,79,321,合格
20194301,62,98,12,3,41,216,不合格
20194302,3,44,3,3,69,122,不合格
20194303,55,24,27,29,17,152,不合格
20194304,74,88,28,14,32,236,不合格
20194305,12,7,83,13,85,200,不合格
20194306,31,25,49,30,52,187,不合格
20194307,84,17,97,83,95,376,合格
20194308,77,75,39,75,3,269,不合格
20194309,15,77,62,15,87,256,不合格
20194310,54,27,6,91,24,202,不合格
20194311,38,35,51,92,31,247,不合格
20194312,9,49,89,58,1,206,不合格
20194313,68,99,24,5,45,241,不合格
20194314,43,70,25,91,0,229,不合格
20194315,91,73,60,34,58,316,合格
20194316,96,67,29,51,97,340,合格
20194317,4,29,79,16,43,171,不合格
20194318,66,22,83,55,14,240,不合格
20194319,82,13,33,7,41,176,不合格
20194320,61,60,5,41,36,203,不合格
20194321,97,3,76,0,81,257,不合格
20194322,20,75,67,38,42,242,不合格
20194323,24,87,22,31,49,213,不合格
20194324,68,50,45,55,24,242,不合格
20194325,99,30,63,24,29,245,不合格
20194326,82,20,37,40,55,234,不合格
20194327,84,73,26,14,2,199,不合格
20194328,44,59,72,35,9,219,不合格
20194329,19,57,42,78,23,219,不合格
20194330,47,31,83,98,54,313,合格
20194331,13,52,19,83,64,231,不合格
20194332,56,10,29,67,82,244,不合格
20194333,86,58,80,32,65,321,合格
20194334,51,31,67,75,60,284,不合格
20194335,74,2,89,25,83,273,不合格
20194336,74,75,44,96,54,343,合格
20194337,76,61,56,84,21,298,不合格
20194338,63,1,64,79,77,284,不合格
20194339,89,98,41,26,41,295,不合格
20194340,20,41,66,38,42,207,不合格
20194341,42,34,83,47,12,218,不合格
20194342,24,29,24,58,56,191,不合格
20194343,86,42,70,98,31,327,合格
20194344,80,17,3,68,44,212,不合格
20194345,50,9,67,76,52,254,不合格
20194346,81,70,32,78,62,323,合格
20194347,66,98,27,19,62,272,不合格
20194348,85,94,16,3,54,252,不合格
20194349,4,62,30,26,61,183,不合格
20194350,18,86,37,41,49,231,不合格
20194351,52,47,13,71,19,202,不合格
20194352,40,53,90,85,6,274,不合格
20194353,67,68,90,11,67,303,合格
20194354,19,89,35,88,88,319,合格
20194355,51,26,67,96,4,244,不合格
20194356,25,40,19,6,65,155,不合格
20194357,15,88,43,36,51,233,不合格
20194358,46,37,55,86,97,321,合格
20194359,73,28,71,59,40,271,不合格
20194360,27,83,96,38,28,272,不合格
20194361,36,30,39,54,45,204,不合格
20194362,76,49,97,18,96,336,合格
20194363,77,77,76,65,35,330,合格
20194364,32,7,43,76,89,247,不合格
20194365,30,95,86,63,75,349,合格
20194366,6,89,95,55,82,327,合格
20194367,86,33,38,42,25,224,不合格
20194368,66,10,79,49,0,204,不合格
20194369,52,17,68,89,17,243,不合格
20194370,77,92,21,8,69,267,不合格
20194371,67,36,78,60,51,292,不合格
20194372,90,54,42,10,45,241,不合格
20194373,64,28,1,72,23,188,不合格
20194374,51,13,19,98,67,248,不合格
20194375,5,15,12,77,93,202,不合格
20194376,11,8,94,84,37,234,不合格
20194377,62,75,91,85,91,404,合格
20194378,50,91,70,11,95,317,合格
20194379,12,9,0,95,6,122,不合格
20194380,4,55,25,7,74,165,不合格
20194381,48,75,63,81,67,334,合格
20194382,27,38,93,69,94,321,合格
20194383,82,81,60,70,81,374,合格
20194384,42,84,46,15,57,244,不合格
20194385,39,49,0,98,45,231,不合格
20194386,56,39,52,53,63,263,不合格
20194387,23,92,41,41,68,265,不合格
20194388,77,30,69,30,42,248,不合格
20194389,9,33,93,43,78,256,不合格
20194390,47,52,4,84,93,280,不合格
20194391,48,53,97,81,35,314,合格
20194392,89,45,61,99,64,358,合格
20194393,34,34,96,48,10,222,不合格
20194394,17,24,29,15,92,177,不合格
20194395,65,2,26,40,88,221,不合格
20194396,34,56,74,9,14,187,不合格
20194397,10,43,57,95,99,304,合格
20194398,18,48,39,43,23,171,不合格
20194399,98,10,19,48,15,190,不合格
20194400,75,11,47,63,41,237,不合格
20194401,51,57,26,44,52,230,不合格
20194402,13,70,82,57,60,282,不合格
20194403,68,28,62,84,63,305,合格
20194404,35,35,48,83,48,249,不合格
20194405,42,54,9,16,91,212,不合格
20194406,26,77,30,70,27,230,不合格
20194407,58,76,23,91,30,278,不合格
20194408,10,44,89,2,32,177,不合格
20194409,25,67,31,1,49,173,不合格
20194410,43,66,63,12,18,202,不合格
20194411,25,25,75,80,31,236,不合格
20194412,92,83,30,34,35,274,不合格
20194413,96,81,12,51,0,240,不合格
20194414,77,60,32,5,21,195,不合格
20194415,80,29,38,28,87,262,不合格
20194416,31,67,92,14,2,206,不合格
20194417,33,10,29,35,87,194,不合格
20194418,54,20,54,42,63,233,不合格
20194419,87,7,65,92,21,272,不合格
20194420,51,43,9,23,90,216,不合格
20194421,90,9,6,2,25,132,不合格
20194422,13,78,82,15,97,285,不合格
20194423,54,8,81,64,21,228,不合格
20194424,53,17,84,28,83,265,不合格
20194425,41,4,59,37,28,169,不合格
20194426,93,25,14,34,2,168,不合格
20194427,68,36,32,59,34,229,不合格
20194428,1,70,42,43,48,204,不合格
20194429,49,58,77,36,31,251,不合格
20194430,18,86,2,14,54,174,不合格
20194431,3,94,51,61,1,210,不合格
20194432,32,2,30,67,51,182,不合格
20194433,24,6,90,81,79,280,不合格
20194434,87,29,44,12,26,198,不合格
20194435,17,50,21,10,36,134,不合格
20194436,48,69,80,90,22,309,合格
20194437,37,32,84,92,36,281,不合格
20194438,30,28,17,55,86,216,不合格
20194439,55,95,85,72,11,318,合格
20194440,42,44,83,73,99,341,合格
20194441,84,14,49,5,99,251,不合格
20194442,61,72,86,37,41,297,不合格
20194443,2,19,9,22,64,116,不合格
20194444,71,86,35,61,39,292,不合格
20194445,87,67,98,60,7,319,合格
20194446,9,90,48,50,81,278,不合格
20194447,33,21,15,62,31,162,不合格
20194448,99,85,19,1,12,216,不合格
20194449,65,1,59,39,93,257,不合格
20194450,8,32,48,16,5,109,不合格
20194451,64,27,81,11,65,248,不合格
20194452,25,19,22,69,51,186,不合格
20194453,45,54,43,6,25,173,不合格
20194454,83,77,9,86,0,255,不合格
20194455,40,44,64,40,92,280,不合格
20194456,92,60,41,21,20,234,不合格
20194457,79,89,0,28,28,224,不合格
20194458,65,25,42,45,41,218,不合格
20194459,96,46,66,70,4,282,不合格
20194460,33,68,18,0,51,170,不合格
20194461,18,86,23,93,41,261,不合格
20194462,24,85,4,69,52,234,不合格
20194463,35,94,26,65,29,249,不合格
20194464,8,72,52,14,15,161,不合格
20194465,20,84,34,86,42,266,不合格
20194466,23,49,96,22,52,242,不合格
20194467,18,82,53,54,58,265,不合格
20194468,72,9,99,48,67,295,不合格
20194469,88,47,0,63,48,246,不合格
20194470,36,99,79,9,86,309,合格
20194471,9,80,92,55,68,304,合格
20194472,51,90,83,55,57,336,合格
20194473,41,23,10,9,5,88,不合格
20194474,63,35,60,23,92,273,不合格
20194475,51,67,32,47,19,216,不合格
20194476,38,12,40,47,38,175,不合格
20194477,84,34,90,21,6,235,不合格
20194478,41,55,44,80,99,319,合格
20194479,59,38,56,83,51,287,不合格
20194480,71,66,68,65,54,324,合格
20194481,55,34,44,78,27,238,不合格
20194482,43,15,62,24,99,243,不合格
20194483,65,42,30,81,77,295,不合格
20194484,73,98,95,42,11,319,合格
20194485,42,34,14,35,73,198,不合格
20194486,61,28,81,34,25,229,不合格
20194487,14,77,93,49,87,320,合格
20194488,60,42,85,61,40,288,不合格
20194489,63,31,34,66,44,238,不合格
20194490,43,9,0,24,94,170,不合格
20194491,66,32,57,33,98,286,不合格
20194492,56,45,22,25,93,241,不合格
20194493,58,38,78,1,46,221,不合格
20194494,72,24,3,6,18,123,不合格
20194495,4,51,38,32,52,177,不合格
20194496,16,87,0,30,61,194,不合格
20194497,12,17,16,64,72,181,不合格
20194498,48,12,79,17,7,163,不合格
20194499,45,38,25,5,91,204,不合格
20194500,3,67,71,70,39,250,不合格
20194501,0,28,16,55,46,145,不合格
20194502,75,49,30,58,64,276,不合格
20194503,24,60,65,43,26,218,不合格
20194504,38,86,71,24,57,276,不合格
20194505,42,72,11,2,70,197,不合格
20194506,72,81,74,59,5,291,不合格
20194507,58,41,35,19,41,194,不合格
20194508,39,37,24,73,46,219,不合格
20194509,56,70,54,70,56,306,合格
20194510,22,45,85,70,28,250,不合格
20194511,1,12,24,94,82,213,不合格
20194512,51,71,32,14,3,171,不合格
20194513,26,19,50,84,0,179,不合格
20194514,56,74,81,84,55,350,合格
20194515,25,68,55,45,91,284,不合格
20194516,37,79,78,88,73,355,合格
20194517,44,31,98,64,8,245,不合格
20194518,16,4,40,91,2,153,不合格
20194519,88,34,27,21,67,237,不合格
20194520,7,4,29,51,31,122,不合格
20194521,96,87,87,65,13,348,合格
20194522,47,49,50,86,64,296,不合格
20194523,56,50,64,24,84,278,不合格
20194524,9,86,50,27,99,271,不合格
20194525,10,49,45,17,82,203,不合格
20194526,18,50,2,34,17,121,不合格
20194527,25,89,30,74,51,269,不合格
20194528,43,97,83,67,4,294,不合格
20194529,19,49,48,45,88,249,不合格
20194530,0,94,11,34,79,218,不合格
20194531,13,20,53,51,2,139,不合格
20194532,56,60,6,29,65,216,不合格
20194533,11,58,36,17,39,161,不合格
20194534,99,19,20,80,56,274,不合格
20194535,6,88,34,49,70,247,不合格
20194536,49,12,32,10,57,160,不合格
20194537,74,31,69,96,11,281,不合格
20194538,71,90,58,66,41,326,合格
20194539,59,72,41,56,67,295,不合格
20194540,72,77,19,89,66,323,合格
20194541,57,95,70,0,23,245,不合格
20194542,34,28,43,88,83,276,不合格
20194543,51,99,67,82,32,331,合格
20194544,9,37,83,95,39,263,不合格
20194545,91,50,0,42,55,238,不合格
20194546,0,75,51,33,79,238,不合格
20194547,1,45,6,75,15,142,不合格
20194548,69,33,5,29,58,194,不合格
20194549,38,87,15,25,82,247,不合格
20194550,87,0,74,89,65,315,合格
20194551,58,21,91,93,22,285,不合格
20194552,90,63,49,67,54,323,合格
20194553,67,97,24,75,24,287,不合格
20194554,42,80,21,39,81,263,不合格
20194555,21,27,72,58,25,203,不合格
20194556,31,50,94,92,54,321,合格
20194557,96,40,81,92,90,399,合格
20194558,25,98,1,86,16,226,不合格
20194559,53,93,59,91,49,345,合格
20194560,75,36,55,30,71,267,不合格
20194561,5,63,32,33,51,184,不合格
20194562,53,55,83,65,0,256,不合格
20194563,83,6,87,17,65,258,不合格
20194564,82,9,74,55,16,236,不合格
20194565,98,84,10,87,25,304,合格
20194566,17,38,59,92,19,225,不合格
20194567,80,1,42,94,29,246,不合格
20194568,21,66,89,2,86,264,不合格
20194569,54,92,4,22,23,195,不合格
20194570,10,86,97,86,61,340,合格
20194571,64,95,81,75,73,388,合格
20194572,29,82,5,81,26,223,不合格
20194573,98,9,92,17,85,301,合格
20194574,4,29,73,27,73,206,不合格
20194575,54,18,67,39,82,260,不合格
20194576,99,99,43,24,90,355,合格
20194577,60,95,81,1,46,283,不合格
20194578,53,76,23,78,91,321,合格
20194579,85,50,87,12,42,276,不合格
20194580,24,6,56,80,64,230,不合格
20194581,58,49,62,18,24,211,不合格
20194582,29,40,22,84,94,269,不合格
20194583,81,19,64,43,40,247,不合格
20194584,10,68,29,1,21,129,不合格
20194585,30,32,93,84,31,270,不合格
20194586,36,14,81,85,33,249,不合格
20194587,58,63,1,14,55,191,不合格
20194588,42,59,43,17,50,211,不合格
20194589,94,59,38,50,50,291,不合格
20194590,39,4,4,96,17,160,不合格
20194591,9,42,31,51,90,223,不合格
20194592,3,42,66,59,58,228,不合格
20194593,78,65,63,38,4,248,不合格
20194594,17,66,74,3,46,206,不合格
20194595,49,95,79,23,38,284,不合格
20194596,88,94,2,17,38,239,不合格
20194597,35,38,17,33,17,140,不合格
20194598,95,65,50,83,1,294,不合格
20194599,44,66,55,15,81,261,不合格
20194600,95,6,2,41,13,157,不合格
20194601,25,5,38,20,82,170,不合格
20194602,24,53,70,79,69,295,不合格
20194603,79,28,16,69,71,263,不合格
20194604,49,18,61,78,11,217,不合格
20194605,38,61,4,93,69,265,不合格
20194606,43,90,34,28,67,262,不合格
20194607,57,30,3,27,79,196,不合格
20194608,7,87,55,46,54,249,不合格
20194609,96,85,94,79,81,435,合格
20194610,98,54,68,38,73,331,合格
20194611,57,95,46,26,20,244,不合格
20194612,88,11,80,32,60,271,不合格
20194613,47,77,64,18,52,258,不合格
20194614,65,11,83,39,76,274,不合格
20194615,24,35,96,10,75,240,不合格
20194616,83,77,54,89,81,384,合格
20194617,54,71,84,21,29,259,不合格
20194618,89,85,34,25,11,244,不合格
20194619,45,7,72,27,99,250,不合格
20194620,90,62,77,78,2,309,合格
20194621,60,73,27,69,6,235,不合格
20194622,21,14,16,1,27,79,不合格
20194623,66,43,76,5,1,191,不合格
20194624,49,52,32,11,10,154,不合格
20194625,50,82,28,28,38,226,不合格
20194626,54,82,10,38,60,244,不合格
20194627,23,89,39,39,62,252,不合格
20194628,72,33,46,47,31,229,不合格
20194629,50,28,28,63,2,171,不合格
20194630,13,84,69,77,87,330,合格
20194631,74,33,5,54,1,167,不合格
20194632,12,14,13,56,63,158,不合格
20194633,36,18,44,6,68,172,不合格
20194634,31,14,16,45,72,178,不合格
20194635,41,53,54,11,82,241,不合格
20194636,88,62,81,80,53,364,合格
20194637,22,54,12,29,47,164,不合格
20194638,91,98,59,95,51,394,合格
20194639,32,89,47,42,89,299,不合格
20194640,90,70,61,38,67,326,合格
20194641,42,28,60,8,34,172,不合格
20194642,94,19,24,84,61,282,不合格
20194643,29,27,86,40,14,196,不合格
20194644,5,93,85,28,85,296,不合格
20194645,20,4,16,66,51,157,不合格
20194646,87,68,63,72,11,301,合格
20194647,75,24,66,90,98,353,合格
20194648,5,64,64,13,13,159,不合格
20194649,18,33,66,57,62,236,不合格
20194650,26,71,67,23,62,249,不合格
20194651,87,37,80,7,69,280,不合格
20194652,25,56,73,34,68,256,不合格
20194653,72,94,39,59,28,292,不合格
20194654,78,84,85,35,93,375,合格
20194655,39,87,73,51,64,314,合格
20194656,15,51,62,45,61,234,不合格
20194657,39,38,7,5,34,123,不合格
20194658,4,88,26,61,53,232,不合格
20194659,38,64,53,65,39,259,不合格
20194660,29,72,96,74,81,352,合格
20194661,54,82,41,8,5,190,不合格
20194662,32,51,79,73,77,312,合格
20194663,90,22,47,38,55,252,不合格
20194664,61,16,30,92,27,226,不合格
20194665,73,47,52,27,25,224,不合格
20194666,59,60,29,57,63,268,不合格
20194667,12,92,54,88,13,259,不合格
20194668,93,30,10,48,20,201,不合格
20194669,91,33,73,51,69,317,合格
20194670,56,17,67,7,38,185,不合格
20194671,24,49,85,23,55,236,不合格
20194672,55,91,71,99,5,321,合格
20194673,12,62,89,4,99,266,不合格
20194674,13,53,52,10,17,145,不合格
20194675,25,17,87,48,62,239,不合格
20194676,58,5,47,43,42,195,不合格
20194677,68,42,80,26,82,298,不合格
20194678,23,23,85,58,81,270,不合格
20194679,47,70,0,36,86,239,不合格
20194680,74,94,79,29,70,346,合格
20194681,81,16,19,24,5,145,不合格
20194682,43,10,69,61,82,265,不合格
20194683,26,22,70,52,80,250,不合格
20194684,70,15,85,86,68,324,合格
20194685,29,71,32,50,37,219,不合格
20194686,11,49,5,72,96,233,不合格
20194687,22,48,58,83,37,248,不合格
20194688,16,66,36,5,60,183,不合格
20194689,25,53,14,94,20,206,不合格
20194690,78,93,78,61,29,339,合格
20194691,2,25,50,67,67,211,不合格
20194692,17,75,53,2,9,156,不合格
20194693,96,10,17,81,66,270,不合格
20194694,90,76,6,12,18,202,不合格
20194695,2,9,74,60,56,201,不合格
20194696,16,31,36,52,73,208,不合格
20194697,53,49,35,97,40,274,不合格
20194698,44,55,72,94,97,362,合格
20194699,16,68,64,0,45,193,不合格
20194700,16,41,60,41,13,171,不合格
20194701,65,66,77,39,35,282,不合格
20194702,26,88,88,51,77,330,合格
20194703,32,62,68,82,57,301,合格
20194704,91,50,91,57,73,362,合格
20194705,40,60,73,21,15,209,不合格
20194706,72,9,46,81,5,213,不合格
20194707,52,42,87,8,64,253,不合格
20194708,46,79,28,86,78,317,合格
20194709,76,34,31,95,53,289,不合格
20194710,68,4,90,95,45,302,合格
20194711,33,62,28,83,25,231,不合格
20194712,17,83,50,55,1,206,不合格
20194713,19,33,23,33,35,143,不合格
20194714,88,99,43,2,29,261,不合格
20194715,78,87,98,86,85,434,合格
20194716,97,48,78,43,75,341,合格
20194717,20,82,31,67,60,260,不合格
20194718,67,16,77,10,91,261,不合格
20194719,53,23,95,28,15,214,不合格
20194720,74,59,48,80,13,274,不合格
20194721,14,91,57,85,21,268,不合格
20194722,31,16,24,2,48,121,不合格
20194723,9,6,50,72,20,157,不合格
20194724,18,81,46,38,29,212,不合格
20194725,20,91,65,2,79,257,不合格
20194726,0,47,60,56,41,204,不合格
20194727,27,28,5,12,17,89,不合格
20194728,44,22,77,39,94,276,不合格
20194729,92,58,24,0,76,250,不合格
20194730,5,86,6,49,87,233,不合格
20194731,60,98,76,99,92,425,合格
20194732,65,99,52,9,70,295,不合格
20194733,60,12,82,94,30,278,不合格
20194734,19,25,22,39,43,148,不合格
20194735,81,31,49,26,39,226,不合格
20194736,52,62,79,56,30,279,不合格
20194737,91,6,64,33,40,234,不合格
20194738,34,6,3,29,99,171,不合格
20194739,35,41,85,17,56,234,不合格
20194740,75,88,87,71,77,398,合格
20194741,53,91,68,19,57,288,不合格
20194742,64,48,87,77,84,360,合格
20194743,13,40,67,20,74,214,不合格
20194744,0,66,59,11,57,193,不合格
20194745,65,80,31,26,25,227,不合格
20194746,34,18,44,7,15,118,不合格
20194747,91,88,19,16,84,298,不合格
20194748,98,80,32,43,31,284,不合格
20194749,51,21,9,86,99,266,不合格
20194750,46,53,42,48,27,216,不合格
20194751,62,84,31,75,52,304,合格
20194752,74,35,98,30,71,308,合格
20194753,51,68,97,34,6,256,不合格
20194754,44,15,35,43,9,146,不合格
20194755,57,77,21,83,25,263,不合格
20194756,97,91,86,37,34,345,合格
20194757,91,5,55,59,71,281,不合格
20194758,56,33,74,11,80,254,不合格
20194759,63,42,52,76,36,269,不合格
20194760,79,64,30,43,20,236,不合格
20194761,15,81,32,97,35,260,不合格
20194762,1,36,7,1,33,78,不合格
20194763,56,40,4,32,29,161,不合格
20194764,42,85,13,24,3,167,不合格
20194765,13,97,15,33,67,225,不合格
20194766,42,69,68,51,71,301,合格
20194767,3,68,96,18,30,215,不合格
20194768,36,21,77,43,41,218,不合格
20194769,78,80,5,19,3,185,不合格
20194770,11,13,48,16,45,133,不合格
20194771,23,46,68,56,4,197,不合格
20194772,17,19,57,4,49,146,不合格
20194773,43,68,73,86,82,352,合格
20194774,49,14,46,65,83,257,不合格
20194775,95,96,97,78,72,438,合格
20194776,2,16,29,98,41,186,不合格
20194777,46,66,56,64,0,232,不合格
20194778,43,46,1,4,85,179,不合格
20194779,57,78,15,78,71,299,不合格
20194780,72,40,59,26,58,255,不合格
20194781,57,46,18,37,5,163,不合格
20194782,17,80,37,78,7,219,不合格
20194783,61,31,58,22,29,201,不合格
20194784,6,4,37,24,72,143,不合格
20194785,60,13,82,86,67,308,合格
20194786,82,77,93,56,98,406,合格
20194787,57,10,34,27,84,212,不合格
20194788,72,46,8,78,16,220,不合格
20194789,42,78,88,88,15,311,合格
20194790,3,67,62,62,49,243,不合格
20194791,80,69,60,13,12,234,不合格
20194792,85,66,20,47,97,315,合格
20194793,38,61,66,68,55,288,不合格
20194794,99,95,6,20,63,283,不合格
20194795,48,84,93,54,45,324,合格
20194796,57,81,82,82,27,329,合格
20194797,55,98,81,22,79,335,合格
20194798,58,76,50,0,39,223,不合格
20194799,12,90,61,22,12,197,不合格
20194800,19,64,47,57,4,191,不合格
20194801,36,16,8,88,46,194,不合格
20194802,52,79,34,11,73,249,不合格
20194803,48,28,0,9,63,148,不合格
20194804,36,71,14,82,40,243,不合格
20194805,27,85,36,5,34,187,不合格
20194806,15,45,32,1,60,153,不合格
20194807,54,64,57,93,73,341,合格
20194808,41,3,44,29,60,177,不合格
20194809,95,79,85,72,35,366,合格
20194810,45,94,96,68,44,347,合格
20194811,93,57,31,11,94,286,不合格
20194812,12,67,69,1,97,246,不合格
20194813,26,99,60,90,77,352,合格
20194814,54,71,63,60,53,301,合格
20194815,24,41,58,33,66,222,不合格
20194816,86,93,92,44,56,371,合格
20194817,20,41,35,21,83,200,不合格
20194818,50,21,85,76,25,257,不合格
20194819,48,59,40,93,22,262,不合格
20194820,23,22,87,21,17,170,不合格
20194821,44,22,51,44,95,256,不合格
20194822,7,1,58,57,63,186,不合格
20194823,45,32,71,21,29,198,不合格
20194824,58,7,58,67,10,200,不合格
20194825,50,40,56,27,74,247,不合格
20194826,13,9,97,11,65,195,不合格
20194827,90,14,14,39,67,224,不合格
20194828,29,78,12,17,26,162,不合格
20194829,53,11,54,81,78,277,不合格
20194830,97,57,5,3,8,170,不合格
20194831,7,43,43,84,24,201,不合格
20194832,70,54,71,7,48,250,不合格
20194833,34,2,21,51,83,191,不合格
20194834,53,83,86,85,7,314,合格
20194835,50,47,1,59,81,238,不合格
20194836,28,26,10,42,96,202,不合格
20194837,2,94,82,60,59,297,不合格
20194838,63,57,21,42,93,276,不合格
20194839,24,99,87,58,27,295,不合格
20194840,98,44,60,56,39,297,不合格
20194841,76,41,17,60,31,225,不合格
20194842,8,14,48,45,61,176,不合格
20194843,12,93,97,31,17,250,不合格
20194844,65,60,89,44,16,274,不合格
20194845,68,5,72,69,35,249,不合格
20194846,77,27,59,37,7,207,不合格
20194847,10,32,43,54,14,153,不合格
20194848,51,38,3,32,34,158,不合格
20194849,42,87,95,19,89,332,合格
20194850,78,56,12,20,41,207,不合格
20194851,42,23,17,73,31,186,不合格
20194852,30,0,76,9,66,181,不合格
20194853,42,38,78,47,55,260,不合格
20194854,82,68,43,52,1,246,不合格
20194855,34,98,77,17,28,254,不合格
20194856,84,26,62,37,76,285,不合格
20194857,22,90,7,99,95,313,合格
20194858,2,47,6,24,36,115,不合格
20194859,33,42,2,56,46,179,不合格
20194860,38,12,1,62,96,209,不合格
20194861,76,95,68,86,35,360,合格
20194862,12,90,30,18,79,229,不合格
20194863,1,40,4,46,21,112,不合格
20194864,69,65,75,15,37,261,不合格
20194865,88,60,42,95,29,314,合格
20194866,44,85,97,97,21,344,合格
20194867,4,65,99,88,5,261,不合格
20194868,87,91,24,62,81,345,合格
20194869,21,26,45,13,84,189,不合格
20194870,9,6,77,31,66,189,不合格
20194871,4,88,75,0,12,179,不合格
20194872,41,57,16,52,58,224,不合格
20194873,58,61,30,16,38,203,不合格
20194874,7,56,86,91,12,252,不合格
20194875,27,12,59,37,38,173,不合格
20194876,30,53,81,60,46,270,不合格
20194877,5,89,89,10,75,268,不合格
20194878,94,65,3,17,71,250,不合格
20194879,12,99,54,73,74,312,合格
20194880,50,61,20,1,74,206,不合格
20194881,23,2,82,65,75,247,不合格
20194882,41,26,39,52,4,162,不合格
20194883,68,73,75,95,99,410,合格
20194884,25,34,60,66,17,202,不合格
20194885,81,0,96,44,65,286,不合格
20194886,29,46,57,40,75,247,不合格
20194887,63,21,69,3,40,196,不合格
20194888,43,60,31,67,10,211,不合格
20194889,9,47,76,24,78,234,不合格
20194890,1,48,63,77,57,246,不合格
20194891,97,82,98,75,80,432,合格
20194892,78,24,74,54,35,265,不合格
20194893,8,66,50,87,93,304,合格
20194894,38,4,2,70,57,171,不合格
20194895,36,45,79,82,12,254,不合格
20194896,85,76,46,21,76,304,合格
20194897,89,36,57,40,62,284,不合格
20194898,87,6,0,61,81,235,不合格
20194899,98,89,28,19,29,263,不合格
20194900,28,10,28,62,64,192,不合格
20194901,27,78,69,30,50,254,不合格
20194902,97,65,67,31,3,263,不合格
20194903,86,71,18,46,27,248,不合格
20194904,71,79,15,53,93,311,合格
20194905,91,56,93,85,90,415,合格
20194906,10,33,60,11,8,122,不合格
20194907,26,45,94,81,88,334,合格
20194908,76,93,17,99,72,357,合格
20194909,92,55,63,25,34,269,不合格
20194910,18,18,64,77,96,273,不合格
20194911,40,61,76,63,68,308,合格
20194912,2,28,27,99,47,203,不合格
20194913,21,62,59,35,11,188,不合格
20194914,39,49,44,43,95,270,不合格
20194915,77,9,10,78,35,209,不合格
20194916,41,92,0,33,16,182,不合格
20194917,82,85,40,93,53,353,合格
20194918,23,99,97,24,95,338,合格
20194919,7,35,58,36,31,167,不合格
20194920,4,93,43,60,13,213,不合格
20194921,9,24,33,57,7,130,不合格
20194922,56,24,96,1,13,190,不合格
20194923,91,0,58,87,56,292,不合格
20194924,75,51,9,13,14,162,不合格
20194925,14,89,76,62,78,319,合格
20194926,58,9,80,52,74,273,不合格
20194927,6,23,8,79,13,129,不合格
20194928,95,49,92,0,96,332,合格
20194929,55,88,0,40,76,259,不合格
20194930,46,97,62,31,74,310,合格
20194931,7,30,49,14,63,163,不合格
20194932,11,60,76,15,57,219,不合格
20194933,85,45,74,20,88,312,合格
20194934,95,47,92,8,42,284,不合格
20194935,62,18,8,30,36,154,不合格
20194936,69,5,23,56,89,242,不合格
20194937,10,81,65,40,55,251,不合格
20194938,15,31,84,93,91,314,合格
20194939,20,8,30,91,26,175,不合格
20194940,55,35,46,36,50,222,不合格
20194941,6,32,5,45,73,161,不合格
20194942,29,62,38,9,97,235,不合格
20194943,68,2,12,28,60,170,不合格
20194944,0,30,69,17,82,198,不合格
20194945,21,57,99,60,25,262,不合格
20194946,27,17,48,56,34,182,不合格
20194947,14,87,91,39,68,299,不合格
20194948,51,48,10,18,90,217,不合格
20194949,57,85,51,84,35,312,合格
20194950,83,23,21,74,26,227,不合格
20194951,13,2,62,48,29,154,不合格
20194952,46,48,12,45,21,172,不合格
20194953,93,99,19,1,85,297,不合格
20194954,53,60,85,44,97,339,合格
20194955,66,26,91,14,98,295,不合格
20194956,61,69,4,12,20,166,不合格
20194957,79,67,44,89,77,356,合格
20194958,72,37,44,4,20,177,不合格
20194959,55,12,76,15,8,166,不合格
20194960,80,42,58,41,17,238,不合格
20194961,57,47,29,24,44,201,不合格
20194962,81,61,14,72,28,256,不合格
20194963,93,39,42,28,14,216,不合格
20194964,59,16,4,61,37,177,不合格
20194965,90,90,46,37,52,315,合格
20194966,71,35,53,33,42,234,不合格
20194967,42,32,36,17,73,200,不合格
20194968,6,52,29,83,40,210,不合格
20194969,41,69,59,40,43,252,不合格
20194970,47,88,2,26,41,204,不合格
20194971,75,10,92,16,21,214,不合格
20194972,46,16,61,29,0,152,不合格
20194973,74,60,51,15,0,200,不合格
20194974,94,35,13,43,39,224,不合格
20194975,6,85,15,44,71,221,不合格
20194976,92,32,40,5,8,177,不合格
20194977,92,75,68,66,78,379,合格
20194978,47,46,1,98,90,282,不合格
20194979,34,90,39,42,20,225,不合格
20194980,89,2,59,70,83,303,合格
20194981,3,99,4,7,69,182,不合格
20194982,95,56,86,42,24,303,合格
20194983,20,71,23,54,69,237,不合格
20194984,89,28,10,22,21,170,不合格
20194985,18,76,94,52,61,301,合格
20194986,11,80,4,73,37,205,不合格
20194987,47,70,21,72,55,265,不合格
20194988,68,6,66,65,73,278,不合格
20194989,27,35,33,92,5,192,不合格
20194990,61,70,1,32,69,233,不合格
20194991,71,74,1,16,84,246,不合格
20194992,19,79,55,22,94,269,不合格
20194993,32,43,37,32,68,212,不合格
20194994,63,9,3,2,99,176,不合格
20194995,97,66,67,76,66,372,合格
20194996,22,63,9,34,58,186,不合格
20194997,14,58,75,16,26,189,不合格
20194998,60,66,21,74,40,261,不合格
20194999,17,68,29,46,40,200,不合格
20195000,70,15,91,90,93,359,合格
20195001,24,97,45,78,2,246,不合格
20195002,53,97,49,23,41,263,不合格
20195003,0,8,27,12,59,106,不合格
20195004,79,62,23,39,63,266,不合格
20195005,69,29,32,95,9,234,不合格
20195006,94,77,92,70,60,393,合格
20195007,23,34,79,71,10,217,不合格
20195008,18,7,83,87,95,290,不合格
20195009,17,37,5,48,18,125,不合格
20195010,33,60,10,87,48,238,不合格
20195011,39,25,69,1,13,147,不合格
20195012,22,35,65,59,0,181,不合格
20195013,17,13,93,57,50,230,不合格
20195014,77,95,98,7,91,368,合格
20195015,35,51,45,67,28,226,不合格
20195016,64,4,44,67,26,205,不合格
20195017,86,22,14,27,62,211,不合格
20195018,32,40,70,44,89,275,不合格
20195019,68,27,17,65,46,223,不合格
20195020,67,82,49,78,64,340,合格
20195021,74,4,43,1,67,189,不合格
20195022,65,99,73,66,48,351,合格
20195023,15,76,46,79,95,311,合格
20195024,44,73,26,87,99,329,合格
20195025,19,6,50,87,38,200,不合格
20195026,99,68,66,96,0,329,合格
20195027,51,7,23,32,7,120,不合格
20195028,57,33,49,94,27,260,不合格
20195029,11,13,8,57,40,129,不合格
20195030,81,26,53,75,97,332,合格
20195031,64,87,39,67,22,279,不合格
20195032,40,14,65,18,49,186,不合格
20195033,1,3,22,44,35,105,不合格
20195034,5,70,37,77,22,211,不合格
20195035,63,33,4,33,12,145,不合格
20195036,59,57,29,79,27,251,不合格
20195037,44,51,95,37,7,234,不合格
20195038,46,52,51,62,59,270,不合格
20195039,99,9,53,14,72,247,不合格
20195040,81,74,13,67,73,308,合格
20195041,48,29,65,31,49,222,不合格
20195042,96,80,27,88,51,342,合格
20195043,48,67,89,54,38,296,不合格
20195044,83,22,51,40,4,200,不合格
20195045,77,68,74,70,54,343,合格
20195046,6,4,76,19,33,138,不合格
20195047,89,18,13,74,33,227,不合格
20195048,33,76,34,45,19,207,不合格
20195049,9,65,26,26,3,129,不合格
20195050,89,67,69,35,23,283,不合格
20195051,68,0,45,77,19,209,不合格
20195052,78,80,52,7,41,258,不合格
20195053,45,67,78,56,21,267,不合格
20195054,11,31,54,10,82,188,不合格
20195055,79,79,15,39,93,305,合格
20195056,57,81,31,50,37,256,不合格
20195057,96,63,95,79,15,348,合格
20195058,72,61,5,18,76,232,不合格
20195059,39,0,66,52,94,251,不合格
20195060,46,2,5,73,40,166,不合格
20195061,90,71,74,79,90,404,合格
20195062,28,76,51,18,43,216,不合格
20195063,95,14,82,76,43,310,合格
20195064,92,1,50,72,53,268,不合格
20195065,40,95,64,64,3,266,不合格
20195066,93,43,67,46,52,301,合格
20195067,17,50,33,17,48,165,不合格
20195068,12,76,43,5,3,139,不合格
20195069,98,86,80,8,87,359,合格
20195070,97,25,53,89,1,265,不合格
20195071,43,86,5,58,86,278,不合格
20195072,16,95,42,94,90,337,合格
20195073,96,20,62,18,16,212,不合格
20195074,64,30,23,8,75,200,不合格
20195075,24,89,84,68,80,345,合格
20195076,88,93,67,51,79,378,合格
20195077,31,86,49,30,29,225,不合格
20195078,88,39,10,31,59,227,不合格
20195079,67,18,90,26,19,220,不合格
20195080,81,7,78,21,46,233,不合格
20195081,18,6,47,13,99,183,不合格
20195082,24,93,9,65,60,251,不合格
20195083,20,44,72,33,23,192,不合格
20195084,36,62,93,70,78,339,合格
20195085,46,76,59,75,29,285,不合格
20195086,55,72,69,74,66,336,合格
20195087,83,25,42,38,77,265,不合格
20195088,20,96,25,54,25,220,不合格
20195089,54,27,21,29,56,187,不合格
20195090,53,44,25,41,54,217,不合格
20195091,26,93,14,22,6,161,不合格
20195092,72,76,74,95,77,394,合格
20195093,53,82,0,40,9,184,不合格
20195094,44,35,94,21,39,233,不合格
20195095,59,60,21,38,3,181,不合格
20195096,49,28,48,74,2,201,不合格
20195097,30,97,65,15,18,225,不合格
20195098,69,81,55,98,18,321,合格
20195099,9,49,56,82,45,241,不合格
20195100,7,15,65,59,40,186,不合格
20195101,73,5,33,51,36,198,不合格
20195102,21,15,91,43,20,190,不合格
20195103,58,42,30,53,99,282,不合格
20195104,68,2,60,68,64,262,不合格
20195105,10,84,41,65,39,239,不合格
20195106,59,38,38,30,16,181,不合格
20195107,82,65,45,84,57,333,合格
20195108,56,5,37,47,49,194,不合格
20195109,62,20,95,86,72,335,合格
20195110,87,87,82,39,31,326,合格
20195111,42,31,64,38,68,243,不合格
20195112,9,13,62,26,24,134,不合格
20195113,7,5,93,40,46,191,不合格
20195114,77,48,99,89,83,396,合格
20195115,52,6,43,83,6,190,不合格
20195116,0,92,24,75,0,191,不合格
20195117,55,69,62,83,17,286,不合格
20195118,11,33,15,55,3,117,不合格
20195119,34,11,92,81,16,234,不合格
20195120,11,61,79,47,30,228,不合格
20195121,91,70,58,29,70,318,合格
20195122,21,13,21,21,89,165,不合格
20195123,66,77,13,40,90,286,不合格
20195124,59,13,35,3,55,165,不合格
20195125,63,11,23,75,41,213,不合格
20195126,83,44,13,34,20,194,不合格
20195127,12,12,23,97,38,182,不合格
20195128,41,2,85,91,44,263,不合格
20195129,9,98,15,96,40,258,不合格
20195130,69,59,0,66,36,230,不合格
20195131,26,50,79,57,8,220,不合格
20195132,32,14,77,86,35,244,不合格
20195133,39,6,67,29,29,170,不合格
20195134,34,12,32,16,32,126,不合格
20195135,91,84,12,55,71,313,合格
20195136,6,70,21,66,11,174,不合格
20195137,18,64,29,24,75,210,不合格
20195138,52,39,51,10,76,228,不合格
20195139,86,52,20,72,51,281,不合格
20195140,48,24,42,3,20,137,不合格
20195141,72,89,97,33,45,336,合格
20195142,2,89,20,79,43,233,不合格
20195143,47,79,34,4,3,167,不合格
20195144,82,38,57,46,29,252,不合格
20195145,63,72,80,38,82,335,合格
20195146,81,40,69,50,7,247,不合格
20195147,14,12,14,33,48,121,不合格
20195148,79,42,25,83,93,322,合格
20195149,24,39,56,13,44,176,不合格
20195150,62,54,32,23,19,190,不合格
20195151,98,30,40,97,88,353,合格
20195152,61,89,4,67,30,251,不合格
20195153,96,35,44,51,43,269,不合格
20195154,99,1,11,8,62,181,不合格
20195155,60,92,23,84,48,307,合格
20195156,29,21,71,49,36,206,不合格
20195157,37,31,38,43,72,221,不合格
20195158,49,80,84,94,63,370,合格
20195159,28,80,30,97,39,274,不合格
20195160,20,73,2,30,27,152,不合格
20195161,22,54,55,67,56,254,不合格
20195162,92,75,75,10,97,349,合格
20195163,26,8,13,52,33,132,不合格
20195164,22,90,23,82,60,277,不合格
20195165,96,93,74,54,85,402,合格
20195166,25,65,64,93,53,300,合格
20195167,4,54,66,77,91,292,不合格
20195168,5,87,89,12,68,261,不合格
20195169,25,71,23,29,4,152,不合格
20195170,90,34,72,13,77,286,不合格
20195171,8,34,92,33,18,185,不合格
20195172,84,28,33,0,48,193,不合格
20195173,59,21,69,24,87,260,不合格
20195174,5,29,42,80,68,224,不合格
20195175,89,75,4,89,19,276,不合格
20195176,68,33,97,90,48,336,合格
20195177,3,83,88,29,78,281,不合格
20195178,35,41,87,4,44,211,不合格
20195179,82,57,5,75,84,303,合格
20195180,17,83,91,80,94,365,合格
20195181,59,78,25,53,69,284,不合格
20195182,81,16,93,6,52,248,不合格
20195183,11,20,74,12,2,119,不合格
20195184,39,44,13,63,86,245,不合格
20195185,21,90,38,29,77,255,不合格
20195186,22,12,44,60,18,156,不合格
20195187,59,74,97,32,94,356,合格
20195188,2,68,68,69,20,227,不合格
20195189,23,26,74,64,41,228,不合格
20195190,65,79,37,81,62,324,合格
20195191,54,35,40,9,5,143,不合格
20195192,9,36,25,2,7,79,不合格
20195193,61,55,4,98,38,256,不合格
20195194,93,96,15,27,43,274,不合格
20195195,6,64,30,50,31,181,不合格
20195196,96,1,18,77,45,237,不合格
20195197,16,0,58,62,48,184,不合格
20195198,75,49,19,23,96,262,不合格
20195199,44,38,28,11,93,214,不合格
20195200,88,66,89,98,28,369,合格
20195201,29,74,1,21,62,187,不合格
20195202,3,41,78,23,81,226,不合格
20195203,73,0,58,38,57,226,不合格
20195204,36,34,52,65,51,238,不合格
20195205,37,88,41,1,30,197,不合格
20195206,91,70,8,8,16,193,不合格
20195207,83,10,92,27,59,271,不合格
20195208,64,2,9,81,1,157,不合格
20195209,40,92,24,76,50,282,不合格
20195210,50,63,7,58,43,221,不合格
20195211,72,84,55,91,79,381,合格
20195212,74,50,59,86,96,365,合格
20195213,51,64,88,4,33,240,不合格
20195214,67,32,97,25,27,248,不合格
20195215,5,2,44,56,44,151,不合格
20195216,92,57,33,6,85,273,不合格
20195217,3,6,64,83,54,210,不合格
20195218,31,30,46,5,28,140,不合格
20195219,64,74,5,48,84,275,不合格
20195220,71,26,64,46,33,240,不合格
20195221,52,84,6,94,86,322,合格
20195222,4,10,70,43,27,154,不合格
20195223,37,97,16,64,24,238,不合格
20195224,92,12,93,23,36,256,不合格
20195225,32,82,73,16,92,295,不合格
20195226,97,66,53,96,24,336,合格
20195227,11,53,7,52,55,178,不合格
20195228,65,3,69,23,80,240,不合格
20195229,15,42,91,44,39,231,不合格
20195230,64,24,97,13,16,214,不合格
20195231,84,42,50,30,85,291,不合格
20195232,41,83,39,18,86,267,不合格
20195233,75,16,13,50,11,165,不合格
20195234,57,98,52,4,68,279,不合格
20195235,97,90,74,30,15,306,合格
20195236,73,90,18,58,92,331,合格
20195237,79,69,88,19,30,285,不合格
20195238,7,18,52,33,76,186,不合格
20195239,8,40,43,84,41,216,不合格
20195240,9,26,18,47,38,138,不合格
20195241,89,42,52,78,11,272,不合格
20195242,75,99,42,57,89,362,合格
20195243,43,75,70,14,18,220,不合格
20195244,51,96,13,71,90,321,合格
20195245,9,40,11,6,66,132,不合格
20195246,44,45,45,37,12,183,不合格
20195247,67,58,72,12,62,271,不合格
20195248,22,29,95,28,18,192,不合格
20195249,51,85,23,19,84,262,不合格
20195250,81,83,13,91,43,311,合格
20195251,9,14,31,36,60,150,不合格
20195252,88,68,41,93,67,357,合格
20195253,71,95,8,50,41,265,不合格
20195254,58,59,4,67,24,212,不合格
20195255,13,90,27,55,51,236,不合格
20195256,67,42,83,0,2,194,不合格
20195257,9,38,84,22,14,167,不合格
20195258,75,27,83,42,80,307,合格
20195259,31,78,98,87,79,373,合格
20195260,74,34,25,66,61,260,不合格
20195261,95,88,25,17,85,310,合格
20195262,91,21,95,55,42,304,合格
20195263,15,67,81,80,60,303,合格
20195264,17,39,4,37,75,172,不合格
20195265,68,15,53,94,59,289,不合格
20195266,6,86,87,8,91,278,不合格
20195267,70,13,91,44,66,284,不合格
20195268,26,63,59,72,19,239,不合格
20195269,15,53,4,43,22,137,不合格
20195270,54,74,45,76,53,302,合格
20195271,14,7,91,50,39,201,不合格
20195272,55,64,90,32,16,257,不合格
20195273,28,58,31,22,84,223,不合格
20195274,37,79,59,23,89,287,不合格
20195275,1,67,58,29,66,221,不合格
20195276,15,21,93,46,2,177,不合格
20195277,7,63,23,80,60,233,不合格
20195278,80,77,14,69,76,316,合格
20195279,15,14,90,86,80,285,不合格
20195280,43,25,65,18,30,181,不合格
20195281,60,99,68,93,52,372,合格
20195282,50,58,1,80,62,251,不合格
20195283,22,82,85,66,50,305,合格
20195284,83,42,10,27,79,241,不合格
20195285,73,54,91,83,69,370,合格
20195286,38,37,94,90,3,262,不合格
20195287,9,30,42,42,57,180,不合格
20195288,64,43,83,5,65,260,不合格
20195289,78,58,4,38,96,274,不合格
20195290,15,52,12,87,6,172,不合格
20195291,16,71,66,31,24,208,不合格
20195292,77,55,93,91,86,402,合格
20195293,86,86,6,74,64,316,合格
20195294,98,77,53,93,52,373,合格
20195295,80,14,93,23,85,295,不合格
20195296,5,9,50,0,4,68,不合格
20195297,18,62,23,65,59,227,不合格
20195298,56,38,83,41,61,279,不合格
20195299,71,97,1,80,13,262,不合格
20195300,45,33,51,66,35,230,不合格
20195301,57,63,13,4,21,158,不合格
20195302,40,81,87,14,87,309,合格
20195303,69,83,20,93,29,294,不合格
20195304,94,24,6,58,87,269,不合格
20195305,48,6,89,5,10,158,不合格
20195306,66,99,13,8,30,216,不合格
20195307,84,70,7,75,19,255,不合格
20195308,66,20,27,61,26,200,不合格
20195309,53,25,15,87,69,249,不合格
20195310,76,42,38,34,81,271,不合格
20195311,37,25,56,31,45,194,不合格
20195312,50,54,68,45,51,268,不合格
20195313,7,13,76,38,42,176,不合格
20195314,45,20,89,68,95,317,合格
20195315,68,59,43,57,51,278,不合格
20195316,27,46,94,92,95,354,合格
20195317,94,27,73,7,21,222,不合格
20195318,42,44,92,12,70,260,不合格
20195319,88,73,71,32,74,338,合格
20195320,73,17,64,27,6,187,不合格
20195321,85,58,76,59,73,351,合格
20195322,59,95,72,57,36,319,合格
20195323,86,38,7,88,99,318,合格
20195324,94,1,78,43,20,236,不合格
20195325,27,49,32,66,22,196,不合格
20195326,47,51,17,28,77,220,不合格
20195327,90,74,3,92,10,269,不合格
20195328,38,92,12,3,48,193,不合格
20195329,92,96,57,21,80,346,合格
20195330,26,20,81,19,32,178,不合格
20195331,14,35,81,89,37,256,不合格
20195332,14,60,89,19,12,194,不合格
20195333,50,80,97,98,32,357,合格
20195334,39,95,3,77,45,259,不合格
20195335,2,56,19,56,39,172,不合格
20195336,8,54,60,49,48,219,不合格
20195337,82,92,78,63,83,398,合格
20195338,62,98,19,30,58,267,不合格
20195339,81,54,89,85,53,362,合格
20195340,1,99,64,99,9,272,不合格
20195341,62,88,7,68,27,252,不合格
20195342,85,79,90,54,72,380,合格
20195343,16,54,15,37,72,194,不合格
20195344,47,49,92,51,16,255,不合格
20195345,31,55,28,95,28,237,不合格
20195346,47,15,4,50,70,186,不合格
20195347,36,19,51,96,30,232,不合格
20195348,34,32,48,52,25,191,不合格
20195349,45,94,62,77,22,300,合格
20195350,50,92,95,84,46,367,合格
20195351,15,53,36,35,13,152,不合格
20195352,70,8,99,92,63,332,合格
20195353,14,28,58,85,86,271,不合格
20195354,4,38,28,94,41,205,不合格
20195355,98,79,24,76,11,288,不合格
20195356,26,46,81,94,86,333,合格
20195357,99,5,21,21,31,177,不合格
20195358,83,58,7,74,95,317,合格
20195359,29,82,67,0,80,258,不合格
20195360,34,47,86,38,50,255,不合格
20195361,93,91,50,80,28,342,合格
20195362,16,34,9,17,66,142,不合格
20195363,84,10,0,22,88,204,不合格
20195364,90,95,55,17,74,331,合格
20195365,81,31,73,60,82,327,合格
20195366,64,43,96,98,74,375,合格
20195367,81,54,77,63,32,307,合格
20195368,90,39,84,63,98,374,合格
20195369,15,15,24,66,45,165,不合格
20195370,81,6,37,56,63,243,不合格
20195371,4,56,0,86,61,207,不合格
20195372,70,2,34,8,93,207,不合格
20195373,66,68,60,73,24,291,不合格
20195374,59,47,83,43,23,255,不合格
20195375,16,8,70,18,54,166,不合格
20195376,90,81,28,98,58,355,合格
20195377,86,56,84,49,40,315,合格
20195378,60,89,29,19,34,231,不合格
20195379,16,0,25,75,7,123,不合格
20195380,86,14,2,11,87,200,不合格
20195381,63,57,93,49,48,310,合格
20195382,99,6,62,72,91,330,合格
20195383,71,62,18,20,89,260,不合格
20195384,44,58,27,92,86,307,合格
20195385,88,28,65,53,58,292,不合格
20195386,94,49,9,39,31,222,不合格
20195387,96,17,18,32,3,166,不合格
20195388,42,93,89,68,5,297,不合格
20195389,15,67,4,52,97,235,不合格
20195390,49,87,68,57,99,360,合格
20195391,33,61,21,3,46,164,不合格
20195392,12,17,11,65,4,109,不合格
20195393,98,47,97,11,33,286,不合格
20195394,97,91,63,83,83,417,合格
20195395,61,95,80,8,32,276,不合格
20195396,22,40,99,3,74,238,不合格
20195397,54,79,17,48,69,267,不合格
20195398,28,21,35,85,44,213,不合格
20195399,37,76,22,10,92,237,不合格
20195400,94,22,47,11,56,230,不合格
20195401,86,44,9,58,31,228,不合格
20195402,65,7,65,66,96,299,不合格
20195403,24,30,88,4,43,189,不合格
20195404,67,47,50,17,50,231,不合格
20195405,29,56,79,86,31,281,不合格
20195406,77,50,9,16,16,168,不合格
20195407,44,53,53,51,53,254,不合格
20195408,80,22,62,99,79,342,合格
20195409,4,20,51,79,10,164,不合格
20195410,38,59,11,3,17,128,不合格
20195411,63,83,49,57,96,348,合格
20195412,27,55,78,69,14,243,不合格
20195413,69,59,97,98,63,386,合格
20195414,2,68,32,19,24,145,不合格
20195415,96,5,30,28,15,174,不合格
20195416,77,21,43,9,85,235,不合格
20195417,43,85,70,45,65,308,合格
20195418,73,74,17,80,70,314,合格
20195419,19,25,61,0,63,168,不合格
20195420,11,36,41,69,82,239,不合格
20195421,34,85,19,69,23,230,不合格
20195422,18,98,79,45,93,333,合格
20195423,98,62,77,58,98,393,合格
20195424,19,94,20,7,53,193,不合格
20195425,6,36,31,13,64,150,不合格
20195426,50,35,66,53,41,245,不合格
20195427,41,37,16,1,50,145,不合格
20195428,82,41,75,3,54,255,不合格
20195429,57,54,28,32,56,227,不合格
20195430,68,14,57,15,25,179,不合格
20195431,51,68,10,63,28,220,不合格
20195432,65,93,29,88,89,364,合格
20195433,4,3,29,43,14,93,不合格
20195434,45,38,22,25,33,163,不合格
20195435,92,99,41,86,23,341,合格
20195436,12,24,12,19,47,114,不合格
20195437,75,99,96,50,93,413,合格
20195438,50,71,25,42,69,257,不合格
20195439,93,32,14,69,43,251,不合格
20195440,9,19,35,55,26,144,不合格
20195441,79,42,51,53,94,319,合格
20195442,6,39,60,37,90,232,不合格
20195443,10,83,46,29,97,265,不合格
20195444,10,11,38,9,83,151,不合格
20195445,89,10,64,88,69,320,合格
20195446,51,91,88,76,92,398,合格
20195447,88,19,25,30,68,230,不合格
20195448,45,35,8,80,5,173,不合格
20195449,18,3,18,0,47,86,不合格
20195450,25,0,6,33,88,152,不合格
20195451,38,74,57,48,49,266,不合格
20195452,36,74,81,78,70,339,合格
20195453,70,63,1,4,84,222,不合格
20195454,62,39,18,77,49,245,不合格
20195455,19,42,83,25,16,185,不合格
20195456,23,5,18,40,22,108,不合格
20195457,15,22,36,8,5,86,不合格
20195458,29,2,59,90,36,216,不合格
20195459,8,35,71,94,81,289,不合格
20195460,68,55,58,48,30,259,不合格
20195461,53,3,67,20,64,207,不合格
20195462,13,18,1,49,70,151,不合格
20195463,37,7,3,21,94,162,不合格
20195464,98,63,27,42,44,274,不合格
20195465,67,17,0,97,63,244,不合格
20195466,27,30,44,35,58,194,不合格
20195467,1,75,19,38,46,179,不合格
20195468,54,20,62,25,2,163,不合格
20195469,17,76,3,32,61,189,不合格
20195470,91,86,87,26,51,341,合格
20195471,87,64,54,90,2,297,不合格
20195472,89,44,5,51,16,205,不合格
20195473,26,92,90,25,76,309,合格
20195474,18,75,71,27,72,263,不合格
20195475,15,30,37,11,35,128,不合格
20195476,92,44,65,73,28,302,合格
20195477,82,11,84,35,48,260,不合格
20195478,38,64,61,57,63,283,不合格
20195479,69,45,28,51,94,287,不合格
20195480,66,77,11,5,21,180,不合格
20195481,74,48,95,80,13,310,合格
20195482,42,4,8,93,92,239,不合格
20195483,12,48,99,54,46,259,不合格
20195484,61,94,3,43,35,236,不合格
20195485,95,46,98,79,76,394,合格
20195486,40,34,29,7,78,188,不合格
20195487,82,5,4,89,10,190,不合格
20195488,1,92,91,91,28,303,合格
20195489,53,87,27,98,64,329,合格
20195490,82,17,16,58,89,262,不合格
20195491,48,73,49,13,30,213,不合格
20195492,7,22,36,60,39,164,不合格
20195493,30,28,14,52,30,154,不合格
20195494,66,30,8,16,72,192,不合格
20195495,73,28,64,45,25,235,不合格
20195496,43,62,2,29,94,230,不合格
20195497,99,76,1,16,57,249,不合格
20195498,94,71,54,31,80,330,合格
20195499,54,36,11,5,15,121,不合格
20195500,57,69,77,98,88,389,合格
